"filename","subject","date","time","delay","tot_num_trials","tot_num_free","tot_num_fd","tot_num_fi","tot_forced_trials","events_before_center","events_before_center_fd","events_before_center_fi","events_before_center_tot","events_before_choice","events_before_choice_fd","events_before_choice_fi","events_before_choice_tot","events_during_to","events_during_to_fd","events_during_to_fi","events_during_to_tot","avg_rxn_time_free","avg_choice_rxn_time_free","avg_timeout_dur_free","avg_collection_time_free","avg_events_before_collect_imm","avg_events_before_collect_del","events_before_collect_tot","percent_reward_collected"
"./Ship3_Latin-square/2019-08-24_12h55m_Subject 47754.txt","47754",2019-08-24,"12:55",24,61,46,10,5,15,121,18,18,157,72,47,5,124,160,0,32,192,2201.5,355.826086956522,1986.62222222222,2038.44444444444,42,49,91,97.8723404255319
"./Ship3_Latin-square/2019-08-24_13h00m_Subject 46894.txt","46894",2019-08-24,"13:00",4,83,60,10,13,23,105,11,41,157,57,24,25,106,761,137,142,1040,617.566666666667,294.916666666667,2776.16949152542,938.338983050847,11,43,54,100
"./Ship3_Latin-square/2019-08-24_13h00m_Subject 47088.txt","47088",2019-08-24,"13:00",8,76,56,10,10,20,86,18,11,115,82,21,35,138,319,55,60,434,1221.10714285714,286.910714285714,2578.14545454545,912.892857142857,21,25,46,100
"./Ship3_Latin-square/2019-08-24_13h00m_Subject 47228.txt","47228",2019-08-24,"13:00",4,79,56,10,13,23,81,13,22,116,116,16,25,157,573,114,142,829,865.839285714286,538.892857142857,2774.54545454545,1447.07272727273,60,125,185,100
"./Ship3_Latin-square/2019-08-24_13h00m_Subject 47243.txt","47243",2019-08-24,"13:00",4,27,19,8,0,8,40,40,0,80,10,10,0,20,85,50,0,135,3680.77777777778,308.055555555556,2977.72222222222,612,238,0,238,26.3157894736842
"./Ship3_Latin-square/2019-08-24_13h00m_Subject 47249.txt","47249",2019-08-24,"13:00",8,79,60,5,14,19,133,16,15,164,129,13,34,176,469,18,151,638,893.883333333333,261.033333333333,2498.23728813559,835.28813559322,28,16,44,100
"./Ship3_Latin-square/2019-08-24_13h00m_Subject 47639.txt","47639",2019-08-24,"13:00",4,80,60,12,8,20,179,14,10,203,80,39,44,163,744,113,108,965,822.666666666667,339.283333333333,2816.86440677966,1137.8813559322,46,79,125,100
"./Ship3_Latin-square/2019-08-24_13h00m_Subject 47758.txt","47758",2019-08-24,"13:00",8,86,60,12,14,26,73,10,8,91,40,25,67,132,652,71,239,962,336.783333333333,184.233333333333,2552.49152542373,1002.83050847458,38,15,53,100
"./Ship3_Latin-square/2019-08-24_13h00m_Subject 47759.txt","47759",2019-08-24,"13:00",8,79,60,7,12,19,78,16,12,106,74,11,32,117,498,70,122,690,586.233333333333,290.933333333333,2525.37288135593,1117.22033898305,20,28,48,100
"./Ship3_Latin-square/2019-08-24_13h00m_Subject 47776.txt","47776",2019-08-24,"13:00",4,81,60,6,15,21,66,6,7,79,83,21,54,158,756,64,227,1047,384.5,244.116666666667,2742.35593220339,936.101694915254,25,31,56,100
"./Ship3_Latin-square/2019-08-24_13h00m_Subject 47799.txt","47799",2019-08-24,"13:00",8,79,60,10,9,19,54,6,6,66,96,47,10,153,449,59,104,612,562.366666666667,300.716666666667,2606.69491525424,569.220338983051,32,32,64,100
"./Ship3_Latin-square/2019-08-24_14h03m_Subject 46892.txt","46892",2019-08-24,"14:03",8,83,60,8,15,23,62,5,15,82,29,9,16,54,623,77,163,863,532.416666666667,164.366666666667,2538.96610169492,1108.91525423729,24,42,66,100
"./Ship3_Latin-square/2019-08-24_14h03m_Subject 47099.txt","47099",2019-08-24,"14:03",8,81,60,10,11,21,108,24,15,147,129,78,71,278,572,69,138,779,687.366666666667,334.266666666667,2593.18644067797,1025.05084745763,34,63,97,100
"./Ship3_Latin-square/2019-08-24_14h20m_Subject 46893.txt","46893",2019-08-24,"14:20",4,82,60,8,14,22,84,9,11,104,81,11,40,132,856,117,238,1211,441.533333333333,335.183333333333,2769.47457627119,1009.96610169492,21,89,110,100
"./Ship3_Latin-square/2019-08-24_14h20m_Subject 47638.txt","47638",2019-08-24,"14:20",4,68,51,8,9,17,149,50,14,213,95,37,120,252,447,54,69,570,1228.01960784314,353.823529411765,2796.03921568627,1278.66666666667,22,92,114,100
"./Ship3_Latin-square/2019-08-24_14h20m_Subject 47757.txt","47757",2019-08-24,"14:20",8,64,47,10,7,17,118,30,18,166,85,52,20,157,354,80,70,504,1922.02173913043,405.478260869565,2634.71739130435,1650.33333333333,73,92,165,97.8723404255319
"./Ship3_Latin-square/2019-08-24_14h20m_Subject 47769.txt","47769",2019-08-24,"14:20",4,79,60,8,11,19,63,6,16,85,68,19,26,113,892,103,188,1183,306.2,258.866666666667,2783.01694915254,907.305084745763,36,21,57,100
"./Ship3_Latin-square/2019-08-24_14h20m_Subject 47782.txt","47782",2019-08-24,"14:20",8,79,60,10,9,19,48,8,6,62,17,5,22,44,683,65,116,864,357.966666666667,132.733333333333,2620.27118644068,882.474576271186,21,10,31,100
"./Ship3_Latin-square/2019-08-24_14h20m_Subject 47788.txt","47788",2019-08-24,"14:20",8,82,60,7,15,22,90,12,9,111,70,11,37,118,360,39,123,522,648.8,253.05,2498.30508474576,1671.74137931034,58,60,118,98.3606557377049
"./Ship3_Latin-square/2019-08-24_15h15m_Subject 47080.txt","47080",2019-08-24,"15:15",4,82,60,10,12,22,62,14,16,92,81,24,12,117,536,86,117,739,371.25,485.066666666667,2776.22033898305,1447.28813559322,36,63,99,100
"./Ship3_Latin-square/2019-08-25_10h51m_Subject 47229.txt","47229",2019-08-25,"10:51",4,78,60,6,12,18,99,29,8,136,157,65,46,268,699,62,160,921,408.216666666667,585.716666666667,2755.8813559322,1224.40677966102,47,119,166,100
"./Ship3_Latin-square/2019-08-25_11h07m_Subject 47250.txt","47250",2019-08-25,"11:07",4,78,57,11,10,21,168,86,9,263,33,26,77,136,618,94,117,829,894.929824561404,181.947368421053,2792.80357142857,1091.35087719298,23,18,41,100
"./Ship3_Latin-square/2019-08-25_11h56m_Subject 47754.txt","47754",2019-08-25,"11:56",8,66,50,8,8,16,169,19,4,192,57,17,11,85,313,31,58,402,2121.65306122449,328.224489795918,2640.69387755102,1813.51162790698,41,110,151,92
"./Ship3_Latin-square/2019-08-25_11h56m_Subject 47800.txt","47800",2019-08-25,"11:56",4,71,52,12,7,19,113,15,16,144,94,30,20,144,381,74,39,494,1598.90384615385,452.5,2827.37254901961,1429.29411764706,35,29,64,100
"./Ship3_Latin-square/2019-08-25_12h23m_Subject 46894.txt","46894",2019-08-25,"12:23",8,80,60,8,12,20,66,10,10,86,28,14,5,47,527,69,144,740,590.016666666667,141.983333333333,2566.06779661017,930.237288135593,13,43,56,100
"./Ship3_Latin-square/2019-08-25_12h23m_Subject 47088.txt","47088",2019-08-25,"12:23",2,80,60,3,17,20,59,3,13,75,131,8,113,252,567,34,132,733,649.066666666667,336.25,2857.59322033898,1139.61016949153,35,58,93,100
"./Ship3_Latin-square/2019-08-25_12h23m_Subject 47228.txt","47228",2019-08-25,"12:23",8,83,60,10,13,23,71,8,11,90,70,16,17,103,583,103,167,853,492.033333333333,307.55,2565.94915254237,1238.66101694915,34,108,142,100
"./Ship3_Latin-square/2019-08-25_12h23m_Subject 47243.txt","47243",2019-08-25,"12:23",8,33,24,8,1,9,48,13,21,82,142,71,4,217,264,65,0,329,630.208333333333,8752.66666666667,2833.25,1573.26086956522,58,20,78,100
"./Ship3_Latin-square/2019-08-25_12h23m_Subject 47249.txt","47249",2019-08-25,"12:23",2,81,60,6,15,21,104,12,15,131,162,29,83,274,540,55,152,747,653.525423728814,474.220338983051,2871.16949152542,1107.40677966102,21,30,51,100
"./Ship3_Latin-square/2019-08-25_12h23m_Subject 47639.txt","47639",2019-08-25,"12:23",8,76,60,7,9,16,41,5,10,56,41,11,20,72,829,81,142,1052,198.066666666667,187.75,2593.16949152542,1069.38983050847,57,65,122,100
"./Ship3_Latin-square/2019-08-25_12h23m_Subject 47758.txt","47758",2019-08-25,"12:23",2,84,60,11,13,24,54,12,18,84,66,15,31,112,569,83,166,818,296.283333333333,389.616666666667,2891.49152542373,1509.71186440678,33,16,49,100
"./Ship3_Latin-square/2019-08-25_12h23m_Subject 47759.txt","47759",2019-08-25,"12:23",2,84,60,7,17,24,38,17,5,60,72,42,24,138,453,54,192,699,364.366666666667,282.6,2864.38983050847,1716.69090909091,49,88,137,98.3606557377049
"./Ship3_Latin-square/2019-08-25_12h23m_Subject 47776.txt","47776",2019-08-25,"12:23",8,81,60,6,15,21,36,1,9,46,76,16,32,124,794,71,264,1129,162.333333333333,195.516666666667,2484.72881355932,1085.32203389831,33,32,65,100
"./Ship3_Latin-square/2019-08-25_12h23m_Subject 47799.txt","47799",2019-08-25,"12:23",2,82,59,4,19,23,62,6,15,83,137,4,121,262,424,40,150,614,464.586206896552,488.51724137931,2848.25862068966,1988.03636363636,25,116,141,98.3050847457627
"./Ship3_Latin-square/2019-08-25_13h05m_Subject 46888.txt","46888",2019-08-25,"13:05",4,77,60,4,13,17,88,6,22,116,113,15,44,172,984,60,237,1281,319.75,304.35,2742.35593220339,1165.03389830508,25,43,68,100
"./Ship3_Latin-square/2019-08-25_13h05m_Subject 46892.txt","46892",2019-08-25,"13:05",2,83,60,9,14,23,49,5,14,68,70,28,20,118,736,117,167,1020,182.983333333333,398.05,2884.69491525424,1186.59322033898,38,24,62,100
"./Ship3_Latin-square/2019-08-25_13h05m_Subject 47099.txt","47099",2019-08-25,"13:05",2,80,60,10,10,20,33,0,4,37,120,89,14,223,829,147,142,1118,190.516666666667,259.016666666667,2901.69491525424,1055.38983050847,38,58,96,100
"./Ship3_Latin-square/2019-08-25_13h37m_Subject 46893.txt","46893",2019-08-25,"13:37",8,79,60,8,11,19,38,4,14,56,51,12,29,92,863,99,171,1133,195.333333333333,177.15,2579.5593220339,920.016949152542,33,50,83,100
"./Ship3_Latin-square/2019-08-25_13h37m_Subject 47638.txt","47638",2019-08-25,"13:37",8,79,59,12,8,20,83,26,11,120,45,14,46,105,480,89,43,612,1089.15254237288,215.305084745763,2655.13793103448,1219.72881355932,37,56,93,100
"./Ship3_Latin-square/2019-08-25_13h37m_Subject 47757.txt","47757",2019-08-25,"13:37",2,70,52,8,10,18,109,19,27,155,108,32,29,169,370,67,89,526,1304.76923076923,525.519230769231,2886.27450980392,1703.6862745098,52,96,148,100
"./Ship3_Latin-square/2019-08-25_13h37m_Subject 47769.txt","47769",2019-08-25,"13:37",8,81,60,13,8,21,62,10,12,84,67,29,15,111,810,130,105,1045,304.3,232.683333333333,2660.89830508475,783.016949152542,41,21,62,100
"./Ship3_Latin-square/2019-08-25_13h37m_Subject 47771.txt","47771",2019-08-25,"13:37",4,83,60,10,13,23,107,43,15,165,65,23,48,136,517,76,154,747,609.416666666667,374.3,2789.76271186441,1172.25862068966,36,64,100,98.3606557377049
"./Ship3_Latin-square/2019-08-25_13h37m_Subject 47775.txt","47775",2019-08-25,"13:37",4,85,59,8,18,26,96,22,13,131,88,69,43,200,652,72,242,966,599.305084745763,322.559322033898,2728.79661016949,967.593220338983,24,16,40,100
"./Ship3_Latin-square/2019-08-25_13h37m_Subject 47782.txt","47782",2019-08-25,"13:37",2,83,60,5,18,23,56,3,10,69,22,1,42,65,573,45,155,773,383.716666666667,213.05,2860.98305084746,1202.0701754386,10,56,66,96.7213114754098
"./Ship3_Latin-square/2019-08-25_13h37m_Subject 47788.txt","47788",2019-08-25,"13:37",2,77,60,2,15,17,50,1,11,62,96,2,25,123,486,16,121,623,336.65,274.75,2857.59322033898,1523.83050847458,31,50,81,100
"./Ship3_Latin-square/2019-08-25_14h12m_Subject 47080.txt","47080",2019-08-25,"14:12",8,82,60,9,13,22,24,3,4,31,47,7,8,62,565,67,149,781,180.7,246.516666666667,2552.50847457627,1229.66101694915,37,36,73,100
"./Ship3_Latin-square/2019-08-25_14h12m_Subject 47089.txt","47089",2019-08-25,"14:12",4,57,42,11,4,15,112,44,4,160,97,64,52,213,280,61,13,354,2298.88095238095,496.214285714286,2866.61904761905,1588.4,59,93,152,97.6744186046512
"./Ship3_Latin-square/2019-08-26_10h07m_Subject 47238.txt","47238",2019-08-26,"10:07",4,78,56,10,12,22,106,35,23,164,78,19,71,168,472,79,128,679,956.678571428571,303.660714285714,2781.78181818182,1260.25,36,71,107,100
"./Ship3_Latin-square/2019-08-26_10h07m_Subject 47242.txt","47242",2019-08-26,"10:07",4,56,42,12,2,14,281,66,2,349,48,20,2,70,456,91,28,575,3522.90476190476,174.47619047619,2885.69047619048,939.512195121951,36,21,57,100
"./Ship3_Latin-square/2019-08-26_10h07m_Subject 47767.txt","47767",2019-08-26,"10:07",4,7,5,2,0,2,125,6,0,131,87,12,0,99,16,8,0,24,12566.6,48063,2919.8,2904.8,12,5,17,100
"./Ship3_Latin-square/2019-08-26_11h19m_Subject 47229.txt","47229",2019-08-26,"11:19",8,86,60,14,12,26,95,9,15,119,70,34,22,126,650,144,118,912,375.3,251.466666666667,2620.27118644068,1212.33898305085,56,54,110,100
"./Ship3_Latin-square/2019-08-26_11h19m_Subject 47777.txt","47777",2019-08-26,"11:19",4,76,57,8,11,19,131,24,19,174,54,11,7,72,355,51,81,487,1084.14035087719,538.491228070175,2785.64285714286,1775.88888888889,67,55,122,96.4912280701754
"./Ship3_Latin-square/2019-08-26_11h24m_Subject 47076.txt","47076",2019-08-26,"11:24",4,85,60,11,14,25,101,47,41,189,83,38,80,201,668,99,205,972,472.65,274.266666666667,2776.22033898305,1272.72881355932,36,120,156,100
"./Ship3_Latin-square/2019-08-26_11h24m_Subject 47082.txt","47082",2019-08-26,"11:24",4,70,52,12,6,18,147,52,27,226,57,53,6,116,527,96,81,704,1654.84615384615,183.865384615385,2835.27450980392,1498.03921568627,76,65,141,100
"./Ship3_Latin-square/2019-08-26_11h24m_Subject 47226.txt","47226",2019-08-26,"11:24",4,80,56,12,12,24,143,24,30,197,59,5,16,80,442,76,124,642,1216.48214285714,219.642857142857,2785.67857142857,1773.84615384615,146,46,192,94.7368421052632
"./Ship3_Latin-square/2019-08-26_11h24m_Subject 47227.txt","47227",2019-08-26,"11:24",4,81,60,9,12,21,127,60,17,204,53,20,99,172,510,76,147,733,905.833333333333,182.2,2789.81355932203,1321.77966101695,38,94,132,100
"./Ship3_Latin-square/2019-08-26_11h24m_Subject 47250.txt","47250",2019-08-26,"11:24",8,84,60,13,11,24,55,9,10,74,45,24,33,102,619,98,130,847,326,171.5,2606.74576271186,958.728813559322,12,10,22,100
"./Ship3_Latin-square/2019-08-26_11h24m_Subject 47646.txt","47646",2019-08-26,"11:24",4,81,60,5,16,21,103,10,22,135,56,8,23,87,584,34,257,875,941.016666666667,317.516666666667,2728.72881355932,1350.42372881356,19,49,68,100
"./Ship3_Latin-square/2019-08-26_11h24m_Subject 47795.txt","47795",2019-08-26,"11:24",4,81,60,9,12,21,128,12,19,159,94,23,17,134,574,79,137,790,731.6,315.166666666667,2789.81355932203,1499.27118644068,42,36,78,100
"./Ship3_Latin-square/2019-08-26_12h26m_Subject 46881.txt","46881",2019-08-26,"12:26",4,56,41,9,6,15,146,42,21,209,49,17,75,141,220,41,61,322,2496.78048780488,359.268292682927,2829.975,2382.63157894737,53,76,129,95.2380952380952
"./Ship3_Latin-square/2019-08-26_12h26m_Subject 47087.txt","47087",2019-08-26,"12:26",4,36,28,5,3,8,275,25,4,304,45,6,9,60,208,46,21,275,2949.77777777778,377.925925925926,2822.18518518519,1684.11111111111,24,53,77,100
"./Ship3_Latin-square/2019-08-26_12h26m_Subject 47634.txt","47634",2019-08-26,"12:26",4,60,41,10,9,19,105,49,23,177,39,28,33,100,220,51,63,334,2119.78048780488,346.268292682927,2810,1933.92682926829,38,54,92,100
"./Ship3_Latin-square/2019-08-26_12h26m_Subject 47640.txt","47640",2019-08-26,"12:26",4,56,41,8,7,15,107,10,12,129,60,52,5,117,279,60,51,390,3042.075,431.325,2809.925,3009.48717948718,24,68,92,97.5609756097561
"./Ship3_Latin-square/2019-08-26_12h26m_Subject 47754.txt","47754",2019-08-26,"12:26",2,36,28,7,1,8,117,9,0,126,49,19,4,72,179,38,6,223,7982.82142857143,449.857142857143,2940.62962962963,2527.10714285714,20,32,52,100
"./Ship3_Latin-square/2019-08-26_12h26m_Subject 47800.txt","47800",2019-08-26,"12:26",8,77,60,9,8,17,111,22,14,147,92,23,16,131,437,62,59,558,1065.46666666667,243.366666666667,2620.28813559322,1352.86440677966,33,62,95,100
"./Ship3_Latin-square/2019-08-26_12h35m_Subject 46882.txt","46882",2019-08-26,"12:35",4,71,52,9,10,19,156,11,18,185,54,48,38,140,399,69,140,608,1567.01923076923,259.352941176471,2803.90196078431,1524.125,24,60,84,94.2307692307692
"./Ship3_Latin-square/2019-08-26_12h35m_Subject 46894.txt","46894",2019-08-26,"12:35",2,80,60,4,16,20,41,1,7,49,90,6,10,106,568,43,161,772,612.2,401.583333333333,2867.76271186441,1394.69491525424,16,71,87,100
"./Ship3_Latin-square/2019-08-26_12h35m_Subject 47088.txt","47088",2019-08-26,"12:35",16,84,60,14,10,24,94,15,12,121,76,27,22,125,384,63,114,561,649.783333333333,228.883333333333,2294.84745762712,910.745762711864,29,39,68,100
"./Ship3_Latin-square/2019-08-26_12h35m_Subject 47228.txt","47228",2019-08-26,"12:35",2,82,60,8,14,22,73,5,9,87,93,6,13,112,767,89,161,1017,444.65,322.566666666667,2877.8813559322,1263.93220338983,27,85,112,100
"./Ship3_Latin-square/2019-08-26_12h35m_Subject 47243.txt","47243",2019-08-26,"12:35",2,79,60,7,12,19,90,13,16,119,82,20,52,154,844,83,185,1112,319.9,378.45,2884.64406779661,1320.83050847458,92,120,212,100
"./Ship3_Latin-square/2019-08-26_12h35m_Subject 47249.txt","47249",2019-08-26,"12:35",16,80,60,11,9,20,92,23,12,127,102,41,21,164,346,40,71,457,583.516666666667,212.333333333333,2267.71186440678,929.915254237288,45,23,68,100
"./Ship3_Latin-square/2019-08-26_12h35m_Subject 47639.txt","47639",2019-08-26,"12:35",2,80,60,8,12,20,26,4,5,35,50,13,16,79,838,101,177,1116,159.766666666667,194.316666666667,2881.30508474576,1388.56896551724,87,72,159,100
"./Ship3_Latin-square/2019-08-26_12h35m_Subject 47758.txt","47758",2019-08-26,"12:35",16,85,60,13,12,25,46,12,12,70,34,24,15,73,507,59,148,714,254.7,161.783333333333,2213.54237288136,981.084745762712,50,14,64,100
"./Ship3_Latin-square/2019-08-26_12h35m_Subject 47759.txt","47759",2019-08-26,"12:35",16,69,51,8,10,18,89,8,18,115,57,8,13,78,238,25,64,327,1975.37254901961,255.941176470588,2103.98,1745.10638297872,35,74,109,94.2307692307692
"./Ship3_Latin-square/2019-08-26_12h35m_Subject 47776.txt","47776",2019-08-26,"12:35",2,81,60,8,13,21,48,4,6,58,108,28,22,158,864,110,210,1184,255,337.983333333333,2881.30508474576,1265.20338983051,33,59,92,100
"./Ship3_Latin-square/2019-08-26_12h35m_Subject 47799.txt","47799",2019-08-26,"12:35",16,79,59,9,11,20,93,5,17,115,128,84,26,238,268,27,81,376,819.627118644068,440.593220338983,2172.36206896552,1413.4406779661,27,52,79,100
"./Ship3_Latin-square/2019-08-26_13h44m_Subject 46888.txt","46888",2019-08-26,"13:44",8,84,60,12,12,24,33,7,5,45,159,30,44,233,811,131,215,1157,138.683333333333,545.65,2593.1186440678,843.186440677966,31,29,60,100
"./Ship3_Latin-square/2019-08-26_13h44m_Subject 46892.txt","46892",2019-08-26,"13:44",16,86,60,12,14,26,82,16,14,112,46,6,8,60,432,46,134,612,524.65,270.533333333333,2132.18644067797,1094.15254237288,42,43,85,100
"./Ship3_Latin-square/2019-08-26_13h44m_Subject 47097.txt","47097",2019-08-26,"13:44",4,79,60,10,9,19,77,17,10,104,95,16,26,137,526,76,62,664,575.9,458.566666666667,2810.13559322034,1591.35593220339,59,59,118,100
"./Ship3_Latin-square/2019-08-26_13h44m_Subject 47099.txt","47099",2019-08-26,"13:44",16,84,60,14,10,24,101,3,31,135,104,50,10,164,553,100,76,729,585,341,2321.96610169492,1166.91525423729,44,59,103,100
"./Ship3_Latin-square/2019-08-26_13h48m_Subject 46893.txt","46893",2019-08-26,"13:48",2,82,60,11,11,22,32,9,6,47,45,10,14,69,1150,192,228,1570,113.45,209.016666666667,2905.05084745763,1082.79661016949,66,53,119,100
"./Ship3_Latin-square/2019-08-26_13h48m_Subject 47638.txt","47638",2019-08-26,"13:48",2,74,56,11,7,18,129,28,9,166,91,28,74,193,425,101,55,581,1223.48214285714,371.928571428571,2912.6,1236.10909090909,38,53,91,100
"./Ship3_Latin-square/2019-08-26_13h48m_Subject 47757.txt","47757",2019-08-26,"13:48",16,70,53,9,8,17,118,26,30,174,78,13,13,104,357,50,51,458,1358.81132075472,293.094339622641,2245.2641509434,1494.96226415094,75,93,168,100
"./Ship3_Latin-square/2019-08-26_13h48m_Subject 47769.txt","47769",2019-08-26,"13:48",2,83,60,10,13,23,47,1,8,56,71,24,32,127,1026,126,282,1434,153.983333333333,283.233333333333,2888.10169491525,924.220338983051,17,17,34,100
"./Ship3_Latin-square/2019-08-26_13h48m_Subject 47771.txt","47771",2019-08-26,"13:48",8,79,60,10,9,19,55,6,10,71,47,17,21,85,572,87,127,786,337.05,201.366666666667,2579.62711864407,1025.32203389831,30,15,45,100
"./Ship3_Latin-square/2019-08-26_13h48m_Subject 47775.txt","47775",2019-08-26,"13:48",8,85,60,11,14,25,60,11,10,81,46,11,10,67,544,85,141,770,417.95,194.766666666667,2579.57627118644,1129.69491525424,23,5,28,100
"./Ship3_Latin-square/2019-08-26_13h48m_Subject 47781.txt","47781",2019-08-26,"13:48",4,80,60,8,12,20,87,5,8,100,160,21,68,249,841,96,201,1138,419.016666666667,481.233333333333,2762.69491525424,1128.18644067797,29,35,64,100
"./Ship3_Latin-square/2019-08-26_13h48m_Subject 47782.txt","47782",2019-08-26,"13:48",16,78,60,12,6,18,49,10,4,63,21,7,5,33,548,45,92,685,240.8,110.816666666667,2349.1186440678,869.610169491525,18,22,40,100
"./Ship3_Latin-square/2019-08-26_13h48m_Subject 47783.txt","47783",2019-08-26,"13:48",4,73,53,11,9,20,164,33,26,223,62,5,21,88,468,37,115,620,1433.69811320755,420.622641509434,2811.28301886792,1918.15384615385,56,112,168,100
"./Ship3_Latin-square/2019-08-26_13h48m_Subject 47785.txt","47785",2019-08-26,"13:48",4,85,60,12,13,25,63,4,17,84,36,24,28,88,806,150,164,1120,439.35,233.066666666667,2783.01694915254,1524.44827586207,26,68,94,98.3606557377049
"./Ship3_Latin-square/2019-08-26_13h48m_Subject 47788.txt","47788",2019-08-26,"13:48",16,79,60,7,12,19,69,6,17,92,87,11,28,126,322,19,83,424,469.966666666667,222.116666666667,2050.81355932203,1528.67796610169,49,56,105,100
"./Ship3_Latin-square/2019-08-26_15h05m_Subject 47080.txt","47080",2019-08-26,"15:05",2,77,60,8,9,17,31,3,7,41,35,5,10,50,580,94,77,751,186.916666666667,182.15,2891.50847457627,1605.1186440678,57,86,143,100
"./Ship3_Latin-square/2019-08-26_15h05m_Subject 47089.txt","47089",2019-08-26,"15:05",8,60,42,5,13,18,85,16,26,127,109,9,25,143,232,19,77,328,2550.95238095238,443.166666666667,2485.66666666667,1840.2619047619,47,43,90,100
"./Ship3_Latin-square/2019-08-27_10h00m_Subject 47238.txt","47238",2019-08-27,"10:00",8,82,60,10,12,22,39,4,8,51,70,5,42,117,520,90,123,733,393.466666666667,228.383333333333,2593.15254237288,1104.89830508475,44,34,78,100
"./Ship3_Latin-square/2019-08-27_10h00m_Subject 47242.txt","47242",2019-08-27,"10:00",8,83,60,10,13,23,184,28,17,229,102,29,77,208,621,99,160,880,715.25,254.583333333333,2579.59322033898,896.508474576271,33,67,100,100
"./Ship3_Latin-square/2019-08-27_10h00m_Subject 47767.txt","47767",2019-08-27,"10:00",8,77,60,9,8,17,80,18,5,103,25,30,4,59,434,51,76,561,482.55,331.75,2647.42372881356,1187.42372881356,30,59,89,100
"./Ship3_Latin-square/2019-08-27_10h03m_Subject 46884.txt","46884",2019-08-27,"10:03",4,58,44,9,5,14,94,16,37,147,83,45,5,133,184,66,17,267,2963.40909090909,484.704545454545,2832.53488372093,3594.31578947368,44,110,154,91.1111111111111
"./Ship3_Latin-square/2019-08-27_10h03m_Subject 47246.txt","47246",2019-08-27,"10:03",4,82,60,5,17,22,68,19,8,95,72,22,39,133,642,32,193,867,449.3,276.5,2722,1350.62711864407,13,124,137,100
"./Ship3_Latin-square/2019-08-27_11h13m_Subject 46900.txt","46900",2019-08-27,"11:13",4,77,59,9,9,18,78,31,15,124,290,160,109,559,543,64,135,742,499.881355932203,718.310344827586,2806.86206896552,1153.8275862069,31,55,86,100
"./Ship3_Latin-square/2019-08-27_11h13m_Subject 47076.txt","47076",2019-08-27,"11:13",8,83,60,14,9,23,47,12,6,65,67,22,22,111,541,102,96,739,395.816666666667,260.366666666667,2647.42372881356,1084.25423728814,50,60,110,100
"./Ship3_Latin-square/2019-08-27_11h13m_Subject 47082.txt","47082",2019-08-27,"11:13",8,81,60,9,12,21,104,11,6,121,35,12,22,69,449,51,105,605,1079.75,149.116666666667,2552.50847457627,1242.84482758621,35,65,100,98.3606557377049
"./Ship3_Latin-square/2019-08-27_11h13m_Subject 47226.txt","47226",2019-08-27,"11:13",8,86,60,11,15,26,100,21,11,132,46,15,26,87,374,47,138,559,640.933333333333,224.833333333333,2566.05084745763,1720.71929824561,80,45,125,98.3606557377049
"./Ship3_Latin-square/2019-08-27_11h13m_Subject 47227.txt","47227",2019-08-27,"11:13",8,82,60,10,12,22,50,8,8,66,23,14,22,59,573,93,136,802,369.85,117.333333333333,2552.49152542373,1062.5593220339,25,41,66,100
"./Ship3_Latin-square/2019-08-27_11h13m_Subject 47250.txt","47250",2019-08-27,"11:13",2,78,60,10,8,18,55,3,4,62,39,10,15,64,612,96,92,800,372.65,197.15,2905.01694915254,906.655172413793,11,19,30,98.3606557377049
"./Ship3_Latin-square/2019-08-27_11h13m_Subject 47646.txt","47646",2019-08-27,"11:13",8,84,59,11,14,25,65,9,9,83,65,22,25,112,550,84,160,794,689.610169491525,401.796610169492,2572.39655172414,1309.94642857143,34,50,84,96.6666666666667
"./Ship3_Latin-square/2019-08-27_11h13m_Subject 47795.txt","47795",2019-08-27,"11:13",8,86,60,11,15,26,89,11,8,108,55,13,36,104,430,61,195,686,721.816666666667,280.4,2552.52542372881,1068.18644067797,19,47,66,100
"./Ship3_Latin-square/2019-08-27_11h17m_Subject 47229.txt","47229",2019-08-27,"11:17",2,82,60,8,14,22,43,5,3,51,119,19,22,160,881,152,188,1221,182.25,328.5,2877.86440677966,1093.28813559322,38,45,83,100
"./Ship3_Latin-square/2019-08-27_11h17m_Subject 47233.txt","47233",2019-08-27,"11:17",4,80,60,8,12,20,52,9,7,68,84,21,17,122,529,59,158,746,418.05,287.883333333333,2776.27118644068,1363.96610169492,53,41,94,100
"./Ship3_Latin-square/2019-08-27_11h17m_Subject 47777.txt","47777",2019-08-27,"11:17",8,82,60,10,12,22,87,15,13,115,27,2,2,31,471,64,87,622,938.7,331.65,2566.06779661017,1580.18965517241,55,60,115,98.3606557377049
"./Ship3_Latin-square/2019-08-27_12h30m_Subject 46880.txt","46880",2019-08-27,"12:30",4,51,37,11,3,14,187,35,9,231,48,77,9,134,252,92,13,357,3585.83783783784,306.540540540541,2888.66666666667,2013.51515151515,61,37,98,92.1052631578947
"./Ship3_Latin-square/2019-08-27_12h30m_Subject 46882.txt","46882",2019-08-27,"12:30",8,83,60,10,13,23,41,4,9,54,110,19,66,195,758,94,196,1048,370.333333333333,247.366666666667,2552.49152542373,1248.51785714286,76,49,125,98.3606557377049
"./Ship3_Latin-square/2019-08-27_12h30m_Subject 46894.txt","46894",2019-08-27,"12:30",16,81,60,10,11,21,71,8,14,93,49,10,2,61,424,44,100,568,899.783333333333,275.066666666667,2186.4406779661,943.762711864407,20,21,41,100
"./Ship3_Latin-square/2019-08-27_12h30m_Subject 47088.txt","47088",2019-08-27,"12:30",0,84,60,9,15,24,70,9,7,86,78,22,43,143,735,110,163,1008,505.35,228.766666666667,2999.8813559322,996.474576271186,11,81,92,100
"./Ship3_Latin-square/2019-08-27_12h30m_Subject 47228.txt","47228",2019-08-27,"12:30",16,81,60,11,10,21,80,10,8,98,43,9,7,59,407,49,82,538,861.733333333333,207.566666666667,2213.52542372881,1324.91071428571,66,73,139,98.3606557377049
"./Ship3_Latin-square/2019-08-27_12h30m_Subject 47243.txt","47243",2019-08-27,"12:30",16,82,58,16,8,24,108,25,9,142,185,56,23,264,537,79,107,723,524.603448275862,577.275862068965,2420.62068965517,1103,126,56,182,98.3050847457627
"./Ship3_Latin-square/2019-08-27_12h30m_Subject 47249.txt","47249",2019-08-27,"12:30",0,79,60,6,13,19,93,6,11,110,93,26,26,145,495,50,138,683,550.65,182.883333333333,2999.98305084746,1171.81355932203,39,41,80,100
"./Ship3_Latin-square/2019-08-27_12h30m_Subject 47639.txt","47639",2019-08-27,"12:30",16,81,60,14,7,21,49,5,6,60,39,21,19,79,457,54,76,587,446.583333333333,223.55,2349.1186440678,1401.50877192982,97,64,161,96.7213114754098
"./Ship3_Latin-square/2019-08-27_12h30m_Subject 47758.txt","47758",2019-08-27,"12:30",0,83,60,10,13,23,64,8,7,79,34,5,23,62,1103,202,255,1560,218.6,160.4,2999.8813559322,929.186440677966,28,32,60,100
"./Ship3_Latin-square/2019-08-27_12h30m_Subject 47759.txt","47759",2019-08-27,"12:30",0,84,60,3,21,24,45,6,7,58,108,8,39,155,500,15,221,736,433.933333333333,317.366666666667,2999.93220338983,1421.72413793103,23,74,97,98.3606557377049
"./Ship3_Latin-square/2019-08-27_12h30m_Subject 47776.txt","47776",2019-08-27,"12:30",16,82,60,11,11,22,38,2,4,44,100,37,29,166,577,51,158,786,261.033333333333,232.466666666667,2186.40677966102,1193.79661016949,71,40,111,100
"./Ship3_Latin-square/2019-08-27_12h30m_Subject 47799.txt","47799",2019-08-27,"12:30",0,82,60,6,16,22,107,10,51,168,101,10,45,156,553,60,137,750,617.783333333333,376.983333333333,2999.91525423729,1638.18644067797,18,65,83,100
"./Ship3_Latin-square/2019-08-27_12h33m_Subject 46881.txt","46881",2019-08-27,"12:33",8,74,53,10,11,21,84,20,35,139,155,28,49,232,320,43,71,434,771.076923076923,579.230769230769,2569.15384615385,2058.02,45,101,146,98.1132075471698
"./Ship3_Latin-square/2019-08-27_12h33m_Subject 47087.txt","47087",2019-08-27,"12:33",8,51,35,10,6,16,148,21,33,202,61,41,9,111,288,72,70,430,3991.51428571429,317.028571428571,2679.85714285714,1446.57142857143,31,37,68,100
"./Ship3_Latin-square/2019-08-27_12h33m_Subject 47626.txt","47626",2019-08-27,"12:33",4,59,42,12,5,17,114,10,6,130,49,47,10,106,353,77,41,471,2550.33333333333,272.119047619048,2876.14285714286,1546.11904761905,77,36,113,100
"./Ship3_Latin-square/2019-08-27_12h33m_Subject 47634.txt","47634",2019-08-27,"12:33",8,78,54,11,13,24,119,27,27,173,20,18,18,56,317,61,113,491,1140.05555555556,151.759259259259,2607.52830188679,1805.47169811321,81,49,130,100
"./Ship3_Latin-square/2019-08-27_12h33m_Subject 47640.txt","47640",2019-08-27,"12:33",8,52,38,6,8,14,67,13,14,94,79,12,74,165,198,44,46,288,1602.24324324324,515.972972972973,2567.51351351351,2252.66666666667,13,54,67,97.3684210526316
"./Ship3_Latin-square/2019-08-27_12h33m_Subject 47754.txt","47754",2019-08-27,"12:33",16,40,28,9,3,12,67,27,7,101,57,34,1,92,122,35,13,170,2682.32142857143,537.214285714286,2542.82142857143,4371.62962962963,43,43,86,100
"./Ship3_Latin-square/2019-08-27_12h33m_Subject 47800.txt","47800",2019-08-27,"12:33",2,81,60,9,12,21,78,6,13,97,109,28,37,174,485,61,91,637,624.483333333333,312.166666666667,2884.72881355932,1627.66101694915,77,74,151,100
"./Ship3_Latin-square/2019-08-27_13h39m_Subject 46876.txt","46876",2019-08-27,"13:39",4,57,43,10,4,14,155,43,28,226,12,17,0,29,210,51,22,283,2511.72093023256,167.53488372093,2847.5,2707,74,67,141,93.0232558139535
"./Ship3_Latin-square/2019-08-27_13h39m_Subject 46888.txt","46888",2019-08-27,"13:39",2,84,60,7,17,24,30,7,8,45,116,13,74,203,999,141,296,1436,145.25,352.8,2864.38983050847,925.118644067797,28,30,58,100
"./Ship3_Latin-square/2019-08-27_13h39m_Subject 46892.txt","46892",2019-08-27,"13:39",0,80,60,2,18,20,51,0,9,60,24,3,6,33,939,34,253,1226,310.9,167.45,2999.93220338983,1061.49152542373,33,79,112,100
"./Ship3_Latin-square/2019-08-27_13h39m_Subject 46893.txt","46893",2019-08-27,"13:39",16,80,60,9,11,20,47,1,5,53,68,7,28,103,776,74,191,1041,182.383333333333,211.4,2213.50847457627,974.71186440678,51,72,123,100
"./Ship3_Latin-square/2019-08-27_13h39m_Subject 47097.txt","47097",2019-08-27,"13:39",8,77,60,7,10,17,32,3,10,45,108,11,13,132,588,74,109,771,213.95,312.866666666667,2566.08474576271,1402.30508474576,60,56,116,100
"./Ship3_Latin-square/2019-08-27_13h39m_Subject 47099.txt","47099",2019-08-27,"13:39",0,87,60,7,20,27,28,6,19,53,83,58,55,196,1014,90,363,1467,167.15,232.9,2999.8813559322,885.152542372881,15,50,65,100
"./Ship3_Latin-square/2019-08-27_13h39m_Subject 47638.txt","47638",2019-08-27,"13:39",16,77,56,10,11,21,90,9,17,116,49,20,19,88,215,32,34,281,1398.73214285714,259.053571428571,2199.875,1541.7962962963,69,43,112,96.4912280701754
"./Ship3_Latin-square/2019-08-27_13h39m_Subject 47757.txt","47757",2019-08-27,"13:39",0,73,56,5,12,17,134,7,31,172,106,10,31,147,401,40,110,551,1396.96428571429,407.321428571429,2999.83636363636,1703.70909090909,44,114,158,100
"./Ship3_Latin-square/2019-08-27_13h39m_Subject 47769.txt","47769",2019-08-27,"13:39",16,84,60,14,10,24,55,10,14,79,49,16,21,86,546,63,121,730,382.65,171.15,2267.77966101695,953.423728813559,41,34,75,100
"./Ship3_Latin-square/2019-08-27_13h39m_Subject 47771.txt","47771",2019-08-27,"13:39",2,81,60,9,12,21,45,10,5,60,25,19,22,66,632,95,160,887,344.233333333333,209.833333333333,2891.50847457627,969.678571428571,24,59,83,96.7213114754098
"./Ship3_Latin-square/2019-08-27_13h39m_Subject 47775.txt","47775",2019-08-27,"13:39",2,82,60,8,14,22,57,5,10,72,17,5,7,29,562,85,113,760,342.716666666667,160.933333333333,2877.96610169492,1267.16949152542,53,16,69,100
"./Ship3_Latin-square/2019-08-27_13h39m_Subject 47781.txt","47781",2019-08-27,"13:39",8,80,60,8,12,20,73,8,7,88,63,13,23,99,587,40,207,834,548.066666666667,188.216666666667,2552.50847457627,1017.69491525424,32,26,58,100
"./Ship3_Latin-square/2019-08-27_13h39m_Subject 47782.txt","47782",2019-08-27,"13:39",0,79,60,8,11,19,16,6,7,29,23,1,19,43,903,124,139,1166,221.033333333333,118.683333333333,2999.8813559322,1024.22033898305,21,31,52,100
"./Ship3_Latin-square/2019-08-27_13h39m_Subject 47783.txt","47783",2019-08-27,"13:39",8,78,60,8,10,18,76,12,6,94,72,4,13,89,536,76,123,735,768.966666666667,460.666666666667,2566.06779661017,1537.61016949153,39,71,110,100
"./Ship3_Latin-square/2019-08-27_13h39m_Subject 47785.txt","47785",2019-08-27,"13:39",8,82,60,8,14,22,40,7,8,55,39,12,39,90,714,85,175,974,340.283333333333,231.016666666667,2525.40677966102,1190.01694915254,32,46,78,100
"./Ship3_Latin-square/2019-08-27_13h39m_Subject 47788.txt","47788",2019-08-27,"13:39",0,79,60,6,13,19,67,3,15,85,95,13,28,136,546,78,90,714,365.616666666667,261.033333333333,2999.89830508475,1308.74576271186,28,30,58,100
"./Ship3_Latin-square/2019-08-27_15h01m_Subject 47080.txt","47080",2019-08-27,"15:01",16,86,60,12,14,26,50,7,13,70,31,10,11,52,493,37,189,719,252.783333333333,167.183333333333,2159.27118644068,1038.29310344828,37,46,83,98.3606557377049
"./Ship3_Latin-square/2019-08-27_15h01m_Subject 47089.txt","47089",2019-08-27,"15:01",2,51,38,10,3,13,136,25,2,163,181,45,6,232,201,37,31,269,2495.71052631579,754.947368421053,2931.57894736842,2719.28947368421,63,29,92,100
"./Ship3_Latin-square/2019-08-27_15h01m_Subject 47791.txt","47791",2019-08-27,"15:01",4,73,50,9,14,23,71,33,44,148,58,63,43,164,297,52,109,458,652.14,355.82,2759.92,1499.95744680851,25,96,121,94.1176470588235
"./Ship3_Latin-square/2019-08-28_10h03m_Subject 46885.txt","46885",2019-08-28,"10:03",4,78,55,9,14,23,180,23,32,235,62,4,42,108,491,74,97,662,1013.90909090909,284,2762.92592592593,1628.83636363636,100,90,190,100
"./Ship3_Latin-square/2019-08-28_10h03m_Subject 47238.txt","47238",2019-08-28,"10:03",2,77,60,7,10,17,41,7,4,52,88,14,27,129,727,92,95,914,410.15,323.233333333333,2894.8813559322,854.796610169491,23,32,55,100
"./Ship3_Latin-square/2019-08-28_10h03m_Subject 47242.txt","47242",2019-08-28,"10:03",2,78,60,5,13,18,57,2,8,67,131,16,65,212,611,51,123,785,329.8,287.85,2877.93220338983,1066.89830508475,23,42,65,100
"./Ship3_Latin-square/2019-08-28_10h03m_Subject 47244.txt","47244",2019-08-28,"10:03",4,67,48,11,8,19,197,60,28,285,107,55,121,283,396,86,92,574,1424.29166666667,341.166666666667,2829.76595744681,1653.44680851064,43,61,104,100
"./Ship3_Latin-square/2019-08-28_10h03m_Subject 47767.txt","47767",2019-08-28,"10:03",2,80,60,7,13,20,61,7,14,82,19,9,7,35,492,56,115,663,615.383333333333,270.783333333333,2877.91525423729,1335.43103448276,37,68,105,98.3606557377049
"./Ship3_Latin-square/2019-08-28_10h07m_Subject 46884.txt","46884",2019-08-28,"10:07",8,55,40,6,9,15,88,11,25,124,44,12,28,84,185,30,47,262,2638.675,343.45,2559.95,3346.13513513513,28,88,116,97.5609756097561
"./Ship3_Latin-square/2019-08-28_10h07m_Subject 47083.txt","47083",2019-08-28,"10:07",4,60,42,10,8,18,146,20,21,187,48,16,12,76,279,53,61,393,2971.26829268293,372.170731707317,2814.58536585366,1503.09756097561,50,49,99,100
"./Ship3_Latin-square/2019-08-28_10h07m_Subject 47246.txt","47246",2019-08-28,"10:07",8,83,60,7,16,23,57,10,11,78,63,14,23,100,515,56,171,742,361.266666666667,303.516666666667,2484.71186440678,1477.47457627119,48,108,156,100
"./Ship3_Latin-square/2019-08-28_11h18m_Subject 46900.txt","46900",2019-08-28,"11:18",8,83,60,11,12,23,51,10,8,69,73,54,48,175,574,66,175,815,289.4,284.416666666667,2579.59322033898,1105.32203389831,31,39,70,100
"./Ship3_Latin-square/2019-08-28_11h18m_Subject 47076.txt","47076",2019-08-28,"11:18",2,86,60,13,13,26,41,4,8,53,32,18,29,79,852,180,257,1289,257.25,172.166666666667,2898.28813559322,1132.50847457627,57,63,120,100
"./Ship3_Latin-square/2019-08-28_11h18m_Subject 47079.txt","47079",2019-08-28,"11:18",4,79,59,13,7,20,77,11,9,97,112,21,10,143,419,104,54,577,828.254237288136,677.01724137931,2848.22413793103,1448.375,94,65,159,96.6101694915254
"./Ship3_Latin-square/2019-08-28_11h18m_Subject 47082.txt","47082",2019-08-28,"11:18",2,66,48,9,9,18,90,11,11,112,60,20,49,129,237,64,33,334,1769.9375,313.4375,2904.14583333333,2472.23404255319,40,49,89,97.9591836734694
"./Ship3_Latin-square/2019-08-28_11h18m_Subject 47092.txt","47092",2019-08-28,"11:18",4,80,60,8,12,20,37,4,5,46,109,18,23,150,711,98,178,987,199.783333333333,346.816666666667,2776.20338983051,1239.08474576271,58,46,104,100
"./Ship3_Latin-square/2019-08-28_11h18m_Subject 47226.txt","47226",2019-08-28,"11:18",2,79,60,8,11,19,86,7,20,113,47,7,23,77,488,94,117,699,521.016666666667,213.616666666667,2884.71186440678,1878,57,64,121,98.3606557377049
"./Ship3_Latin-square/2019-08-28_11h18m_Subject 47227.txt","47227",2019-08-28,"11:18",2,79,60,9,10,19,65,6,4,75,25,29,11,65,590,82,135,807,685.733333333333,142.883333333333,2888.13559322034,1069.91525423729,18,35,53,100
"./Ship3_Latin-square/2019-08-28_11h18m_Subject 47250.txt","47250",2019-08-28,"11:18",16,82,60,12,10,22,61,14,6,81,45,21,21,87,516,53,107,676,471.066666666667,179.2,2294.8813559322,856.372881355932,12,21,33,100
"./Ship3_Latin-square/2019-08-28_11h18m_Subject 47646.txt","47646",2019-08-28,"11:18",2,77,60,10,7,17,85,5,5,95,62,26,2,90,877,89,136,1102,403.583333333333,475.933333333333,2901.62711864407,1021.06779661017,26,41,67,100
"./Ship3_Latin-square/2019-08-28_11h18m_Subject 47760.txt","47760",2019-08-28,"11:18",4,72,53,10,9,19,123,9,25,157,80,45,25,150,456,86,78,620,1140.09433962264,567.188679245283,2803.69811320755,1161.64150943396,26,55,81,100
"./Ship3_Latin-square/2019-08-28_11h18m_Subject 47795.txt","47795",2019-08-28,"11:18",2,81,60,10,11,21,95,22,13,130,70,16,12,98,547,115,82,744,567.766666666667,330.416666666667,2898.20338983051,1284.16949152542,34,30,64,100
"./Ship3_Latin-square/2019-08-28_11h22m_Subject 47229.txt","47229",2019-08-28,"11:22",16,78,60,6,12,18,60,4,14,78,99,8,24,131,596,34,208,838,176.366666666667,282.633333333333,2077.96610169492,982.305084745763,31,65,96,100
"./Ship3_Latin-square/2019-08-28_11h22m_Subject 47233.txt","47233",2019-08-28,"11:22",8,86,60,12,14,26,40,15,15,70,113,42,26,181,672,118,169,959,191.166666666667,316.883333333333,2566.08474576271,1164.54237288136,71,93,164,100
"./Ship3_Latin-square/2019-08-28_11h22m_Subject 47247.txt","47247",2019-08-28,"11:22",4,80,60,7,13,20,58,11,11,80,99,11,11,121,401,49,73,523,477.533333333333,560.916666666667,2769.4406779661,1464.40677966102,33,54,87,100
"./Ship3_Latin-square/2019-08-28_11h22m_Subject 47777.txt","47777",2019-08-28,"11:22",2,80,60,9,11,20,71,8,16,95,11,5,8,24,490,77,109,676,620.983333333333,381.566666666667,2894.83050847458,1647.22413793103,83,70,153,100
"./Ship3_Latin-square/2019-08-28_11h22m_Subject 47784.txt","47784",2019-08-28,"11:22",4,86,60,6,20,26,149,10,10,169,64,7,53,124,1011,87,383,1481,492.833333333333,222.366666666667,2701.66101694915,932.661016949153,13,15,28,100
"./Ship3_Latin-square/2019-08-28_12h36m_Subject 46880.txt","46880",2019-08-28,"12:36",8,84,60,10,14,24,64,6,10,80,36,5,17,58,344,48,84,476,534.966666666667,244.316666666667,2552.49152542373,1815.44642857143,68,76,144,96.7213114754098
"./Ship3_Latin-square/2019-08-28_12h36m_Subject 46882.txt","46882",2019-08-28,"12:36",2,79,60,8,11,19,49,4,2,55,85,10,38,133,836,105,216,1157,308.083333333333,289.4,2898.23728813559,1611.94827586207,93,40,133,100
"./Ship3_Latin-square/2019-08-28_12h36m_Subject 46894.txt","46894",2019-08-28,"12:36",0,80,60,3,17,20,65,2,12,79,25,0,15,40,742,68,169,979,305.166666666667,121.183333333333,2999.94915254237,1095.98305084746,20,43,63,100
"./Ship3_Latin-square/2019-08-28_12h36m_Subject 47088.txt","47088",2019-08-28,"12:36",24,79,60,12,7,19,123,23,19,165,105,23,15,143,268,15,57,340,870.6,278.633333333333,1983.03389830508,785.344827586207,12,41,53,98.3606557377049
"./Ship3_Latin-square/2019-08-28_12h36m_Subject 47228.txt","47228",2019-08-28,"12:36",0,79,60,7,12,19,51,4,5,60,65,2,20,87,550,69,106,725,448.366666666667,211.433333333333,2999.8813559322,1273.18644067797,33,62,95,100
"./Ship3_Latin-square/2019-08-28_12h36m_Subject 47243.txt","47243",2019-08-28,"12:36",0,82,60,6,16,22,147,11,9,167,97,40,27,164,839,89,299,1227,493.866666666667,311.3,2999.93220338983,1193.01694915254,62,94,156,100
"./Ship3_Latin-square/2019-08-28_12h36m_Subject 47249.txt","47249",2019-08-28,"12:36",24,76,54,14,8,22,81,19,11,111,87,38,17,142,189,15,41,245,1137.07407407407,225.166666666667,2111.09259259259,1392.14814814815,42,24,66,100
"./Ship3_Latin-square/2019-08-28_12h36m_Subject 47639.txt","47639",2019-08-28,"12:36",0,82,60,9,13,22,35,9,8,52,32,7,37,76,783,114,178,1075,235.016666666667,144.583333333333,2999.84745762712,1192.65517241379,50,76,126,98.3606557377049
"./Ship3_Latin-square/2019-08-28_12h36m_Subject 47758.txt","47758",2019-08-28,"12:36",24,81,60,15,6,21,133,14,19,166,30,11,4,45,396,6,58,460,803.133333333333,150.133333333333,2105.03389830508,927.932203389831,62,11,73,100
"./Ship3_Latin-square/2019-08-28_12h36m_Subject 47759.txt","47759",2019-08-28,"12:36",24,80,60,11,9,20,55,15,8,78,55,17,16,88,251,8,63,322,464.983333333333,218.883333333333,1901.62711864407,1191,66,43,109,93.4426229508197
"./Ship3_Latin-square/2019-08-28_12h36m_Subject 47776.txt","47776",2019-08-28,"12:36",0,82,60,5,17,22,32,2,11,45,78,16,60,154,964,101,222,1287,191.6,211.983333333333,2999.89830508475,1455.05084745763,33,63,96,100
"./Ship3_Latin-square/2019-08-28_12h36m_Subject 47799.txt","47799",2019-08-28,"12:36",24,76,56,10,10,20,142,12,25,179,191,94,39,324,245,3,67,315,945.803571428571,547.892857142857,1842.80357142857,1289.14814814815,43,44,87,96.4912280701754
"./Ship3_Latin-square/2019-08-28_12h40m_Subject 46881.txt","46881",2019-08-28,"12:40",2,79,56,7,16,23,117,10,15,142,175,31,50,256,425,54,142,621,946.821428571429,552.803571428571,2875,1800.51785714286,45,113,158,100
"./Ship3_Latin-square/2019-08-28_12h40m_Subject 47087.txt","47087",2019-08-28,"12:40",2,66,49,6,11,17,133,5,41,179,115,6,15,136,350,47,79,476,1677.70833333333,460.083333333333,2883.29166666667,1435.27083333333,21,69,90,100
"./Ship3_Latin-square/2019-08-28_12h40m_Subject 47626.txt","47626",2019-08-28,"12:40",8,82,60,9,13,22,102,13,13,128,116,21,34,171,376,42,73,491,814.266666666667,340.466666666667,2525.40677966102,1699.93220338983,45,68,113,100
"./Ship3_Latin-square/2019-08-28_12h40m_Subject 47634.txt","47634",2019-08-28,"12:40",2,83,60,12,11,23,95,21,20,136,37,16,18,71,468,80,109,657,675.016666666667,264.8,2901.62711864407,1393.20338983051,95,35,130,98.3606557377049
"./Ship3_Latin-square/2019-08-28_12h40m_Subject 47640.txt","47640",2019-08-28,"12:40",2,79,60,9,10,19,103,9,19,131,61,10,33,104,805,117,127,1049,894.85,206.533333333333,2901.66101694915,1445.76271186441,67,42,109,100
"./Ship3_Latin-square/2019-08-28_12h40m_Subject 47754.txt","47754",2019-08-28,"12:40",0,57,40,7,10,17,93,25,11,129,40,29,62,131,253,41,87,381,2733.1,315.1,2999.89743589744,3324.88888888889,24,138,162,92.6829268292683
"./Ship3_Latin-square/2019-08-28_12h40m_Subject 47800.txt","47800",2019-08-28,"12:40",16,82,60,5,17,22,102,10,32,144,83,9,45,137,298,19,147,464,650.066666666667,216.616666666667,1915.22033898305,1519.91525423729,45,46,91,100
"./Ship3_Latin-square/2019-08-28_13h47m_Subject 46876.txt","46876",2019-08-28,"13:47",8,80,58,10,12,22,92,27,19,138,40,10,63,113,293,35,106,434,812.017543859649,237.263157894737,2564.89473684211,2007.39622641509,42,117,159,94.8275862068966
"./Ship3_Latin-square/2019-08-28_13h47m_Subject 46893.txt","46893",2019-08-28,"13:47",0,81,60,9,12,21,46,10,3,59,51,6,13,70,1057,159,263,1479,172.533333333333,201.65,2999.89830508475,1242.71186440678,66,79,145,100
"./Ship3_Latin-square/2019-08-28_13h47m_Subject 47638.txt","47638",2019-08-28,"13:47",0,74,54,11,9,20,126,18,16,160,53,20,70,143,401,71,43,515,1186.7962962963,255.87037037037,2999.81481481481,1878.75925925926,59,67,126,100
"./Ship3_Latin-square/2019-08-28_13h47m_Subject 47757.txt","47757",2019-08-28,"13:47",24,67,50,10,7,17,130,30,14,174,67,20,13,100,221,11,63,295,1777.68,283.34,1971.38775510204,1625.14583333333,66,75,141,96.078431372549
"./Ship3_Latin-square/2019-08-28_13h47m_Subject 47769.txt","47769",2019-08-28,"13:47",0,83,60,14,9,23,46,13,10,69,26,19,52,97,970,262,152,1384,318.5,132.85,2999.91525423729,1004.08474576271,67,82,149,100
"./Ship3_Latin-square/2019-08-28_13h47m_Subject 47771.txt","47771",2019-08-28,"13:47",16,79,60,12,7,19,40,2,4,46,16,18,0,34,568,56,110,734,313.516666666667,142.483333333333,2322,858.333333333333,34,23,57,98.3606557377049
"./Ship3_Latin-square/2019-08-28_13h47m_Subject 47775.txt","47775",2019-08-28,"13:47",16,85,60,12,13,25,94,8,12,114,48,19,11,78,321,39,126,486,567.483333333333,199.833333333333,2186.35593220339,1294.06896551724,59,37,96,98.3606557377049
"./Ship3_Latin-square/2019-08-28_13h47m_Subject 47781.txt","47781",2019-08-28,"13:47",2,78,60,7,11,18,57,8,9,74,95,20,14,129,913,90,179,1182,400.85,365.183333333333,2891.42372881356,1135.22033898305,43,30,73,100
"./Ship3_Latin-square/2019-08-28_13h47m_Subject 47782.txt","47782",2019-08-28,"13:47",24,81,60,11,10,21,55,3,15,73,25,59,8,92,413,7,115,535,258.55,118.4,1860.96610169492,813.78431372549,10,43,53,90.1639344262295
"./Ship3_Latin-square/2019-08-28_13h47m_Subject 47783.txt","47783",2019-08-28,"13:47",2,79,60,9,10,19,65,10,10,85,54,12,10,76,633,101,134,868,1145.73333333333,216.566666666667,2898.25423728814,1600.61016949153,46,58,104,100
"./Ship3_Latin-square/2019-08-28_13h47m_Subject 47785.txt","47785",2019-08-28,"13:47",2,84,60,13,11,24,29,1,7,37,40,19,24,83,864,190,138,1192,414.9,275.95,2901.66101694915,1224.4406779661,32,38,70,100
"./Ship3_Latin-square/2019-08-28_13h47m_Subject 47788.txt","47788",2019-08-28,"13:47",24,77,60,9,8,17,140,14,27,181,93,18,13,124,222,2,44,268,817.866666666667,278.7,1820.28813559322,1170.96610169492,28,37,65,100
"./Ship3_Latin-square/2019-08-28_13h50m_Subject 46888.txt","46888",2019-08-28,"13:50",16,83,60,12,11,23,46,3,11,60,129,28,64,221,753,85,214,1052,169.766666666667,269.666666666667,2186.40677966102,758.016949152542,15,45,60,100
"./Ship3_Latin-square/2019-08-28_13h50m_Subject 46889.txt","46889",2019-08-28,"13:50",4,83,60,8,15,23,96,12,10,118,46,13,15,74,870,138,213,1221,467.733333333333,204.7,2742.32203389831,1029.62711864407,32,83,115,100
"./Ship3_Latin-square/2019-08-28_13h50m_Subject 46892.txt","46892",2019-08-28,"13:50",24,88,60,16,12,28,79,20,17,116,40,26,37,103,429,17,142,588,414.5,245.55,1942.28813559322,1028.54716981132,52,75,127,91.8032786885246
"./Ship3_Latin-square/2019-08-28_13h50m_Subject 47097.txt","47097",2019-08-28,"13:50",2,74,60,8,6,14,58,2,5,65,85,17,8,110,753,70,95,918,291.6,331.7,2905.01694915254,1373.71186440678,75,69,144,100
"./Ship3_Latin-square/2019-08-28_13h50m_Subject 47099.txt","47099",2019-08-28,"13:50",24,78,56,15,7,22,233,12,55,300,106,30,10,146,555,21,60,636,1022.51785714286,495,2099.96428571429,850.589285714286,44,45,89,100
"./Ship3_Latin-square/2019-08-28_15h01m_Subject 47080.txt","47080",2019-08-28,"15:01",0,79,60,7,12,19,43,4,14,61,48,7,7,62,629,75,109,813,543.916666666667,234.133333333333,2999.91525423729,1117.5,26,39,65,98.3606557377049
"./Ship3_Latin-square/2019-08-28_15h01m_Subject 47089.txt","47089",2019-08-28,"15:01",16,62,47,12,3,15,83,25,5,113,54,25,4,83,243,27,11,281,1954.04347826087,279.739130434783,2478.15217391304,1425.46666666667,63,35,98,97.8723404255319
"./Ship3_Latin-square/2019-08-28_15h01m_Subject 47791.txt","47791",2019-08-28,"15:01",8,82,60,11,11,22,61,22,10,93,66,18,28,112,591,84,119,794,428.7,221.4,2606.71186440678,1121.61016949153,26,27,53,100
"./Ship3_Latin-square/2019-08-29_10h12m_Subject 46885.txt","46885",2019-08-29,"10:12",8,83,60,11,12,23,87,10,17,114,33,12,20,65,394,61,91,546,711.483333333333,164.183333333333,2606.72881355932,1304.49152542373,56,56,112,100
"./Ship3_Latin-square/2019-08-29_10h12m_Subject 46899.txt","46899",2019-08-29,"10:12",4,67,51,13,3,16,121,20,42,183,40,28,4,72,534,97,40,671,1779.26,201.32,2871.86,1246.61224489796,45,64,109,98.0392156862745
"./Ship3_Latin-square/2019-08-29_10h12m_Subject 47091.txt","47091",2019-08-29,"10:12",4,68,54,7,7,14,122,13,10,145,76,18,19,113,260,40,45,345,1948.61111111111,212.574074074074,2811.2641509434,2047.7358490566,76,58,134,100
"./Ship3_Latin-square/2019-08-29_10h12m_Subject 47231.txt","47231",2019-08-29,"10:12",4,69,51,13,5,18,103,30,10,143,37,26,11,74,225,41,38,304,1526.3137254902,259.529411764706,2858.66666666667,1336.64705882353,42,11,53,100
"./Ship3_Latin-square/2019-08-29_10h12m_Subject 47238.txt","47238",2019-08-29,"10:12",16,78,60,14,4,18,40,7,8,55,84,19,2,105,462,59,29,550,543.216666666667,263.8,2376.22033898305,1129.35087719298,94,53,147,98.3606557377049
"./Ship3_Latin-square/2019-08-29_10h12m_Subject 47242.txt","47242",2019-08-29,"10:12",16,84,60,10,14,24,40,8,7,55,83,15,37,135,491,50,183,724,279.1,211,2050.76271186441,891,17,48,65,100
"./Ship3_Latin-square/2019-08-29_10h12m_Subject 47244.txt","47244",2019-08-29,"10:12",8,82,60,7,15,22,78,7,10,95,107,23,31,161,675,62,210,947,553.733333333333,284.516666666667,2511.83050847458,1358.32203389831,58,108,166,100
"./Ship3_Latin-square/2019-08-29_10h12m_Subject 47752.txt","47752",2019-08-29,"10:12",4,82,60,11,11,22,113,23,7,143,48,33,43,124,659,76,225,960,678.733333333333,213.5,2789.81355932203,1120.74137931034,51,78,129,98.3606557377049
"./Ship3_Latin-square/2019-08-29_10h12m_Subject 47767.txt","47767",2019-08-29,"10:12",16,80,60,10,10,20,58,5,9,72,29,21,5,55,335,52,106,493,417.966666666667,202.883333333333,2186.42372881356,1036.1320754717,36,100,136,95.0819672131148
"./Ship3_Latin-square/2019-08-29_10h15m_Subject 46884.txt","46884",2019-08-29,"10:15",2,81,60,8,13,21,76,21,10,107,84,16,27,127,395,40,77,512,674.933333333333,383.366666666667,2881.30508474576,2045.03703703704,46,95,141,95.0819672131148
"./Ship3_Latin-square/2019-08-29_10h15m_Subject 47083.txt","47083",2019-08-29,"10:15",8,79,58,8,13,21,99,11,17,127,65,13,18,96,488,51,155,694,1266.77192982456,365.894736842105,2536.75438596491,1476.94736842105,58,59,117,100
"./Ship3_Latin-square/2019-08-29_10h15m_Subject 47246.txt","47246",2019-08-29,"10:15",2,81,60,7,14,21,83,11,16,110,81,16,20,117,650,89,140,879,374.95,268.466666666667,2874.5593220339,1344.76271186441,24,80,104,100
"./Ship3_Latin-square/2019-08-29_11h23m_Subject 47229.txt","47229",2019-08-29,"11:23",0,76,60,7,9,16,31,4,1,36,90,13,9,112,883,97,122,1102,173.516666666667,284.216666666667,2999.89830508475,1160.81355932203,26,74,100,100
"./Ship3_Latin-square/2019-08-29_11h23m_Subject 47233.txt","47233",2019-08-29,"11:23",2,81,60,9,12,21,45,3,12,60,95,20,25,140,586,74,137,797,180.35,279.816666666667,2891.47457627119,1409.30508474576,48,72,120,100
"./Ship3_Latin-square/2019-08-29_11h23m_Subject 47247.txt","47247",2019-08-29,"11:23",8,78,60,7,11,18,38,2,9,49,59,8,11,78,323,27,82,432,397.4,256.733333333333,2566.08474576271,1586.98275862069,66,49,115,98.3606557377049
"./Ship3_Latin-square/2019-08-29_11h23m_Subject 47777.txt","47777",2019-08-29,"11:23",16,79,60,10,9,19,91,8,19,118,19,4,3,26,408,43,86,537,552.333333333333,243.15,2240.66101694915,1303.64406779661,83,59,142,100
"./Ship3_Latin-square/2019-08-29_11h23m_Subject 47784.txt","47784",2019-08-29,"11:23",8,74,60,9,5,14,81,6,6,93,83,20,11,114,941,83,87,1111,285.166666666667,194.433333333333,2647.42372881356,973.338983050847,50,12,62,100
"./Ship3_Latin-square/2019-08-29_11h32m_Subject 46900.txt","46900",2019-08-29,"11:32",2,79,60,9,10,19,48,10,7,65,62,17,15,94,794,116,146,1056,314.483333333333,228.15,2894.83050847458,1165.27118644068,38,64,102,100
"./Ship3_Latin-square/2019-08-29_11h32m_Subject 47076.txt","47076",2019-08-29,"11:32",16,85,60,13,12,25,62,5,13,80,40,22,23,85,444,51,137,632,416.983333333333,186.016666666667,2186.38983050847,1022.35593220339,46,57,103,100
"./Ship3_Latin-square/2019-08-29_11h32m_Subject 47079.txt","47079",2019-08-29,"11:32",8,78,60,10,8,18,75,6,4,85,58,8,16,82,407,43,68,518,578.316666666667,406.65,2620.25423728814,1605.49152542373,80,70,150,100
"./Ship3_Latin-square/2019-08-29_11h32m_Subject 47082.txt","47082",2019-08-29,"11:32",16,78,60,9,9,18,47,3,8,58,34,5,18,57,426,39,67,532,383.316666666667,148.683333333333,2186.35593220339,1123.41379310345,74,51,125,98.3606557377049
"./Ship3_Latin-square/2019-08-29_11h32m_Subject 47092.txt","47092",2019-08-29,"11:32",8,73,60,7,6,13,44,3,4,51,124,16,15,155,597,59,71,727,351.35,318.2,2593.18644067797,1098.98305084746,57,38,95,100
"./Ship3_Latin-square/2019-08-29_11h32m_Subject 47226.txt","47226",2019-08-29,"11:32",16,80,60,9,11,20,93,15,13,121,79,6,22,107,281,16,116,413,1024.61666666667,277.483333333333,2159.22033898305,1635.69491525424,56,46,102,100
"./Ship3_Latin-square/2019-08-29_11h32m_Subject 47227.txt","47227",2019-08-29,"11:32",16,79,60,9,10,19,50,5,11,66,39,10,35,84,446,26,99,571,508,125.716666666667,2159.23728813559,1022.25862068966,40,56,96,98.3606557377049
"./Ship3_Latin-square/2019-08-29_11h32m_Subject 47250.txt","47250",2019-08-29,"11:32",0,80,60,10,10,20,48,6,10,64,22,8,25,55,857,152,129,1138,274.666666666667,143.716666666667,2999.81355932203,907.084745762712,7,18,25,100
"./Ship3_Latin-square/2019-08-29_11h32m_Subject 47646.txt","47646",2019-08-29,"11:32",16,79,60,10,9,19,63,8,7,78,66,11,8,85,472,39,128,639,434.05,242.933333333333,2213.50847457627,993.389830508475,24,31,55,100
"./Ship3_Latin-square/2019-08-29_11h32m_Subject 47755.txt","47755",2019-08-29,"11:32",4,77,60,6,11,17,97,8,13,118,100,31,13,144,600,55,121,776,579,414.683333333333,2776.25423728814,1520.01694915254,56,167,223,100
"./Ship3_Latin-square/2019-08-29_11h32m_Subject 47760.txt","47760",2019-08-29,"11:32",8,84,60,10,14,24,96,14,14,124,57,14,26,97,578,74,168,820,475.566666666667,191.85,2566.05084745763,1095.45762711864,42,37,79,100
"./Ship3_Latin-square/2019-08-29_11h32m_Subject 47795.txt","47795",2019-08-29,"11:32",16,81,60,12,9,21,75,13,14,102,72,14,11,97,370,46,60,476,638.15,262.683333333333,2349.06779661017,1330.93220338983,59,25,84,100
"./Ship3_Latin-square/2019-08-29_12h42m_Subject 46880.txt","46880",2019-08-29,"12:42",2,83,60,8,15,23,63,3,7,73,60,21,36,117,577,70,144,791,421.916666666667,345.816666666667,2874.52542372881,1458.80701754386,47,129,176,100
"./Ship3_Latin-square/2019-08-29_12h42m_Subject 46882.txt","46882",2019-08-29,"12:42",16,81,60,8,13,21,43,1,10,54,69,9,37,115,370,21,124,515,615.816666666667,201.95,2077.94915254237,1394.07692307692,44,60,104,88.5245901639344
"./Ship3_Latin-square/2019-08-29_12h42m_Subject 46894.txt","46894",2019-08-29,"12:42",24,83,60,13,10,23,82,9,22,113,22,10,8,40,366,11,74,451,713.016666666667,119.283333333333,1860.93220338983,809.189655172414,43,22,65,98.3606557377049
"./Ship3_Latin-square/2019-08-29_12h42m_Subject 47088.txt","47088",2019-08-29,"12:42",2,81,60,8,13,21,73,3,3,79,113,20,26,159,959,182,257,1398,400.983333333333,329.05,2888.08474576271,864.661016949153,3,64,67,100
"./Ship3_Latin-square/2019-08-29_12h42m_Subject 47228.txt","47228",2019-08-29,"12:42",24,82,60,10,12,22,77,5,9,91,48,3,24,75,297,11,116,424,418.216666666667,196.283333333333,1738.94915254237,1135.625,37,39,76,100
"./Ship3_Latin-square/2019-08-29_12h42m_Subject 47243.txt","47243",2019-08-29,"12:42",24,51,37,13,1,14,194,11,9,214,20,55,0,75,356,11,11,378,4569,188.513513513514,2481.05405405405,1254.41666666667,75,19,94,97.3684210526316
"./Ship3_Latin-square/2019-08-29_12h42m_Subject 47249.txt","47249",2019-08-29,"12:42",2,83,59,13,11,24,120,29,13,162,141,49,101,291,425,91,93,609,497.949152542373,421.186440677966,2906.79310344828,1500.8813559322,43,34,77,100
"./Ship3_Latin-square/2019-08-29_12h42m_Subject 47639.txt","47639",2019-08-29,"12:42",24,84,60,14,10,24,63,7,23,93,51,25,9,85,464,12,143,619,306.7,201.2,2023.67796610169,1156.49122807018,64,30,94,96.7213114754098
"./Ship3_Latin-square/2019-08-29_12h42m_Subject 47649.txt","47649",2019-08-29,"12:42",4,75,60,6,9,15,106,20,19,145,70,6,17,93,316,39,64,419,930.366666666667,306.983333333333,2776.23728813559,2452.40425531915,72,162,234,83.6065573770492
"./Ship3_Latin-square/2019-08-29_12h42m_Subject 47758.txt","47758",2019-08-29,"12:42",2,84,60,7,17,24,27,3,0,30,38,2,11,51,886,91,266,1243,223.6,234.083333333333,2874.52542372881,1086.49152542373,44,23,67,100
"./Ship3_Latin-square/2019-08-29_12h42m_Subject 47759.txt","47759",2019-08-29,"12:42",2,80,60,3,17,20,73,0,21,94,63,15,25,103,619,23,172,814,314.6,212.7,2860.98305084746,1579.87931034483,31,66,97,98.3606557377049
"./Ship3_Latin-square/2019-08-29_12h42m_Subject 47776.txt","47776",2019-08-29,"12:42",24,78,60,10,8,18,71,9,14,94,67,19,10,96,563,7,126,696,313.4,180.933333333333,1901.59322033898,896.305084745763,32,29,61,100
"./Ship3_Latin-square/2019-08-29_12h42m_Subject 47799.txt","47799",2019-08-29,"12:42",2,83,60,7,16,23,97,3,12,112,152,23,93,268,548,64,119,731,525.583333333333,490.35,2871.16949152542,1275.06779661017,37,37,74,100
"./Ship3_Latin-square/2019-08-29_12h45m_Subject 46881.txt","46881",2019-08-29,"12:45",16,82,60,10,12,22,71,6,12,89,49,5,22,76,395,48,111,554,537.416666666667,194.766666666667,2132.13559322034,1570.89090909091,83,93,176,95.0819672131148
"./Ship3_Latin-square/2019-08-29_12h45m_Subject 47087.txt","47087",2019-08-29,"12:45",16,82,60,9,13,22,83,13,34,130,48,22,16,86,338,39,74,451,725.316666666667,180.15,2132.18644067797,1140.8275862069,34,49,83,98.3606557377049
"./Ship3_Latin-square/2019-08-29_12h45m_Subject 47626.txt","47626",2019-08-29,"12:45",2,77,60,9,8,17,64,2,7,73,148,72,12,232,394,59,46,499,718.683333333333,379.866666666667,2898.28813559322,1907.20689655172,77,49,126,98.3606557377049
"./Ship3_Latin-square/2019-08-29_12h45m_Subject 47634.txt","47634",2019-08-29,"12:45",16,76,54,12,10,22,111,26,20,157,44,19,21,84,245,30,70,345,1382.28301886792,317.528301886792,2245.22641509434,1185.49056603774,68,47,115,98.1481481481482
"./Ship3_Latin-square/2019-08-29_12h45m_Subject 47640.txt","47640",2019-08-29,"12:45",16,77,60,9,8,17,112,8,11,131,61,11,24,96,474,28,123,625,888.266666666667,163.133333333333,2213.52542372881,931.203389830509,16,62,78,100
"./Ship3_Latin-square/2019-08-29_12h45m_Subject 47754.txt","47754",2019-08-29,"12:45",24,58,42,11,5,16,88,14,9,111,52,15,10,77,211,3,26,240,2648.33333333333,293.166666666667,2085.69047619048,1106.78048780488,29,29,58,97.6744186046512
"./Ship3_Latin-square/2019-08-29_12h45m_Subject 47800.txt","47800",2019-08-29,"12:45",0,81,60,7,14,21,98,9,21,128,101,14,38,153,601,95,157,853,660.6,217.516666666667,2999.93220338983,1379.03389830508,36,79,115,100
"./Ship3_Latin-square/2019-08-29_13h55m_Subject 46876.txt","46876",2019-08-29,"13:55",2,77,60,8,9,17,128,9,19,156,37,16,24,77,437,60,76,573,1174.71666666667,242.516666666667,2891.47457627119,1785.55172413793,43,75,118,98.3606557377049
"./Ship3_Latin-square/2019-08-29_13h55m_Subject 46893.txt","46893",2019-08-29,"13:55",24,86,60,11,15,26,78,4,29,111,65,17,46,128,672,15,246,933,285.883333333333,176.983333333333,1698.28813559322,836.241379310345,30,48,78,98.3606557377049
"./Ship3_Latin-square/2019-08-29_13h55m_Subject 46895.txt","46895",2019-08-29,"13:55",4,47,33,14,0,14,84,40,0,124,59,76,0,135,159,50,0,209,3973.81818181818,449.5625,2974.90625,1094.96774193548,36,13,49,96.969696969697
"./Ship3_Latin-square/2019-08-29_13h55m_Subject 47638.txt","47638",2019-08-29,"13:55",24,80,60,11,9,20,107,12,19,138,72,21,11,104,235,14,70,319,781.916666666667,295.4,1860.98305084746,992.896551724138,45,51,96,98.3606557377049
"./Ship3_Latin-square/2019-08-29_13h55m_Subject 47757.txt","47757",2019-08-29,"13:55",2,67,50,11,6,17,117,21,8,146,71,37,9,117,291,72,50,413,1871.4,351.734693877551,2914.24489795918,1404.57446808511,53,78,131,98
"./Ship3_Latin-square/2019-08-29_13h55m_Subject 47769.txt","47769",2019-08-29,"13:55",24,85,60,16,9,25,89,14,15,118,44,17,46,107,562,13,131,706,329.266666666667,154.933333333333,2023.66101694915,893.385964912281,111,25,136,96.7213114754098
"./Ship3_Latin-square/2019-08-29_13h55m_Subject 47771.txt","47771",2019-08-29,"13:55",0,78,60,8,10,18,28,3,2,33,26,9,18,53,883,114,183,1180,153.316666666667,169.283333333333,2999.89830508475,958.338983050847,29,44,73,100
"./Ship3_Latin-square/2019-08-29_13h55m_Subject 47775.txt","47775",2019-08-29,"13:55",0,79,60,7,12,19,33,1,3,37,37,9,1,47,954,129,174,1257,243.966666666667,175.866666666667,2999.8813559322,1086.25423728814,46,35,81,100
"./Ship3_Latin-square/2019-08-29_13h55m_Subject 47781.txt","47781",2019-08-29,"13:55",16,79,60,10,9,19,60,2,11,73,55,13,10,78,622,22,113,757,408.133333333333,172.683333333333,2240.61016949153,986.293103448276,52,41,93,98.3606557377049
"./Ship3_Latin-square/2019-08-29_13h55m_Subject 47782.txt","47782",2019-08-29,"13:55",2,79,60,6,13,19,62,3,19,84,24,18,20,62,922,91,172,1185,355.2,152.8,2877.94915254237,879.016949152542,24,18,42,100
"./Ship3_Latin-square/2019-08-29_13h55m_Subject 47783.txt","47783",2019-08-29,"13:55",16,78,60,9,9,18,58,5,7,70,22,0,8,30,501,40,97,638,505.883333333333,164.333333333333,2186.38983050847,1195.51724137931,65,51,116,98.3606557377049
"./Ship3_Latin-square/2019-08-29_13h55m_Subject 47785.txt","47785",2019-08-29,"13:55",16,82,60,10,12,22,50,8,13,71,23,7,13,43,498,33,136,667,316.116666666667,166.3,2213.45762711864,1084.96610169492,42,40,82,100
"./Ship3_Latin-square/2019-08-29_13h55m_Subject 47788.txt","47788",2019-08-29,"13:55",2,80,60,6,14,20,65,6,9,80,107,11,44,162,649,64,146,859,353.733333333333,280.583333333333,2867.76271186441,1150.83050847458,16,40,56,100
"./Ship3_Latin-square/2019-08-29_13h58m_Subject 46888.txt","46888",2019-08-29,"13:58",0,80,60,4,16,20,32,2,8,42,65,7,53,125,1058,78,231,1367,117.083333333333,183.466666666667,2999.8813559322,1165.66101694915,23,55,78,100
"./Ship3_Latin-square/2019-08-29_13h58m_Subject 46889.txt","46889",2019-08-29,"13:58",8,80,60,9,11,20,39,5,7,51,23,7,15,45,966,145,185,1296,238.316666666667,135.333333333333,2566.06779661017,1015.84745762712,44,68,112,100
"./Ship3_Latin-square/2019-08-29_13h58m_Subject 46892.txt","46892",2019-08-29,"13:58",2,79,60,7,12,19,46,4,3,53,20,7,10,37,974,86,206,1266,168.866666666667,208.05,2884.69491525424,1023.72413793103,32,84,116,98.3606557377049
"./Ship3_Latin-square/2019-08-29_13h58m_Subject 47097.txt","47097",2019-08-29,"13:58",16,81,60,11,10,21,137,3,30,170,86,16,39,141,482,31,136,649,468.883333333333,235.4,2213.54237288136,1275.89830508475,46,72,118,100
"./Ship3_Latin-square/2019-08-29_13h58m_Subject 47099.txt","47099",2019-08-29,"13:58",2,82,60,8,14,22,70,10,6,86,110,44,84,238,1268,135,380,1783,178.716666666667,238.933333333333,2877.93220338983,843.694915254237,13,52,65,100
"./Ship3_Latin-square/2019-08-29_15h19m_Subject 47080.txt","47080",2019-08-29,"15:19",24,86,60,13,13,26,110,13,40,163,27,8,5,40,299,4,104,407,437.433333333333,179.8,1820.28813559322,1010.48275862069,35,42,77,98.3606557377049
"./Ship3_Latin-square/2019-08-29_15h19m_Subject 47089.txt","47089",2019-08-29,"15:19",0,60,43,10,7,17,88,13,18,119,60,35,15,110,243,47,42,332,2222.11904761905,271.428571428571,2999.92857142857,2181.68292682927,71,34,105,97.6744186046512
"./Ship3_Latin-square/2019-08-29_15h19m_Subject 47762.txt","47762",2019-08-29,"15:19",4,76,55,9,12,21,87,10,20,117,22,0,17,39,314,53,78,445,1196.54545454545,252.890909090909,2781.8,2112.03773584906,54,78,132,100
"./Ship3_Latin-square/2019-08-29_15h19m_Subject 47791.txt","47791",2019-08-29,"15:19",2,84,60,11,13,24,45,3,7,55,48,9,15,72,608,113,142,863,305.383333333333,277.666666666667,2898.25423728814,1709.8275862069,72,51,123,100
"./Ship3_Latin-square/2019-08-30_09h53m_Subject 46878.txt","46878",2019-08-30,"09:53",4,82,59,12,11,23,44,83,11,138,170,48,69,287,664,126,129,919,285.050847457627,640.491525423729,2796.54237288136,1237.89830508475,36,61,97,100
"./Ship3_Latin-square/2019-08-30_09h53m_Subject 46885.txt","46885",2019-08-30,"09:53",2,85,60,9,16,25,78,16,13,107,34,24,14,72,340,53,115,508,700.783333333333,252.216666666667,2881.30508474576,1832.06896551724,38,69,107,100
"./Ship3_Latin-square/2019-08-30_09h53m_Subject 46899.txt","46899",2019-08-30,"09:53",8,82,60,10,12,22,70,11,12,93,56,3,31,90,497,64,107,668,391.5,213.9,2593.15254237288,1224.58620689655,43,54,97,98.3606557377049
"./Ship3_Latin-square/2019-08-30_09h53m_Subject 47091.txt","47091",2019-08-30,"09:53",8,77,60,8,9,17,49,10,9,68,82,18,18,118,388,46,110,544,337.8,239.633333333333,2593.20338983051,1416.35593220339,79,44,123,100
"./Ship3_Latin-square/2019-08-30_09h53m_Subject 47231.txt","47231",2019-08-30,"09:53",8,72,56,5,11,16,101,12,20,133,35,16,13,64,328,17,103,448,1318.41071428571,173.017857142857,2519.94545454545,1324.23214285714,13,33,46,100
"./Ship3_Latin-square/2019-08-30_09h53m_Subject 47238.txt","47238",2019-08-30,"09:53",0,82,60,14,8,22,48,14,9,71,74,24,11,109,586,158,66,810,816.233333333333,250.733333333333,2999.89830508475,1172.65517241379,75,56,131,98.3606557377049
"./Ship3_Latin-square/2019-08-30_09h53m_Subject 47242.txt","47242",2019-08-30,"09:53",0,84,60,9,15,24,66,1,7,74,64,15,122,201,813,113,212,1138,229.283333333333,201.316666666667,2999.91525423729,1123.1186440678,24,67,91,100
"./Ship3_Latin-square/2019-08-30_09h53m_Subject 47244.txt","47244",2019-08-30,"09:53",2,83,60,8,15,23,72,7,11,90,112,32,30,174,676,73,171,920,455.316666666667,353.766666666667,2874.54237288136,1461.59322033898,49,144,193,100
"./Ship3_Latin-square/2019-08-30_09h53m_Subject 47633.txt","47633",2019-08-30,"09:53",4,81,60,9,12,21,81,7,5,93,107,16,47,170,470,66,93,629,413.733333333333,437,2789.71186440678,1295.81355932203,35,57,92,100
"./Ship3_Latin-square/2019-08-30_09h53m_Subject 47752.txt","47752",2019-08-30,"09:53",8,82,60,11,11,22,64,15,8,87,24,34,6,64,707,133,180,1020,375.933333333333,158.933333333333,2606.71186440678,1161.01754385965,39,59,98,98.3606557377049
"./Ship3_Latin-square/2019-08-30_09h53m_Subject 47767.txt","47767",2019-08-30,"09:53",0,88,60,15,13,28,75,3,19,97,30,22,56,108,377,49,141,567,420.416666666667,187.85,2999.89830508475,1957.34,61,71,132,90.1639344262295
"./Ship3_Latin-square/2019-08-30_09h57m_Subject 46884.txt","46884",2019-08-30,"09:57",16,64,47,7,10,17,100,5,37,142,45,6,18,69,196,18,30,244,1676.10638297872,375.659574468085,2060.82608695652,2496.20930232558,18,80,98,93.6170212765958
"./Ship3_Latin-square/2019-08-30_09h57m_Subject 47083.txt","47083",2019-08-30,"09:57",2,75,52,7,16,23,107,17,29,153,42,4,8,54,418,28,166,612,1417.03846153846,351.519230769231,2866.62745098039,1344.38461538462,46,46,92,100
"./Ship3_Latin-square/2019-08-30_09h57m_Subject 47246.txt","47246",2019-08-30,"09:57",16,79,60,8,11,19,80,6,19,105,64,8,13,85,392,46,99,537,744.933333333333,215.683333333333,2132.10169491525,1172.03636363636,47,64,111,95.0819672131148
"./Ship3_Latin-square/2019-08-30_09h57m_Subject 47635.txt","47635",2019-08-30,"09:57",4,83,60,9,14,23,109,8,23,140,91,13,17,121,542,93,138,773,767.666666666667,431.6,2762.67796610169,1715.15254237288,50,112,162,98.3606557377049
"./Ship3_Latin-square/2019-08-30_09h57m_Subject 47779.txt","47779",2019-08-30,"09:57",4,58,41,8,9,17,115,16,10,141,20,15,16,51,121,26,47,194,3114.70731707317,262.292682926829,2795.0243902439,4289.96875,66,63,129,83.3333333333333
"./Ship3_Latin-square/2019-08-30_11h04m_Subject 47229.txt","47229",2019-08-30,"11:04",24,78,60,12,6,18,135,15,24,174,80,15,2,97,509,13,80,602,495.116666666667,256.033333333333,2023.67796610169,816.35593220339,53,50,103,100
"./Ship3_Latin-square/2019-08-30_11h04m_Subject 47233.txt","47233",2019-08-30,"11:04",16,84,60,14,10,24,68,23,16,107,79,15,20,114,391,52,104,547,322.366666666667,207.983333333333,2267.72881355932,1228.38983050847,71,45,116,100
"./Ship3_Latin-square/2019-08-30_11h04m_Subject 47247.txt","47247",2019-08-30,"11:04",2,81,60,13,8,21,45,11,9,65,38,15,11,64,396,76,62,534,468.55,219.416666666667,2905.03389830508,1455.5593220339,34,47,81,100
"./Ship3_Latin-square/2019-08-30_11h04m_Subject 47777.txt","47777",2019-08-30,"11:04",0,81,60,4,17,21,94,12,11,117,18,0,5,23,572,44,167,783,531.333333333333,198.066666666667,2999.86440677966,1814.51724137931,46,105,151,100
"./Ship3_Latin-square/2019-08-30_11h04m_Subject 47784.txt","47784",2019-08-30,"11:04",2,86,60,5,21,26,64,25,9,98,94,33,80,207,1129,85,433,1647,220.316666666667,273.55,2844.06779661017,943.203389830509,21,16,37,100
"./Ship3_Latin-square/2019-08-30_11h10m_Subject 46900.txt","46900",2019-08-30,"11:10",16,77,60,10,7,17,41,5,4,50,83,23,7,113,522,45,102,669,388.85,307.116666666667,2294.84745762712,1043.67796610169,26,60,86,100
"./Ship3_Latin-square/2019-08-30_11h10m_Subject 47076.txt","47076",2019-08-30,"11:10",0,81,60,10,11,21,38,15,4,57,30,3,23,56,825,118,197,1140,296.316666666667,166.85,2999.8813559322,1285.77966101695,60,98,158,100
"./Ship3_Latin-square/2019-08-30_11h10m_Subject 47079.txt","47079",2019-08-30,"11:10",2,81,60,12,9,21,33,3,2,38,67,18,8,93,401,93,67,561,463.633333333333,318.083333333333,2905.03389830508,1563.41379310345,64,86,150,98.3606557377049
"./Ship3_Latin-square/2019-08-30_11h10m_Subject 47082.txt","47082",2019-08-30,"11:10",0,79,60,8,11,19,55,4,5,64,27,9,45,81,563,77,126,766,253.566666666667,147.6,2999.93220338983,1378.13793103448,50,86,136,98.3606557377049
"./Ship3_Latin-square/2019-08-30_11h10m_Subject 47092.txt","47092",2019-08-30,"11:10",2,80,60,9,11,20,44,6,9,59,104,23,23,150,568,91,112,771,330.633333333333,302.25,2891.45762711864,1506.16949152542,56,41,97,100
"./Ship3_Latin-square/2019-08-30_11h10m_Subject 47226.txt","47226",2019-08-30,"11:10",0,81,60,9,12,21,90,8,20,118,39,14,22,75,614,100,115,829,495.383333333333,163.316666666667,2999.86440677966,1466.52542372881,48,60,108,100
"./Ship3_Latin-square/2019-08-30_11h10m_Subject 47227.txt","47227",2019-08-30,"11:10",0,79,60,5,14,19,86,0,9,95,41,7,9,57,689,76,168,933,378.033333333333,159.9,2999.8813559322,1350.62068965517,31,47,78,100
"./Ship3_Latin-square/2019-08-30_11h10m_Subject 47250.txt","47250",2019-08-30,"11:10",24,58,42,14,2,16,62,17,2,81,136,17,0,153,288,6,18,312,588.731707317073,3450.82926829268,2414.58536585366,814.756756756757,23,13,36,92.8571428571429
"./Ship3_Latin-square/2019-08-30_11h10m_Subject 47646.txt","47646",2019-08-30,"11:10",0,83,60,5,18,23,60,4,4,68,55,3,68,126,1164,73,334,1571,381.716666666667,161.183333333333,2999.89830508475,1022.45762711864,24,57,81,100
"./Ship3_Latin-square/2019-08-30_11h10m_Subject 47755.txt","47755",2019-08-30,"11:10",8,77,60,9,8,17,98,9,10,117,76,15,10,101,497,63,67,627,762.1,433.416666666667,2633.84745762712,1646.03773584906,58,187,245,93.4426229508197
"./Ship3_Latin-square/2019-08-30_11h10m_Subject 47760.txt","47760",2019-08-30,"11:10",2,82,60,9,13,22,91,29,28,148,68,16,39,123,608,82,141,831,571.533333333333,342.183333333333,2884.71186440678,1102.03389830508,32,45,77,100
"./Ship3_Latin-square/2019-08-30_11h10m_Subject 47770.txt","47770",2019-08-30,"11:10",4,51,38,4,9,13,112,7,30,149,162,26,20,208,229,30,41,300,2597.54054054054,858.135135135135,2751.35135135135,4745.4375,56,137,193,86.8421052631579
"./Ship3_Latin-square/2019-08-30_11h10m_Subject 47795.txt","47795",2019-08-30,"11:10",0,84,60,6,18,24,66,6,33,105,61,6,40,107,559,48,160,767,419.666666666667,289.733333333333,2999.8813559322,1498.77966101695,16,62,78,100
"./Ship3_Latin-square/2019-08-30_12h17m_Subject 46880.txt","46880",2019-08-30,"12:17",16,80,60,11,9,20,15,5,1,21,21,2,4,27,482,46,95,623,213.633333333333,188.5,2240.61016949153,1166.32142857143,51,66,117,96.7213114754098
"./Ship3_Latin-square/2019-08-30_12h17m_Subject 46882.txt","46882",2019-08-30,"12:17",0,76,60,6,10,16,19,1,0,20,82,10,42,134,848,81,182,1111,203.766666666667,208.233333333333,2999.93220338983,1484.73684210526,100,48,148,100
"./Ship3_Latin-square/2019-08-30_12h17m_Subject 46883.txt","46883",2019-08-30,"12:17",4,78,56,12,10,22,143,13,24,180,78,61,118,257,381,99,75,555,817.357142857143,340.089285714286,2821.35714285714,1847.6862745098,80,81,161,94.7368421052632
"./Ship3_Latin-square/2019-08-30_12h17m_Subject 46894.txt","46894",2019-08-30,"12:17",2,74,60,6,8,14,51,22,5,78,38,2,28,68,575,36,71,682,715.683333333333,193.783333333333,2894.8813559322,1045.93220338983,28,31,59,100
"./Ship3_Latin-square/2019-08-30_12h17m_Subject 47088.txt","47088",2019-08-30,"12:17",4,80,60,8,12,20,45,3,10,58,48,7,13,68,689,74,137,900,186.9,200.166666666667,2783,938.35593220339,3,62,65,100
"./Ship3_Latin-square/2019-08-30_12h17m_Subject 47228.txt","47228",2019-08-30,"12:17",2,78,60,8,10,18,29,1,9,39,58,9,9,76,697,103,85,885,251.283333333333,242.583333333333,2894.8813559322,1084.13559322034,26,67,93,100
"./Ship3_Latin-square/2019-08-30_12h17m_Subject 47243.txt","47243",2019-08-30,"12:17",2,84,60,10,14,24,64,15,7,86,53,43,2,98,834,106,269,1209,296.516666666667,272.9,2888.1186440678,1464.34482758621,154,87,241,98.3606557377049
"./Ship3_Latin-square/2019-08-30_12h17m_Subject 47249.txt","47249",2019-08-30,"12:17",4,79,60,9,10,19,88,23,8,119,82,26,14,122,360,62,46,468,737.566666666667,296.966666666667,2796.5593220339,1708.74576271186,47,53,100,100
"./Ship3_Latin-square/2019-08-30_12h17m_Subject 47639.txt","47639",2019-08-30,"12:17",2,82,60,10,12,22,26,32,3,61,48,13,37,98,685,115,193,993,169.666666666667,200.783333333333,2894.8813559322,1152.66101694915,56,65,121,100
"./Ship3_Latin-square/2019-08-30_12h17m_Subject 47649.txt","47649",2019-08-30,"12:17",8,84,60,13,11,24,60,7,4,71,89,25,45,159,464,115,98,677,563.566666666667,291.283333333333,2633.83050847458,1333.85964912281,39,75,114,96.7213114754098
"./Ship3_Latin-square/2019-08-30_12h17m_Subject 47758.txt","47758",2019-08-30,"12:17",4,81,60,11,10,21,26,6,1,33,32,3,10,45,811,145,158,1114,217.116666666667,172.433333333333,2803.35593220339,894.016949152542,48,7,55,100
"./Ship3_Latin-square/2019-08-30_12h17m_Subject 47759.txt","47759",2019-08-30,"12:17",4,80,60,11,9,20,17,4,2,23,65,26,15,106,592,83,104,779,200.516666666667,223.65,2803.35593220339,1379.46428571429,85,26,111,96.7213114754098
"./Ship3_Latin-square/2019-08-30_12h17m_Subject 47776.txt","47776",2019-08-30,"12:17",2,83,60,15,8,23,78,58,5,141,57,27,26,110,999,191,185,1375,284,206.433333333333,2925.38983050847,954.881355932203,44,59,103,100
"./Ship3_Latin-square/2019-08-30_12h17m_Subject 47799.txt","47799",2019-08-30,"12:17",4,76,60,8,8,16,35,3,7,45,132,26,35,193,570,78,94,742,344.633333333333,451.7,2796.57627118644,1546.61403508772,51,58,109,96.7213114754098
"./Ship3_Latin-square/2019-08-30_12h20m_Subject 46881.txt","46881",2019-08-30,"12:20",0,78,60,8,10,18,80,12,10,102,37,2,13,52,731,104,162,997,492.4,158.866666666667,2999.91525423729,1232.89830508475,26,79,105,100
"./Ship3_Latin-square/2019-08-30_12h20m_Subject 47087.txt","47087",2019-08-30,"12:20",0,82,60,9,13,22,183,5,16,204,80,21,42,143,456,97,110,663,842.9,246.066666666667,2999.89830508475,1506.05084745763,47,51,98,100
"./Ship3_Latin-square/2019-08-30_12h20m_Subject 47626.txt","47626",2019-08-30,"12:20",16,82,60,14,8,22,72,17,14,103,75,22,8,105,322,54,55,431,495.716666666667,232.75,2349.10169491525,1612.83050847458,104,54,158,100
"./Ship3_Latin-square/2019-08-30_12h20m_Subject 47634.txt","47634",2019-08-30,"12:20",0,82,60,10,12,22,109,11,22,142,45,25,16,86,547,88,121,756,691.133333333333,268.033333333333,2999.91525423729,990.542372881356,69,22,91,100
"./Ship3_Latin-square/2019-08-30_12h20m_Subject 47640.txt","47640",2019-08-30,"12:20",0,78,59,10,9,19,152,13,8,173,58,20,26,104,922,159,157,1238,1424.03389830508,201.033898305085,2999.91379310345,888,33,30,63,100
"./Ship3_Latin-square/2019-08-30_12h20m_Subject 47754.txt","47754",2019-08-30,"12:20",2,68,50,5,13,18,114,13,15,142,60,12,28,100,436,37,124,597,1737.92,285.34,2873.40816326531,1528.39583333333,15,87,102,100
"./Ship3_Latin-square/2019-08-30_12h20m_Subject 47800.txt","47800",2019-08-30,"12:20",24,81,60,9,12,21,101,15,22,138,75,22,28,125,257,4,114,375,507.666666666667,187.483333333333,1698.28813559322,1021.84482758621,29,33,62,98.3606557377049
"./Ship3_Latin-square/2019-08-30_13h49m_Subject 46876.txt","46876",2019-08-30,"13:49",16,78,60,10,8,18,99,15,13,127,18,5,15,38,238,18,37,293,1103.55,154.433333333333,2267.72881355932,1953.39285714286,64,47,111,95.0819672131148
"./Ship3_Latin-square/2019-08-30_13h49m_Subject 46893.txt","46893",2019-08-30,"13:49",2,82,60,5,17,22,39,0,5,44,35,2,14,51,1162,87,362,1611,217.8,179.283333333333,2861,970.830508474576,36,72,108,100
"./Ship3_Latin-square/2019-08-30_13h49m_Subject 46895.txt","46895",2019-08-30,"13:49",8,81,56,12,13,25,110,17,34,161,94,46,80,220,474,67,207,748,639.785714285714,479.607142857143,2592.67272727273,1183.82352941176,44,180,224,94.7368421052632
"./Ship3_Latin-square/2019-08-30_13h49m_Subject 47638.txt","47638",2019-08-30,"13:49",2,76,54,12,10,22,133,17,21,171,53,16,33,102,424,72,80,576,1482.87037037037,245.796296296296,2914.77777777778,1350.83018867925,36,53,89,98.1818181818182
"./Ship3_Latin-square/2019-08-30_13h49m_Subject 47757.txt","47757",2019-08-30,"13:49",4,71,51,7,13,20,88,13,21,122,52,6,25,83,353,39,101,493,1486.58823529412,285.313725490196,2741.13725490196,1913.98,32,153,185,98.0769230769231
"./Ship3_Latin-square/2019-08-30_13h49m_Subject 47769.txt","47769",2019-08-30,"13:49",2,83,60,14,9,23,48,15,6,69,37,21,12,70,815,223,130,1168,213,201.833333333333,2921.96610169492,843.120689655172,60,62,122,98.3606557377049
"./Ship3_Latin-square/2019-08-30_13h49m_Subject 47771.txt","47771",2019-08-30,"13:49",24,85,60,14,11,25,63,16,17,96,22,11,11,44,425,10,116,551,332.85,139.816666666667,2023.69491525424,917.88,48,45,93,85.2459016393443
"./Ship3_Latin-square/2019-08-30_13h49m_Subject 47775.txt","47775",2019-08-30,"13:49",24,83,60,13,10,23,96,14,20,130,70,26,3,99,296,8,113,417,499.55,253.516666666667,1901.66101694915,1128.86206896552,39,21,60,98.3606557377049
"./Ship3_Latin-square/2019-08-30_13h49m_Subject 47781.txt","47781",2019-08-30,"13:49",0,82,60,6,16,22,22,2,3,27,50,8,22,80,1178,136,294,1608,110.833333333333,177.566666666667,2999.91525423729,996.372881355932,24,35,59,100
"./Ship3_Latin-square/2019-08-30_13h49m_Subject 47782.txt","47782",2019-08-30,"13:49",4,82,60,12,10,22,35,3,4,42,30,19,6,55,827,176,161,1164,198.333333333333,220.5,2803.22033898305,981.203389830509,19,29,48,100
"./Ship3_Latin-square/2019-08-30_13h49m_Subject 47783.txt","47783",2019-08-30,"13:49",0,81,60,7,14,21,35,4,10,49,83,9,18,110,975,120,259,1354,285.466666666667,307.75,2999.96610169492,1230.71186440678,48,47,95,100
"./Ship3_Latin-square/2019-08-30_13h49m_Subject 47785.txt","47785",2019-08-30,"13:49",0,80,60,7,13,20,52,4,9,65,19,8,11,38,1018,145,191,1354,357.016666666667,129.05,2999.98305084746,1248.62711864407,31,54,85,100
"./Ship3_Latin-square/2019-08-30_13h49m_Subject 47788.txt","47788",2019-08-30,"13:49",4,81,60,9,12,21,49,4,3,56,74,18,22,114,638,104,116,858,221.2,252.466666666667,2789.76271186441,1292.05084745763,52,33,85,100
"./Ship3_Latin-square/2019-08-30_13h52m_Subject 46888.txt","46888",2019-08-30,"13:52",24,81,60,12,9,21,37,3,11,51,165,21,19,205,543,10,193,746,156.016666666667,408.983333333333,1860.93220338983,786.509433962264,31,53,84,90.1639344262295
"./Ship3_Latin-square/2019-08-30_13h52m_Subject 46889.txt","46889",2019-08-30,"13:52",2,83,60,9,14,23,27,8,9,44,37,12,27,76,1127,161,233,1521,99,209.483333333333,2881.28813559322,1114.59322033898,65,66,131,100
"./Ship3_Latin-square/2019-08-30_13h52m_Subject 46892.txt","46892",2019-08-30,"13:52",4,81,60,9,12,21,35,1,2,38,13,8,2,23,848,145,169,1162,205.25,126.45,2782.96610169492,1141.05084745763,48,61,109,100
"./Ship3_Latin-square/2019-08-30_13h52m_Subject 47097.txt","47097",2019-08-30,"13:52",0,80,60,10,10,20,49,8,10,67,94,22,13,129,986,180,177,1343,237.683333333333,237,2999.91525423729,1354.30508474576,62,115,177,100
"./Ship3_Latin-square/2019-08-30_13h52m_Subject 47099.txt","47099",2019-08-30,"13:52",4,82,60,11,11,22,24,59,8,91,24,15,14,53,1281,221,319,1821,107.95,155.85,2789.79661016949,896.559322033898,34,58,92,100
"./Ship3_Latin-square/2019-08-30_13h52m_Subject 47798.txt","47798",2019-08-30,"13:52",4,73,52,4,17,21,102,11,21,134,49,4,18,71,270,22,100,392,1282.78431372549,413.235294117647,2694.05882352941,1861.21568627451,24,73,97,100
"./Ship3_Latin-square/2019-08-30_15h06m_Subject 47080.txt","47080",2019-08-30,"15:06",2,83,60,9,14,23,51,4,4,59,14,1,3,18,556,102,131,789,254.066666666667,146.766666666667,2891.49152542373,1535.30508474576,35,86,121,100
"./Ship3_Latin-square/2019-08-30_15h06m_Subject 47089.txt","47089",2019-08-30,"15:06",24,43,30,10,3,13,113,26,15,154,69,19,0,88,126,5,5,136,4570.03333333333,1197.03333333333,2359.9,2871.68965517241,52,19,71,100
"./Ship3_Latin-square/2019-08-30_15h06m_Subject 47762.txt","47762",2019-08-30,"15:06",8,77,58,8,11,19,158,14,24,196,24,5,14,43,340,36,72,448,1409.5,175.862068965517,2564.80701754386,1755.3275862069,50,111,161,100
"./Ship3_Latin-square/2019-08-30_15h06m_Subject 47791.txt","47791",2019-08-30,"15:06",16,83,60,11,12,23,51,11,9,71,75,8,13,96,369,32,97,498,438.4,326.916666666667,2159.25423728814,1267.37931034483,55,54,109,98.3606557377049
"./Ship3_Latin-square/2019-09-03_10h07m_Subject 46878.txt","46878",2019-09-03,"10:07",8,80,60,8,12,20,37,25,14,76,70,27,80,177,556,74,151,781,199.75,333.166666666667,2552.47457627119,1360.96551724138,36,74,110,98.3606557377049
"./Ship3_Latin-square/2019-09-03_10h07m_Subject 46885.txt","46885",2019-09-03,"10:07",16,77,57,17,3,20,104,31,8,143,36,21,1,58,286,43,24,353,987.107142857143,251.732142857143,2542.80357142857,1805.89285714286,96,32,128,100
"./Ship3_Latin-square/2019-09-03_10h07m_Subject 46899.txt","46899",2019-09-03,"10:07",2,83,60,14,9,23,62,14,6,82,66,19,12,97,628,119,110,857,350.066666666667,220.2,2918.59322033898,967.779661016949,50,28,78,100
"./Ship3_Latin-square/2019-09-03_10h07m_Subject 47091.txt","47091",2019-09-03,"10:07",2,79,60,5,14,19,43,3,9,55,74,15,26,115,267,12,55,334,556.533333333333,209.45,2874.49152542373,2294.4406779661,55,72,127,100
"./Ship3_Latin-square/2019-09-03_10h07m_Subject 47231.txt","47231",2019-09-03,"10:07",2,80,59,11,10,21,79,16,15,110,51,33,14,98,352,74,76,502,1021.8275862069,280.362068965517,2899.98275862069,1429.22413793103,34,36,70,100
"./Ship3_Latin-square/2019-09-03_10h07m_Subject 47238.txt","47238",2019-09-03,"10:07",24,69,48,21,0,21,53,14,0,67,32,37,0,69,267,36,0,303,1370.64583333333,221.5625,2795.65957446808,2065.58823529412,337,7,344,47.9166666666667
"./Ship3_Latin-square/2019-09-03_10h07m_Subject 47242.txt","47242",2019-09-03,"10:07",24,81,60,15,6,21,51,29,6,86,78,45,46,169,362,16,63,441,496.466666666667,287.85,2105.03389830508,1279.72881355932,51,53,104,100
"./Ship3_Latin-square/2019-09-03_10h07m_Subject 47244.txt","47244",2019-09-03,"10:07",16,67,49,15,3,18,115,14,7,136,154,28,8,190,329,45,27,401,1128.4693877551,299.25,2533.27083333333,1546.14583333333,84,56,140,100
"./Ship3_Latin-square/2019-09-03_10h07m_Subject 47633.txt","47633",2019-09-03,"10:07",8,81,60,13,8,21,50,6,7,63,71,19,16,106,384,44,76,504,322.883333333333,263.033333333333,2674.49152542373,1532.50847457627,69,47,116,100
"./Ship3_Latin-square/2019-09-03_10h07m_Subject 47636.txt","47636",2019-09-03,"10:07",4,58,44,8,6,14,361,91,8,460,94,25,10,129,246,34,38,318,2680.34090909091,366.113636363636,2813.88372093023,3028.21951219512,104,133,237,93.3333333333333
"./Ship3_Latin-square/2019-09-03_10h07m_Subject 47752.txt","47752",2019-09-03,"10:07",2,77,60,9,8,17,55,5,4,64,42,19,10,71,580,62,69,711,506.516666666667,312.1,2901.64406779661,1436.91379310345,60,63,123,98.3606557377049
"./Ship3_Latin-square/2019-09-03_10h07m_Subject 47767.txt","47767",2019-09-03,"10:07",24,63,45,17,1,18,100,15,3,118,28,70,1,99,220,17,5,242,2659.04545454545,233.136363636364,2672.63636363636,1069.51219512195,54,28,82,95.5555555555556
"./Ship3_Latin-square/2019-09-03_10h07m_Subject 47768.txt","47768",2019-09-03,"10:07",4,41,30,7,4,11,109,29,11,149,64,14,3,81,210,37,11,258,4959.68965517241,679.103448275862,2820.58620689655,1669.80952380952,32,85,117,80
"./Ship3_Latin-square/2019-09-03_10h10m_Subject 46884.txt","46884",2019-09-03,"10:10",0,79,60,7,12,19,48,4,5,57,47,25,3,75,317,31,59,407,611.816666666667,222.316666666667,2999.89830508475,2418.18367346939,54,126,180,88.5245901639344
"./Ship3_Latin-square/2019-09-03_10h10m_Subject 47083.txt","47083",2019-09-03,"10:10",16,86,60,13,13,26,108,16,19,143,33,15,7,55,398,38,121,557,775.883333333333,193.433333333333,2240.62711864407,1603.67796610169,96,65,161,100
"./Ship3_Latin-square/2019-09-03_10h10m_Subject 47246.txt","47246",2019-09-03,"10:10",0,88,60,1,27,28,78,0,17,95,44,0,41,85,632,14,218,864,556.683333333333,169.866666666667,2999.89830508475,1650.44827586207,7,124,131,98.3606557377049
"./Ship3_Latin-square/2019-09-03_10h10m_Subject 47635.txt","47635",2019-09-03,"10:10",8,80,60,11,9,20,63,8,11,82,55,15,13,83,551,80,88,719,642.066666666667,263.35,2647.42372881356,1485.5593220339,101,55,156,98.3606557377049
"./Ship3_Latin-square/2019-09-03_10h10m_Subject 47779.txt","47779",2019-09-03,"10:10",8,77,57,10,10,20,71,4,5,80,46,21,8,75,199,14,40,253,1531.54385964912,167.982456140351,2606.91228070175,2465.94,63,54,117,89.6551724137931
"./Ship3_Latin-square/2019-09-03_11h33m_Subject 46900.txt","46900",2019-09-03,"11:33",0,78,60,6,12,18,36,1,14,51,73,15,9,97,847,82,162,1091,211.7,304.5,2999.96610169492,1146.64406779661,32,20,52,100
"./Ship3_Latin-square/2019-09-03_11h33m_Subject 47076.txt","47076",2019-09-03,"11:33",24,78,56,16,6,22,49,4,12,65,135,145,92,372,420,17,56,493,334.196428571429,464.446428571429,2099.94642857143,1008.6875,73,93,166,85.9649122807018
"./Ship3_Latin-square/2019-09-03_11h33m_Subject 47079.txt","47079",2019-09-03,"11:33",16,82,60,13,9,22,40,1,3,44,60,11,10,81,348,52,75,475,355.566666666667,249.783333333333,2322,1221.10344827586,75,36,111,100
"./Ship3_Latin-square/2019-09-03_11h33m_Subject 47082.txt","47082",2019-09-03,"11:33",24,83,60,16,7,23,68,14,7,89,27,10,6,43,315,21,58,394,605.25,137.8,2104.96610169492,1140.76,81,49,130,88.5245901639344
"./Ship3_Latin-square/2019-09-03_11h33m_Subject 47092.txt","47092",2019-09-03,"11:33",16,80,60,12,8,20,87,5,19,111,68,20,12,100,405,39,81,525,478.133333333333,242.633333333333,2321.96610169492,1476.77966101695,64,79,143,100
"./Ship3_Latin-square/2019-09-03_11h33m_Subject 47226.txt","47226",2019-09-03,"11:33",24,79,60,10,9,19,93,4,21,118,53,5,13,71,262,5,52,319,701.85,191.183333333333,1820.28813559322,1744.49122807018,88,43,131,96.7213114754098
"./Ship3_Latin-square/2019-09-03_11h33m_Subject 47227.txt","47227",2019-09-03,"11:33",24,85,60,16,9,25,84,6,13,103,53,29,18,100,378,11,94,483,358.366666666667,218.65,2023.67796610169,870.56,61,69,130,86.8852459016393
"./Ship3_Latin-square/2019-09-03_11h33m_Subject 47250.txt","47250",2019-09-03,"11:33",2,84,60,8,16,24,66,11,12,89,6,5,33,44,708,76,240,1024,306.833333333333,82,2877.94915254237,1018.91525423729,12,23,35,100
"./Ship3_Latin-square/2019-09-03_11h33m_Subject 47646.txt","47646",2019-09-03,"11:33",24,59,44,13,2,15,113,13,4,130,36,5,36,77,368,4,16,388,1264.13953488372,435.581395348837,2385.95348837209,1327.07894736842,40,33,73,88.6363636363636
"./Ship3_Latin-square/2019-09-03_11h33m_Subject 47755.txt","47755",2019-09-03,"11:33",2,80,59,3,18,21,77,5,16,98,77,4,38,119,568,26,163,757,579.98275862069,490.689655172414,2855.13793103448,2022.67857142857,46,206,252,98.3050847457627
"./Ship3_Latin-square/2019-09-03_11h33m_Subject 47760.txt","47760",2019-09-03,"11:33",16,81,60,13,8,21,59,12,8,79,50,14,10,74,514,43,91,648,510.916666666667,181.483333333333,2294.86440677966,1223.25862068966,49,17,66,98.3606557377049
"./Ship3_Latin-square/2019-09-03_11h33m_Subject 47770.txt","47770",2019-09-03,"11:33",8,56,44,6,6,12,92,13,7,112,70,44,9,123,196,25,31,252,2685.97727272727,459.659090909091,2609.20930232558,3219.40540540541,76,75,151,93.3333333333333
"./Ship3_Latin-square/2019-09-03_11h33m_Subject 47795.txt","47795",2019-09-03,"11:33",24,43,32,10,1,11,54,9,1,64,35,168,0,203,185,6,13,204,661.9375,553.03125,2474.90625,1583.46666666667,36,11,47,96.969696969697
"./Ship3_Latin-square/2019-09-03_11h37m_Subject 47229.txt","47229",2019-09-03,"11:37",2,79,60,8,11,19,25,1,3,29,55,8,3,66,668,94,109,871,143.566666666667,218.333333333333,2894.84745762712,1421.35087719298,62,73,135,100
"./Ship3_Latin-square/2019-09-03_11h37m_Subject 47233.txt","47233",2019-09-03,"11:37",0,81,60,4,17,21,40,3,6,49,77,7,48,132,430,33,125,588,180.833333333333,234,2999.86440677966,1793.13793103448,47,79,126,98.3606557377049
"./Ship3_Latin-square/2019-09-03_11h37m_Subject 47247.txt","47247",2019-09-03,"11:37",16,81,60,12,9,21,62,10,14,86,49,8,6,63,343,35,72,450,548.733333333333,242.9,2321.98305084746,1431.50847457627,56,57,113,100
"./Ship3_Latin-square/2019-09-03_11h37m_Subject 47777.txt","47777",2019-09-03,"11:37",24,78,60,11,7,18,143,12,21,176,28,7,3,38,280,11,59,350,997.666666666667,284.866666666667,1901.67796610169,1410.79661016949,70,36,106,100
"./Ship3_Latin-square/2019-09-03_11h37m_Subject 47784.txt","47784",2019-09-03,"11:37",16,70,60,7,3,10,91,6,11,108,77,7,4,88,540,19,37,596,539.45,227.866666666667,2321.98305084746,1237.79661016949,76,23,99,100
"./Ship3_Latin-square/2019-09-03_13h13m_Subject 46880.txt","46880",2019-09-03,"13:13",0,80,60,7,13,20,43,6,10,59,24,1,14,39,684,90,153,927,273.7,167.316666666667,2999.81355932203,1522.48275862069,51,111,162,98.3606557377049
"./Ship3_Latin-square/2019-09-03_13h13m_Subject 46882.txt","46882",2019-09-03,"13:13",24,72,52,12,8,20,72,3,12,87,58,23,14,95,325,6,66,397,1795.21568627451,310.56862745098,2058.72549019608,2150.82978723404,72,26,98,94.2307692307692
"./Ship3_Latin-square/2019-09-03_13h13m_Subject 46883.txt","46883",2019-09-03,"13:13",8,80,60,11,9,20,99,15,13,127,35,11,7,53,296,31,50,377,773.55,198.216666666667,2606.74576271186,2111.51724137931,50,55,105,98.3606557377049
"./Ship3_Latin-square/2019-09-03_13h13m_Subject 46894.txt","46894",2019-09-03,"13:13",4,81,60,8,13,21,54,2,6,62,25,22,1,48,517,54,119,690,489.333333333333,142.416666666667,2776.16949152542,1317.59322033898,47,44,91,100
"./Ship3_Latin-square/2019-09-03_13h13m_Subject 47088.txt","47088",2019-09-03,"13:13",0,79,60,10,9,19,52,3,5,60,57,21,8,86,769,174,116,1059,173.35,211.283333333333,2999.8813559322,1222.25423728814,42,59,101,100
"./Ship3_Latin-square/2019-09-03_13h13m_Subject 47228.txt","47228",2019-09-03,"13:13",4,81,60,9,12,21,28,7,5,40,43,5,23,71,525,76,95,696,350.666666666667,186,2776.23728813559,1250.81355932203,27,79,106,100
"./Ship3_Latin-square/2019-09-03_13h13m_Subject 47243.txt","47243",2019-09-03,"13:13",4,81,60,11,10,21,66,10,6,82,34,14,10,58,831,132,162,1125,296.266666666667,203.433333333333,2810.1186440678,1283.76271186441,145,89,234,100
"./Ship3_Latin-square/2019-09-03_13h13m_Subject 47249.txt","47249",2019-09-03,"13:13",0,78,60,9,9,18,54,10,9,73,83,20,36,139,596,49,98,743,271.516666666667,177.333333333333,2999.91525423729,1160.79310344828,44,55,99,98.3606557377049
"./Ship3_Latin-square/2019-09-03_13h13m_Subject 47639.txt","47639",2019-09-03,"13:13",4,76,60,10,6,16,17,7,5,29,16,15,0,31,759,89,82,930,139.733333333333,173.05,2823.67796610169,1379.06779661017,69,60,129,100
"./Ship3_Latin-square/2019-09-03_13h13m_Subject 47649.txt","47649",2019-09-03,"13:13",2,74,59,8,7,15,80,8,7,95,55,14,44,113,326,45,35,406,1126.08620689655,342.310344827586,2903.41379310345,2114.29787234043,95,98,193,84.7457627118644
"./Ship3_Latin-square/2019-09-03_13h13m_Subject 47758.txt","47758",2019-09-03,"13:13",0,78,60,6,12,18,16,1,1,18,27,4,4,35,829,99,168,1096,113.35,168.883333333333,2999.89830508475,1073.98305084746,46,37,83,100
"./Ship3_Latin-square/2019-09-03_13h13m_Subject 47759.txt","47759",2019-09-03,"13:13",0,84,60,9,15,24,27,1,2,30,47,6,33,86,544,82,138,764,215.2,180.366666666667,2999.93220338983,1575.61111111111,52,91,143,95.0819672131148
"./Ship3_Latin-square/2019-09-03_13h13m_Subject 47776.txt","47776",2019-09-03,"13:13",4,82,60,2,20,22,26,2,7,35,102,3,43,148,917,24,335,1276,108.7,235.533333333333,2688.10169491525,1414.98305084746,22,86,108,100
"./Ship3_Latin-square/2019-09-03_13h13m_Subject 47799.txt","47799",2019-09-03,"13:13",0,79,60,9,10,19,28,4,6,38,70,25,26,121,642,117,96,855,196.116666666667,290.183333333333,2999.8813559322,1561.16949152542,42,54,96,100
"./Ship3_Latin-square/2019-09-03_13h16m_Subject 46881.txt","46881",2019-09-03,"13:16",24,82,60,14,8,22,137,14,30,181,40,4,21,65,261,10,45,316,884.6,217.066666666667,1942.33898305085,1627.54,56,119,175,90.1639344262295
"./Ship3_Latin-square/2019-09-03_13h16m_Subject 47087.txt","47087",2019-09-03,"13:16",24,57,42,11,4,15,106,17,22,145,39,12,3,54,199,11,24,234,1958.85365853659,203.853658536585,2121.90243902439,1933.25641025641,49,43,92,95.2380952380952
"./Ship3_Latin-square/2019-09-03_13h16m_Subject 47626.txt","47626",2019-09-03,"13:16",0,78,60,9,9,18,65,9,5,79,98,25,51,174,452,79,63,594,688.9,268.366666666667,2999.93220338983,1713.6724137931,90,79,169,98.3606557377049
"./Ship3_Latin-square/2019-09-03_13h16m_Subject 47634.txt","47634",2019-09-03,"13:16",24,73,53,17,3,20,141,28,9,178,37,27,2,66,222,10,9,241,1675.1320754717,321.905660377359,2353.76923076923,1291.68,107,26,133,96.2962962962963
"./Ship3_Latin-square/2019-09-03_13h16m_Subject 47640.txt","47640",2019-09-03,"13:16",24,76,57,14,5,19,117,25,14,156,41,27,4,72,393,5,48,446,1050.01785714286,190.946428571429,2142.78571428571,854.2,48,25,73,100
"./Ship3_Latin-square/2019-09-03_13h16m_Subject 47754.txt","47754",2019-09-03,"13:16",4,76,60,9,7,16,59,4,5,68,104,22,15,141,629,66,72,767,450.316666666667,391.616666666667,2810.16949152542,1401.47457627119,40,76,116,100
"./Ship3_Latin-square/2019-09-03_13h16m_Subject 47800.txt","47800",2019-09-03,"13:16",2,80,60,10,10,20,83,12,5,100,72,18,17,107,459,89,75,623,675.3,187.883333333333,2901.67796610169,1167.4406779661,40,60,100,100
"./Ship3_Latin-square/2019-09-03_14h33m_Subject 46876.txt","46876",2019-09-03,"14:33",0,55,43,6,6,12,74,9,10,93,7,4,30,41,258,36,38,332,2937.61904761905,110.690476190476,2999.85714285714,1686.725,35,46,81,97.6744186046512
"./Ship3_Latin-square/2019-09-03_14h33m_Subject 46877.txt","46877",2019-09-03,"14:33",4,82,60,13,9,22,170,24,5,199,50,18,78,146,933,203,170,1306,410.516666666667,161.666666666667,2823.66101694915,1152.9298245614,44,157,201,96.7213114754098
"./Ship3_Latin-square/2019-09-03_14h33m_Subject 46893.txt","46893",2019-09-03,"14:33",4,75,60,6,9,15,28,4,3,35,45,0,6,51,828,55,123,1006,169.733333333333,170.783333333333,2783,1278.13793103448,82,56,138,98.3606557377049
"./Ship3_Latin-square/2019-09-03_14h33m_Subject 46895.txt","46895",2019-09-03,"14:33",2,84,60,7,17,24,68,12,11,91,84,22,44,150,467,51,146,664,821.333333333333,291.25,2867.71186440678,1437.19298245614,13,90,103,98.3606557377049
"./Ship3_Latin-square/2019-09-03_14h33m_Subject 47638.txt","47638",2019-09-03,"14:33",4,79,57,11,11,22,80,20,15,115,56,19,88,163,266,50,47,363,911.571428571429,287.875,2792.83928571429,1680.30188679245,40,62,102,96.4912280701754
"./Ship3_Latin-square/2019-09-03_14h33m_Subject 47757.txt","47757",2019-09-03,"14:33",0,77,58,8,11,19,94,13,16,123,71,18,30,119,424,55,73,552,1061.62068965517,294.275862068966,2999.91228070175,1879.0701754386,68,102,170,100
"./Ship3_Latin-square/2019-09-03_14h33m_Subject 47769.txt","47769",2019-09-03,"14:33",4,83,60,13,10,23,44,4,9,57,44,17,32,93,633,137,100,870,220.6,178.933333333333,2816.8813559322,1559.48275862069,84,90,174,98.3606557377049
"./Ship3_Latin-square/2019-09-03_14h33m_Subject 47771.txt","47771",2019-09-03,"14:33",2,81,60,7,14,21,34,6,9,49,35,3,92,130,667,71,206,944,215.833333333333,178.95,2874.49152542373,1375.05172413793,24,82,106,98.3606557377049
"./Ship3_Latin-square/2019-09-03_14h33m_Subject 47775.txt","47775",2019-09-03,"14:33",2,80,60,8,12,20,53,12,4,69,26,1,4,31,574,91,150,815,322.683333333333,142.966666666667,2881.28813559322,1463.15254237288,67,44,111,100
"./Ship3_Latin-square/2019-09-03_14h33m_Subject 47781.txt","47781",2019-09-03,"14:33",24,84,60,22,2,24,66,11,9,86,51,42,0,93,625,5,28,658,614.516666666667,290.116666666667,2593.1186440678,1102.21052631579,64,12,76,96.7213114754098
"./Ship3_Latin-square/2019-09-03_14h33m_Subject 47782.txt","47782",2019-09-03,"14:33",0,77,60,5,12,17,34,0,3,37,12,6,14,32,726,91,146,963,225.416666666667,95.9666666666667,2999.83050847458,1449.08771929825,32,49,81,96.7213114754098
"./Ship3_Latin-square/2019-09-03_14h33m_Subject 47783.txt","47783",2019-09-03,"14:33",24,83,60,13,10,23,94,10,25,129,37,10,9,56,294,4,68,366,629.033333333333,181.283333333333,1901.59322033898,1425.26315789474,73,46,119,98.3606557377049
"./Ship3_Latin-square/2019-09-03_14h33m_Subject 47785.txt","47785",2019-09-03,"14:33",24,73,51,13,9,22,93,12,26,131,30,17,22,69,332,7,64,403,1244.78431372549,189.901960784314,2011.70588235294,1250.57446808511,49,40,89,96.1538461538462
"./Ship3_Latin-square/2019-09-03_14h33m_Subject 47788.txt","47788",2019-09-03,"14:33",0,78,60,7,11,18,43,5,9,57,105,23,21,149,419,59,88,566,249.05,318.1,2999.94915254237,1838.91525423729,52,49,101,100
"./Ship3_Latin-square/2019-09-03_14h37m_Subject 46888.txt","46888",2019-09-03,"14:37",2,80,60,7,13,20,27,2,1,30,149,13,43,205,775,88,147,1010,114.116666666667,310.3,2874.50847457627,1442.13559322034,49,73,122,100
"./Ship3_Latin-square/2019-09-03_14h37m_Subject 46889.txt","46889",2019-09-03,"14:37",16,80,60,10,10,20,62,12,12,86,39,7,12,58,534,38,121,693,388.1,174.183333333333,2186.37288135593,1166.86206896552,60,102,162,98.3606557377049
"./Ship3_Latin-square/2019-09-03_14h37m_Subject 46892.txt","46892",2019-09-03,"14:37",0,75,60,4,11,15,25,1,4,30,21,6,1,28,971,74,177,1222,197.966666666667,193.883333333333,2999.93220338983,1286,45,62,107,100
"./Ship3_Latin-square/2019-09-03_14h37m_Subject 47097.txt","47097",2019-09-03,"14:37",24,82,60,13,9,22,151,3,45,199,85,24,14,123,324,0,116,440,596.416666666667,202.516666666667,1861,1328.98305084746,72,69,141,100
"./Ship3_Latin-square/2019-09-03_14h37m_Subject 47099.txt","47099",2019-09-03,"14:37",0,78,60,7,11,18,42,2,2,46,33,2,3,38,1378,182,238,1798,155.933333333333,167.95,2999.79661016949,1008.28813559322,37,50,87,100
"./Ship3_Latin-square/2019-09-03_14h37m_Subject 47798.txt","47798",2019-09-03,"14:37",8,79,59,11,9,20,65,4,19,88,57,13,6,76,245,31,68,344,930.983050847458,565.881355932203,2633.83050847458,1903.48076923077,51,59,110,93.3333333333333
"./Ship3_Latin-square/2019-09-03_15h45m_Subject 47080.txt","47080",2019-09-03,"15:45",4,78,60,9,9,18,46,4,2,52,14,1,10,25,594,82,129,805,276.366666666667,111.633333333333,2789.81355932203,1432.61403508772,49,77,126,98.3606557377049
"./Ship3_Latin-square/2019-09-03_15h45m_Subject 47089.txt","47089",2019-09-03,"15:45",2,66,50,9,7,16,85,20,16,121,131,47,46,224,255,40,38,333,1678.38775510204,439.183673469388,2906.04081632653,2059.22448979592,60,54,114,100
"./Ship3_Latin-square/2019-09-03_15h45m_Subject 47762.txt","47762",2019-09-03,"15:45",2,77,60,9,8,17,73,9,4,86,42,8,15,65,334,59,58,451,1157.15,272.3,2901.64406779661,2170.92156862745,61,118,179,95.0819672131148
"./Ship3_Latin-square/2019-09-03_15h45m_Subject 47791.txt","47791",2019-09-03,"15:45",0,83,60,5,18,23,44,4,14,62,54,14,23,91,621,57,212,890,406.75,195.2,2999.91525423729,1652.59649122807,37,74,111,96.7213114754098
"./Ship3_Latin-square/2019-09-04_09h35m_Subject 46878.txt","46878",2019-09-04,"09:35",2,81,60,10,11,21,36,10,3,49,70,43,31,144,919,144,172,1235,205.5,291.4,2894.89830508475,1495,68,65,133,98.3606557377049
"./Ship3_Latin-square/2019-09-04_09h35m_Subject 46885.txt","46885",2019-09-04,"09:35",0,84,60,9,15,24,73,8,10,91,61,9,4,74,330,56,82,468,782.85,231.633333333333,2999.91525423729,2011.5,63,72,135,95.0819672131148
"./Ship3_Latin-square/2019-09-04_09h35m_Subject 46899.txt","46899",2019-09-04,"09:35",16,80,60,12,8,20,70,10,18,98,55,10,10,75,414,45,81,540,554.3,226.2,2294.89830508475,1262.84745762712,33,41,74,100
"./Ship3_Latin-square/2019-09-04_09h35m_Subject 47091.txt","47091",2019-09-04,"09:35",16,77,60,9,8,17,52,2,4,58,68,26,6,100,230,23,51,304,622.5,207.45,2213.52542372881,1923.80769230769,67,79,146,91.8032786885246
"./Ship3_Latin-square/2019-09-04_09h35m_Subject 47231.txt","47231",2019-09-04,"09:35",16,73,60,9,4,13,85,17,8,110,36,7,2,45,236,23,15,274,1526.66666666667,193,2349.10169491525,1581.98076923077,63,45,108,88.5245901639344
"./Ship3_Latin-square/2019-09-04_09h35m_Subject 47238.txt","47238",2019-09-04,"09:35",2,81,60,12,9,21,43,6,7,56,93,30,42,165,616,108,143,867,414.35,340.733333333333,2905.05084745763,941.457627118644,48,55,103,100
"./Ship3_Latin-square/2019-09-04_09h35m_Subject 47242.txt","47242",2019-09-04,"09:35",2,83,60,11,12,23,38,3,5,46,121,17,87,225,683,133,166,982,227.383333333333,317.9,2898.27118644068,1094.20338983051,28,37,65,100
"./Ship3_Latin-square/2019-09-04_09h35m_Subject 47244.txt","47244",2019-09-04,"09:35",0,84,60,8,16,24,72,21,5,98,84,26,44,154,739,103,207,1049,423.183333333333,249.05,2999.94915254237,1561.13559322034,38,129,167,100
"./Ship3_Latin-square/2019-09-04_09h35m_Subject 47633.txt","47633",2019-09-04,"09:35",2,81,60,11,10,21,75,12,10,97,79,19,26,124,444,63,75,582,436.033333333333,277.15,2908.42372881356,1633.18644067797,38,89,127,100
"./Ship3_Latin-square/2019-09-04_09h35m_Subject 47636.txt","47636",2019-09-04,"09:35",8,74,54,10,10,20,323,25,15,363,77,24,16,117,292,39,56,387,1474,273.679245283019,2607.50943396226,2384.07692307692,97,74,171,98.1481481481482
"./Ship3_Latin-square/2019-09-04_09h35m_Subject 47752.txt","47752",2019-09-04,"09:35",16,83,60,14,9,23,68,7,9,84,28,30,26,84,580,66,139,785,549.316666666667,131.416666666667,2294.86440677966,1088.76363636364,47,91,138,93.4426229508197
"./Ship3_Latin-square/2019-09-04_09h35m_Subject 47767.txt","47767",2019-09-04,"09:35",2,86,60,10,16,26,64,26,2,92,60,79,81,220,420,69,121,610,345.633333333333,272.5,2877.94915254237,1470.06779661017,36,90,126,100
"./Ship3_Latin-square/2019-09-04_09h35m_Subject 47768.txt","47768",2019-09-04,"09:35",8,80,60,10,10,20,88,14,13,115,71,14,17,102,406,39,93,538,974.55,363.8,2593.16949152542,2182.96296296296,112,103,215,95.0819672131148
"./Ship3_Latin-square/2019-09-04_09h35m_Subject 47780.txt","47780",2019-09-04,"09:35",4,65,48,12,5,17,101,32,12,145,82,110,114,306,401,59,28,488,1006.95833333333,466.916666666667,2849.97916666667,2276.10416666667,52,59,111,100
"./Ship3_Latin-square/2019-09-04_09h38m_Subject 46884.txt","46884",2019-09-04,"09:38",24,71,51,11,9,20,110,5,26,141,42,34,11,87,140,3,35,178,1243.52941176471,445.156862745098,1823.47058823529,2080.56756756757,38,114,152,82.6923076923077
"./Ship3_Latin-square/2019-09-04_09h38m_Subject 47083.txt","47083",2019-09-04,"09:38",0,74,54,7,13,20,71,7,14,92,97,18,6,121,489,72,158,719,1174.94444444444,718.759259259259,2999.94339622642,1741.92452830189,64,66,130,98.1818181818182
"./Ship3_Latin-square/2019-09-04_09h38m_Subject 47246.txt","47246",2019-09-04,"09:38",24,73,60,9,4,13,104,9,10,123,70,6,6,82,353,2,41,396,644.516666666667,236.95,1983,1100.57894736842,49,64,113,96.7213114754098
"./Ship3_Latin-square/2019-09-04_09h38m_Subject 47635.txt","47635",2019-09-04,"09:38",2,79,60,12,7,19,38,9,4,51,77,20,14,111,667,115,93,875,366.8,320.9,2915.22033898305,1252.50847457627,57,70,127,100
"./Ship3_Latin-square/2019-09-04_09h38m_Subject 47779.txt","47779",2019-09-04,"09:38",2,78,60,6,12,18,40,1,3,44,57,15,18,90,185,23,40,248,734.366666666667,239.583333333333,2884.69491525424,2799.70833333333,83,89,172,86.8852459016393
"./Ship3_Latin-square/2019-09-04_09h38m_Subject 47797.txt","47797",2019-09-04,"09:38",4,49,38,2,9,11,55,4,4,63,26,2,10,38,156,3,14,173,2475.35135135135,622.72972972973,2718.83783783784,3108.77777777778,2,71,73,100
"./Ship3_Latin-square/2019-09-04_10h55m_Subject 46900.txt","46900",2019-09-04,"10:55",24,83,60,13,10,23,62,3,23,88,66,7,7,80,427,5,121,553,393.116666666667,253.9,1901.62711864407,1197.07547169811,43,82,125,93.4426229508197
"./Ship3_Latin-square/2019-09-04_10h55m_Subject 47076.txt","47076",2019-09-04,"10:55",2,82,60,9,13,22,11,7,2,20,48,9,2,59,784,120,197,1101,114,293.833333333333,2891.47457627119,1411.93220338983,65,100,165,100
"./Ship3_Latin-square/2019-09-04_10h55m_Subject 47079.txt","47079",2019-09-04,"10:55",0,81,60,11,10,21,25,2,3,30,70,11,8,89,396,87,72,555,400.916666666667,308.6,2999.93220338983,1550.01818181818,78,68,146,93.4426229508197
"./Ship3_Latin-square/2019-09-04_10h55m_Subject 47082.txt","47082",2019-09-04,"10:55",2,79,60,7,12,19,93,3,26,122,23,0,22,45,689,98,145,932,314.8,134.483333333333,2888.08474576271,1265.77586206897,47,92,139,98.3606557377049
"./Ship3_Latin-square/2019-09-04_10h55m_Subject 47092.txt","47092",2019-09-04,"10:55",0,80,60,9,11,20,19,6,3,28,79,8,18,105,709,107,131,947,119.85,261.333333333333,2999.93220338983,1554.1186440678,83,64,147,100
"./Ship3_Latin-square/2019-09-04_10h55m_Subject 47226.txt","47226",2019-09-04,"10:55",2,78,60,6,12,18,43,6,17,66,42,3,22,67,494,54,122,670,345.666666666667,186.066666666667,2881.25423728814,1757.59649122807,75,75,150,98.3606557377049
"./Ship3_Latin-square/2019-09-04_10h55m_Subject 47227.txt","47227",2019-09-04,"10:55",2,78,60,4,14,18,53,1,22,76,22,8,23,53,549,34,122,705,408.6,141.416666666667,2871.16949152542,1253.47457627119,24,58,82,100
"./Ship3_Latin-square/2019-09-04_10h55m_Subject 47250.txt","47250",2019-09-04,"10:55",4,80,60,11,9,20,33,3,3,39,13,7,8,28,765,98,153,1016,225.016666666667,110.466666666667,2816.89830508475,1030.25423728814,18,31,49,100
"./Ship3_Latin-square/2019-09-04_10h55m_Subject 47646.txt","47646",2019-09-04,"10:55",2,83,60,12,11,23,26,1,2,29,70,28,35,133,931,189,219,1339,279.066666666667,326.583333333333,2905.05084745763,1526.82142857143,70,64,134,96.7213114754098
"./Ship3_Latin-square/2019-09-04_10h55m_Subject 47755.txt","47755",2019-09-04,"10:55",16,82,60,12,10,22,71,14,16,101,81,15,11,107,493,61,115,669,417.016666666667,349.616666666667,2267.74576271186,1619.22807017544,90,137,227,98.3606557377049
"./Ship3_Latin-square/2019-09-04_10h55m_Subject 47760.txt","47760",2019-09-04,"10:55",0,79,60,7,12,19,94,8,11,113,41,10,15,66,781,84,158,1023,343.8,178.983333333333,2999.94915254237,1213.22033898305,23,37,60,100
"./Ship3_Latin-square/2019-09-04_10h55m_Subject 47770.txt","47770",2019-09-04,"10:55",2,57,44,6,7,13,74,19,9,102,85,14,6,105,203,40,26,269,2131.95454545455,529.181818181818,2893.02325581395,4342.45454545455,65,130,195,77.7777777777778
"./Ship3_Latin-square/2019-09-04_10h55m_Subject 47795.txt","47795",2019-09-04,"10:55",2,86,60,8,18,26,44,14,14,72,30,48,52,130,458,26,221,705,331.683333333333,301.366666666667,2861,1741.91525423729,36,43,79,100
"./Ship3_Latin-square/2019-09-04_10h58m_Subject 47229.txt","47229",2019-09-04,"10:58",4,74,60,6,8,14,26,1,2,29,37,6,6,49,788,66,104,958,160.95,158.9,2783,1130.81355932203,41,73,114,100
"./Ship3_Latin-square/2019-09-04_10h58m_Subject 47233.txt","47233",2019-09-04,"10:58",24,77,54,19,4,23,126,60,5,191,121,96,22,239,389,6,32,427,727.259259259259,659.092592592593,2456.60377358491,907.792452830189,67,23,90,100
"./Ship3_Latin-square/2019-09-04_10h58m_Subject 47241.txt","47241",2019-09-04,"10:58",4,87,60,4,23,27,43,7,13,63,18,12,22,52,685,45,319,1049,356.216666666667,145.65,2667.77966101695,1320.05263157895,10,87,97,98.3606557377049
"./Ship3_Latin-square/2019-09-04_10h58m_Subject 47247.txt","47247",2019-09-04,"10:58",0,77,60,5,12,17,30,4,7,41,42,5,9,56,378,48,83,509,223.15,218.15,2999.8813559322,1704.8813559322,35,84,119,100
"./Ship3_Latin-square/2019-09-04_10h58m_Subject 47777.txt","47777",2019-09-04,"10:58",2,84,60,11,13,24,44,3,10,57,22,7,7,36,526,121,123,770,318.4,310.833333333333,2901.69491525424,1565.55172413793,74,56,130,98.3606557377049
"./Ship3_Latin-square/2019-09-04_10h58m_Subject 47784.txt","47784",2019-09-04,"10:58",0,84,60,3,21,24,71,4,11,86,31,3,45,79,1154,44,324,1522,327.983333333333,142.683333333333,2999.93220338983,1335.20338983051,16,50,66,100
"./Ship3_Latin-square/2019-09-04_12h01m_Subject 46881.txt","46881",2019-09-04,"12:01",2,79,60,8,11,19,83,3,16,102,28,2,18,48,494,93,92,679,710.65,178.883333333333,2891.50847457627,2184.59649122807,33,190,223,98.3606557377049
"./Ship3_Latin-square/2019-09-04_12h01m_Subject 47087.txt","47087",2019-09-04,"12:01",2,80,58,6,16,22,81,25,19,125,86,13,60,159,358,41,84,483,836,265.51724137931,2866.63157894737,2127.15517241379,33,108,141,100
"./Ship3_Latin-square/2019-09-04_12h01m_Subject 47626.txt","47626",2019-09-04,"12:01",24,69,55,9,5,14,129,7,12,148,69,22,6,97,176,1,15,192,1870.14545454545,364.037037037037,1977.74074074074,2767.84905660377,99,74,173,98.1818181818182
"./Ship3_Latin-square/2019-09-04_12h01m_Subject 47634.txt","47634",2019-09-04,"12:01",2,78,57,10,11,21,123,31,19,173,49,24,43,116,350,60,93,503,897.508771929825,303.105263157895,2898.17543859649,1826.12280701754,106,45,151,100
"./Ship3_Latin-square/2019-09-04_12h01m_Subject 47640.txt","47640",2019-09-04,"12:01",2,77,56,10,11,21,78,12,8,98,50,7,40,97,536,92,161,789,1153.75,286.053571428571,2898.12727272727,1799.47916666667,41,141,182,92.9824561403509
"./Ship3_Latin-square/2019-09-04_12h01m_Subject 47754.txt","47754",2019-09-04,"12:01",0,78,60,5,13,18,38,1,3,42,64,1,16,81,671,53,146,870,186.683333333333,284.816666666667,2999.86440677966,1608.42857142857,32,128,160,98.3606557377049
"./Ship3_Latin-square/2019-09-04_12h01m_Subject 47800.txt","47800",2019-09-04,"12:01",4,80,60,6,14,20,48,2,5,55,73,9,16,98,550,46,151,747,360.083333333333,234.85,2755.8813559322,1442.38983050847,54,82,136,100
"./Ship3_Latin-square/2019-09-04_12h08m_Subject 46880.txt","46880",2019-09-04,"12:08",24,84,59,14,11,25,99,5,28,132,37,8,11,56,197,0,60,257,906.206896551724,234.155172413793,1924.12068965517,1888.25531914894,81,66,147,84.7457627118644
"./Ship3_Latin-square/2019-09-04_12h08m_Subject 46882.txt","46882",2019-09-04,"12:08",2,83,60,11,12,23,16,0,1,17,109,15,29,153,873,143,181,1197,236.283333333333,246.616666666667,2894.79661016949,1816.36734693878,249,46,295,88.5245901639344
"./Ship3_Latin-square/2019-09-04_12h08m_Subject 46883.txt","46883",2019-09-04,"12:08",2,84,60,11,13,24,66,23,16,105,41,23,70,134,333,58,96,487,531.733333333333,196.083333333333,2894.89830508475,2022.67272727273,38,90,128,95.0819672131148
"./Ship3_Latin-square/2019-09-04_12h08m_Subject 46894.txt","46894",2019-09-04,"12:08",0,76,60,6,10,16,43,9,3,55,24,3,5,32,423,50,70,543,529.466666666667,128.066666666667,2999.93220338983,1842.2037037037,54,57,111,95.0819672131148
"./Ship3_Latin-square/2019-09-04_12h08m_Subject 47088.txt","47088",2019-09-04,"12:08",8,76,60,7,9,16,30,4,4,38,71,12,15,98,665,85,103,853,135.95,250.716666666667,2593.22033898305,1095.71186440678,40,62,102,100
"./Ship3_Latin-square/2019-09-04_12h08m_Subject 47228.txt","47228",2019-09-04,"12:08",0,79,60,8,11,19,42,5,10,57,24,5,9,38,454,88,61,603,557.266666666667,155,2999.91525423729,1972.50943396226,62,109,171,93.4426229508197
"./Ship3_Latin-square/2019-09-04_12h08m_Subject 47243.txt","47243",2019-09-04,"12:08",0,84,60,7,17,24,52,7,6,65,31,8,18,57,657,67,216,940,334.3,244.483333333333,2999.89830508475,1545.33333333333,84,119,203,100
"./Ship3_Latin-square/2019-09-04_12h08m_Subject 47249.txt","47249",2019-09-04,"12:08",8,81,60,12,9,21,58,8,11,77,100,69,15,184,272,46,45,363,577.35,273.716666666667,2633.8813559322,2091.25862068966,71,58,129,98.3606557377049
"./Ship3_Latin-square/2019-09-04_12h08m_Subject 47639.txt","47639",2019-09-04,"12:08",0,78,60,8,10,18,35,2,1,38,8,0,9,17,757,105,114,976,168.6,134.566666666667,2999.91525423729,1558.93220338983,48,64,112,100
"./Ship3_Latin-square/2019-09-04_12h08m_Subject 47649.txt","47649",2019-09-04,"12:08",16,74,54,9,11,20,48,7,10,65,32,12,21,65,262,25,57,344,922.092592592593,193.888888888889,2140.68518518519,1855.97619047619,51,88,139,83.6363636363636
"./Ship3_Latin-square/2019-09-04_12h08m_Subject 47758.txt","47758",2019-09-04,"12:08",8,79,60,9,10,19,10,1,5,16,22,1,9,32,651,82,136,869,104.05,154.733333333333,2593.20338983051,1073.34482758621,74,20,94,100
"./Ship3_Latin-square/2019-09-04_12h08m_Subject 47759.txt","47759",2019-09-04,"12:08",8,83,60,12,11,23,21,0,6,27,27,7,15,49,442,55,90,587,190.083333333333,165.583333333333,2620.32203389831,1709.49090909091,95,72,167,93.4426229508197
"./Ship3_Latin-square/2019-09-04_12h08m_Subject 47776.txt","47776",2019-09-04,"12:08",0,82,60,5,17,22,36,2,3,41,75,9,35,119,930,73,254,1257,198.933333333333,208.183333333333,2999.96610169492,1541.5593220339,40,66,106,100
"./Ship3_Latin-square/2019-09-04_12h08m_Subject 47799.txt","47799",2019-09-04,"12:08",8,77,60,6,11,17,9,1,2,12,65,18,15,98,413,38,101,552,226.616666666667,209.666666666667,2538.96610169492,1602.05660377358,52,97,149,91.8032786885246
"./Ship3_Latin-square/2019-09-04_13h16m_Subject 46876.txt","46876",2019-09-04,"13:16",24,56,43,11,2,13,74,10,4,88,10,4,2,16,187,1,8,196,3974.35714285714,127.166666666667,2314.2619047619,1322.35294117647,56,43,99,83.7209302325581
"./Ship3_Latin-square/2019-09-04_13h16m_Subject 46877.txt","46877",2019-09-04,"13:16",8,84,60,14,10,24,29,2,8,39,47,17,46,110,705,167,142,1014,219.9,170.466666666667,2633.84745762712,1530.10526315789,81,64,145,96.7213114754098
"./Ship3_Latin-square/2019-09-04_13h16m_Subject 46893.txt","46893",2019-09-04,"13:16",0,79,60,7,12,19,14,2,1,17,53,4,10,67,861,110,223,1194,92.9,224.25,2999.93220338983,1587.78947368421,88,100,188,96.7213114754098
"./Ship3_Latin-square/2019-09-04_13h16m_Subject 46895.txt","46895",2019-09-04,"13:16",16,58,43,11,4,15,94,28,12,134,81,24,6,111,185,27,13,225,1829.09302325581,1243.6976744186,2390.40476190476,1979.90243902439,31,53,84,95.4545454545455
"./Ship3_Latin-square/2019-09-04_13h16m_Subject 47638.txt","47638",2019-09-04,"13:16",0,82,60,9,13,22,63,10,16,89,35,14,54,103,485,91,68,644,539.183333333333,187.75,2999.94915254237,1504.12280701754,49,41,90,98.3606557377049
"./Ship3_Latin-square/2019-09-04_13h16m_Subject 47757.txt","47757",2019-09-04,"13:16",8,73,57,9,7,16,79,15,11,105,41,10,11,62,332,52,58,442,1284.51785714286,222.196428571429,2628.48214285714,2053.82142857143,85,103,188,100
"./Ship3_Latin-square/2019-09-04_13h16m_Subject 47769.txt","47769",2019-09-04,"13:16",0,84,60,14,10,24,20,2,3,25,37,19,29,85,862,186,131,1179,148.816666666667,187.583333333333,2999.93220338983,1473.64406779661,119,87,206,100
"./Ship3_Latin-square/2019-09-04_13h16m_Subject 47771.txt","47771",2019-09-04,"13:16",4,84,60,10,14,24,18,2,7,27,26,6,23,55,696,112,160,968,160.033333333333,151.033333333333,2769.40677966102,1565.01818181818,33,122,155,93.4426229508197
"./Ship3_Latin-square/2019-09-04_13h16m_Subject 47775.txt","47775",2019-09-04,"13:16",4,83,60,13,10,23,77,10,11,98,69,22,3,94,465,100,77,642,428.066666666667,279.05,2810.1186440678,1301.38983050847,65,18,83,100
"./Ship3_Latin-square/2019-09-04_13h16m_Subject 47781.txt","47781",2019-09-04,"13:16",2,80,60,9,11,20,24,3,2,29,61,10,10,81,1063,153,234,1450,121.2,239.55,2894.86440677966,1268.87931034483,62,36,98,98.3606557377049
"./Ship3_Latin-square/2019-09-04_13h16m_Subject 47782.txt","47782",2019-09-04,"13:16",8,78,60,8,10,18,40,2,9,51,5,16,3,24,609,56,160,825,175.25,82.6,2579.54237288136,1164.49122807018,18,32,50,96.7213114754098
"./Ship3_Latin-square/2019-09-04_13h16m_Subject 47783.txt","47783",2019-09-04,"13:16",2,82,60,10,12,22,60,4,4,68,50,11,20,81,700,138,158,996,327.6,196.516666666667,2894.89830508475,1528.62711864407,45,97,142,100
"./Ship3_Latin-square/2019-09-04_13h16m_Subject 47785.txt","47785",2019-09-04,"13:16",2,81,60,8,13,21,14,7,6,27,20,8,14,42,1007,109,203,1319,122.316666666667,143.116666666667,2888.10169491525,1396.69491525424,49,72,121,100
"./Ship3_Latin-square/2019-09-04_13h16m_Subject 47788.txt","47788",2019-09-04,"13:16",8,80,60,9,11,20,48,6,7,61,87,30,25,142,409,59,110,578,288.15,258.9,2552.45762711864,1756.57627118644,38,66,104,100
"./Ship3_Latin-square/2019-09-04_13h19m_Subject 46888.txt","46888",2019-09-04,"13:19",4,76,60,8,8,16,13,0,3,16,117,11,14,142,720,88,111,919,86.0666666666667,273.766666666667,2796.59322033898,1501.43103448276,76,44,120,98.3606557377049
"./Ship3_Latin-square/2019-09-04_13h19m_Subject 46889.txt","46889",2019-09-04,"13:19",0,79,60,3,16,19,26,0,4,30,27,4,9,40,921,65,261,1247,151.816666666667,145.966666666667,2999.93220338983,1387.44444444444,80,115,195,90.1639344262295
"./Ship3_Latin-square/2019-09-04_13h19m_Subject 46892.txt","46892",2019-09-04,"13:19",8,84,60,12,12,24,15,1,5,21,14,4,6,24,723,155,180,1058,96.7666666666667,138.05,2593.20338983051,1299.13793103448,53,64,117,98.3606557377049
"./Ship3_Latin-square/2019-09-04_13h19m_Subject 46898.txt","46898",2019-09-04,"13:19",4,81,60,15,6,21,53,27,7,87,73,41,39,153,500,144,76,720,440.983333333333,472.116666666667,2850.79661016949,1515.98305084746,47,93,140,100
"./Ship3_Latin-square/2019-09-04_13h19m_Subject 47097.txt","47097",2019-09-04,"13:19",2,80,60,9,11,20,13,1,3,17,87,28,42,157,723,85,143,951,150,287.333333333333,2888.10169491525,1499.91525423729,69,77,146,100
"./Ship3_Latin-square/2019-09-04_13h19m_Subject 47099.txt","47099",2019-09-04,"13:19",8,80,60,10,10,20,24,4,1,29,31,1,2,34,780,88,177,1045,161.066666666667,194.533333333333,2606.71186440678,1117.32203389831,43,56,99,100
"./Ship3_Latin-square/2019-09-04_13h19m_Subject 47798.txt","47798",2019-09-04,"13:19",2,84,60,3,21,24,32,0,11,43,29,2,9,40,241,12,100,353,585.466666666667,214.7,2844.03389830508,2321.05263157895,29,162,191,83.6065573770492
"./Ship3_Latin-square/2019-09-04_14h35m_Subject 47080.txt","47080",2019-09-04,"14:35",0,80,60,7,13,20,28,1,4,33,14,2,4,20,395,43,90,528,212.1,152.366666666667,2999.86440677966,2014.02083333333,52,145,197,90.1639344262295
"./Ship3_Latin-square/2019-09-04_14h35m_Subject 47089.txt","47089",2019-09-04,"14:35",4,65,48,10,7,17,54,4,3,61,80,28,22,130,161,32,22,215,2038.1914893617,307.893617021277,2812.68085106383,3744.525,81,68,149,87.5
"./Ship3_Latin-square/2019-09-04_14h35m_Subject 47762.txt","47762",2019-09-04,"14:35",16,80,60,10,10,20,55,3,13,71,18,4,7,29,264,32,56,352,654.483333333333,160.083333333333,2213.5593220339,1820.14583333333,70,98,168,83.6065573770492
"./Ship3_Latin-square/2019-09-04_14h35m_Subject 47791.txt","47791",2019-09-04,"14:35",24,85,60,15,10,25,51,20,9,80,47,26,16,89,282,3,38,323,468.583333333333,238.65,1942.32203389831,1738.65217391304,79,62,141,81.9672131147541
"./Ship3_Latin-square/2019-09-05_10h05m_Subject 46878.txt","46878",2019-09-05,"10:05",16,80,60,9,11,20,20,6,7,33,70,10,12,92,558,48,187,793,147,243.533333333333,2132.16949152542,1400.01724137931,50,66,116,98.3606557377049
"./Ship3_Latin-square/2019-09-05_10h05m_Subject 46885.txt","46885",2019-09-05,"10:05",24,69,51,13,5,18,135,31,21,187,18,15,14,47,188,4,18,210,1678.88,241.5,2135.9,1866.46808510638,72,38,110,94.1176470588235
"./Ship3_Latin-square/2019-09-05_10h05m_Subject 46899.txt","46899",2019-09-05,"10:05",0,82,60,10,12,22,53,10,8,71,37,10,14,61,662,111,157,930,302,155.816666666667,2999.94915254237,1258.93220338983,35,70,105,100
"./Ship3_Latin-square/2019-09-05_10h05m_Subject 47081.txt","47081",2019-09-05,"10:05",4,82,60,11,11,22,94,15,3,112,143,3,51,197,578,96,147,821,371.116666666667,435.566666666667,2796.54237288136,1169.89830508475,27,48,75,100
"./Ship3_Latin-square/2019-09-05_10h05m_Subject 47091.txt","47091",2019-09-05,"10:05",0,79,60,5,14,19,53,2,6,61,78,9,26,113,507,51,106,664,513.15,200.683333333333,2999.8813559322,1568.4406779661,63,70,133,100
"./Ship3_Latin-square/2019-09-05_10h05m_Subject 47231.txt","47231",2019-09-05,"10:05",0,84,59,6,19,25,59,4,18,81,40,12,17,69,346,29,145,520,1040.87931034483,161.120689655172,2999.84482758621,1251.87037037037,19,60,79,94.9152542372881
"./Ship3_Latin-square/2019-09-05_10h05m_Subject 47238.txt","47238",2019-09-05,"10:05",4,81,60,9,12,21,29,0,2,31,83,8,37,128,563,96,157,816,216.183333333333,278.483333333333,2776.22033898305,1474.53191489362,48,172,220,90.1639344262295
"./Ship3_Latin-square/2019-09-05_10h05m_Subject 47242.txt","47242",2019-09-05,"10:05",4,77,60,6,11,17,51,0,7,58,84,9,32,125,565,58,136,759,282.55,222.1,2769.4406779661,1298.62711864407,30,73,103,100
"./Ship3_Latin-square/2019-09-05_10h05m_Subject 47244.txt","47244",2019-09-05,"10:05",24,59,45,11,3,14,74,7,8,89,132,32,28,192,340,5,18,363,581.533333333333,2003.02222222222,2199.93333333333,1090.52272727273,54,54,108,97.8260869565217
"./Ship3_Latin-square/2019-09-05_10h05m_Subject 47633.txt","47633",2019-09-05,"10:05",16,80,60,10,10,20,113,11,23,147,84,20,26,130,330,38,69,437,801.6,245.433333333333,2186.37288135593,1459.16949152542,47,62,109,100
"./Ship3_Latin-square/2019-09-05_10h05m_Subject 47636.txt","47636",2019-09-05,"10:05",2,79,60,11,8,19,149,10,16,175,162,61,12,235,366,71,62,499,1060.2,313.616666666667,2911.81355932203,2946.38596491228,158,75,233,98.3606557377049
"./Ship3_Latin-square/2019-09-05_10h05m_Subject 47752.txt","47752",2019-09-05,"10:05",0,84,60,9,15,24,44,7,11,62,41,20,51,112,788,84,223,1095,329.266666666667,152.333333333333,2999.86440677966,1315.26315789474,25,84,109,98.3606557377049
"./Ship3_Latin-square/2019-09-05_10h05m_Subject 47767.txt","47767",2019-09-05,"10:05",4,82,60,14,8,22,43,5,7,55,22,28,6,56,366,69,62,497,516.15,154.95,2844.05084745763,1521.8431372549,85,23,108,88.5245901639344
"./Ship3_Latin-square/2019-09-05_10h05m_Subject 47768.txt","47768",2019-09-05,"10:05",2,84,60,13,11,24,78,10,4,92,51,8,14,73,503,142,73,718,869.533333333333,298.233333333333,2901.64406779661,2003.28813559322,73,59,132,100
"./Ship3_Latin-square/2019-09-05_10h05m_Subject 47780.txt","47780",2019-09-05,"10:05",8,77,60,8,9,17,68,9,8,85,53,26,47,126,328,39,72,439,493.166666666667,228.3,2579.64406779661,1989.30769230769,66,88,154,90.1639344262295
"./Ship3_Latin-square/2019-09-05_10h08m_Subject 46884.txt","46884",2019-09-05,"10:08",2,35,27,3,5,8,48,1,2,51,61,0,5,66,244,26,65,335,755.925925925926,573.296296296296,2884.57692307692,2045,28,94,122,100
"./Ship3_Latin-square/2019-09-05_10h08m_Subject 47083.txt","47083",2019-09-05,"10:08",24,34,24,10,0,10,45,10,0,55,19,45,0,64,186,3,0,189,982.833333333333,255.291666666667,-3671.5,1114.25,72,8,80,88
"./Ship3_Latin-square/2019-09-05_10h08m_Subject 47086.txt","47086",2019-09-05,"10:08",4,37,28,5,4,9,36,2,2,40,57,16,3,76,227,23,50,300,415.285714285714,463.607142857143,2807.2962962963,1250.82608695652,43,53,96,89.6551724137931
"./Ship3_Latin-square/2019-09-05_10h08m_Subject 47246.txt","47246",2019-09-05,"10:08",2,38,28,0,10,10,33,0,4,37,14,0,23,37,305,0,101,406,397.071428571429,149.678571428571,2829.59259259259,1488.60714285714,5,55,60,100
"./Ship3_Latin-square/2019-09-05_10h08m_Subject 47635.txt","47635",2019-09-05,"10:08",16,40,33,2,5,7,32,0,5,37,36,4,5,45,262,10,56,328,356.545454545455,217.878787878788,2150,1384.06451612903,33,45,78,94.1176470588235
"./Ship3_Latin-square/2019-09-05_10h08m_Subject 47779.txt","47779",2019-09-05,"10:08",16,34,24,7,3,10,23,1,6,30,25,11,2,38,90,7,20,117,999.130434782609,250.869565217391,2443.4347826087,-5009.05263157895,44,23,67,87.5
"./Ship3_Latin-square/2019-09-05_10h08m_Subject 47797.txt","47797",2019-09-05,"10:08",8,19,16,1,2,3,45,1,2,48,20,0,2,22,46,0,23,69,3783.875,1360.3125,2550,2339.625,3,26,29,100
"./Ship3_Latin-square/2019-09-05_11h33m_Subject 46900.txt","46900",2019-09-05,"11:33",2,83,60,10,13,23,81,28,2,111,67,15,9,91,794,144,162,1100,307.266666666667,266.666666666667,2891.47457627119,1317.31578947368,45,92,137,98.3606557377049
"./Ship3_Latin-square/2019-09-05_11h33m_Subject 47076.txt","47076",2019-09-05,"11:33",4,79,60,10,9,19,26,2,1,29,32,6,14,52,634,92,146,872,152.316666666667,208.466666666667,2803.35593220339,1540.59649122807,73,110,183,96.7213114754098
"./Ship3_Latin-square/2019-09-05_11h33m_Subject 47079.txt","47079",2019-09-05,"11:33",24,66,49,13,4,17,71,11,3,85,45,10,3,58,159,2,16,177,1386.08333333333,253.020833333333,2199.91666666667,2804.425,102,46,148,85.7142857142857
"./Ship3_Latin-square/2019-09-05_11h33m_Subject 47082.txt","47082",2019-09-05,"11:33",4,79,60,8,11,19,44,17,6,67,72,4,28,104,418,44,75,537,466.366666666667,235.15,2782.91525423729,1943.94827586207,57,49,106,100
"./Ship3_Latin-square/2019-09-05_11h33m_Subject 47092.txt","47092",2019-09-05,"11:33",24,69,52,9,8,17,178,5,54,237,73,17,23,113,260,0,51,311,1398.88461538462,311.538461538462,1917.56862745098,1976.74509803922,58,75,133,100
"./Ship3_Latin-square/2019-09-05_11h33m_Subject 47226.txt","47226",2019-09-05,"11:33",4,83,60,7,16,23,33,7,9,49,35,1,26,62,509,39,180,728,268.75,203.783333333333,2742.35593220339,1583.22222222222,44,91,135,93.4426229508197
"./Ship3_Latin-square/2019-09-05_11h33m_Subject 47227.txt","47227",2019-09-05,"11:33",4,80,60,7,13,20,38,1,4,43,24,15,13,52,496,75,87,658,421.316666666667,144.016666666667,2782.96610169492,1375.47368421053,28,60,88,96.7213114754098
"./Ship3_Latin-square/2019-09-05_11h33m_Subject 47250.txt","47250",2019-09-05,"11:33",0,80,60,9,11,20,20,5,7,32,14,1,17,32,1017,129,228,1374,87.8833333333333,130.633333333333,2999.84745762712,1175.49152542373,28,31,59,100
"./Ship3_Latin-square/2019-09-05_11h33m_Subject 47646.txt","47646",2019-09-05,"11:33",4,80,60,7,13,20,68,3,9,80,66,10,36,112,607,47,207,861,550.9,273.5,2755.93220338983,1528.2962962963,37,89,126,98.3606557377049
"./Ship3_Latin-square/2019-09-05_11h33m_Subject 47755.txt","47755",2019-09-05,"11:33",0,82,60,5,17,22,38,1,5,44,58,4,19,81,816,66,194,1076,187.166666666667,256.466666666667,2999.8813559322,1951.58928571429,43,335,378,96.7213114754098
"./Ship3_Latin-square/2019-09-05_11h33m_Subject 47760.txt","47760",2019-09-05,"11:33",24,86,60,15,11,26,96,12,34,142,82,23,14,119,316,0,92,408,650.372881355932,381.932203389831,1901.62711864407,1158.49152542373,33,31,64,100
"./Ship3_Latin-square/2019-09-05_11h33m_Subject 47770.txt","47770",2019-09-05,"11:33",16,56,40,10,6,16,62,26,10,98,61,30,10,101,151,24,26,201,2045.225,658.2,2359.975,2782.68421052632,60,40,100,95.1219512195122
"./Ship3_Latin-square/2019-09-05_11h33m_Subject 47795.txt","47795",2019-09-05,"11:33",4,81,60,7,14,21,34,3,4,41,17,3,11,31,484,57,142,683,204.65,180.216666666667,2755.91525423729,2043.91228070175,59,31,90,96.7213114754098
"./Ship3_Latin-square/2019-09-05_11h36m_Subject 47229.txt","47229",2019-09-05,"11:36",0,78,60,6,12,18,24,0,4,28,54,9,19,82,915,121,137,1173,159.433333333333,216.616666666667,2999.91525423729,1197.74576271186,37,82,119,100
"./Ship3_Latin-square/2019-09-05_11h36m_Subject 47233.txt","47233",2019-09-05,"11:36",2,78,60,6,12,18,65,5,10,80,73,9,9,91,521,45,115,681,273.9,306.983333333333,2877.91525423729,1503.28813559322,55,72,127,100
"./Ship3_Latin-square/2019-09-05_11h36m_Subject 47234.txt","47234",2019-09-05,"11:36",4,73,51,14,8,22,105,43,37,185,208,88,67,363,369,137,73,579,583.294117647059,705.725490196078,2839.94,1344.69387755102,50,53,103,98.0769230769231
"./Ship3_Latin-square/2019-09-05_11h36m_Subject 47241.txt","47241",2019-09-05,"11:36",8,80,60,4,16,20,51,1,7,59,12,1,11,24,639,43,234,916,296.883333333333,158.283333333333,2430.49152542373,1458.34482758621,37,99,136,100
"./Ship3_Latin-square/2019-09-05_11h36m_Subject 47247.txt","47247",2019-09-05,"11:36",24,67,52,10,5,15,115,10,18,143,73,17,5,95,160,2,32,194,2110.1568627451,400.960784313725,2011.72549019608,1730.35294117647,50,42,92,100
"./Ship3_Latin-square/2019-09-05_11h36m_Subject 47777.txt","47777",2019-09-05,"11:36",4,76,60,7,9,16,33,0,6,39,16,3,8,27,505,59,79,643,273.8,275.816666666667,2782.96610169492,1646.57627118644,61,40,101,100
"./Ship3_Latin-square/2019-09-05_11h36m_Subject 47784.txt","47784",2019-09-05,"11:36",24,72,52,16,4,20,191,38,16,245,78,15,7,100,447,0,39,486,1628.73076923077,346.730769230769,2307.65384615385,1092.53846153846,70,16,86,100
"./Ship3_Latin-square/2019-09-05_12h42m_Subject 46880.txt","46880",2019-09-05,"12:42",2,82,60,11,11,22,24,2,3,29,36,9,13,58,497,93,83,673,241.3,254.466666666667,2898.28813559322,1829.88,61,146,207,91.8032786885246
"./Ship3_Latin-square/2019-09-05_12h42m_Subject 46882.txt","46882",2019-09-05,"12:42",4,76,60,8,8,16,14,0,1,15,58,9,10,77,872,77,159,1108,156.05,209.916666666667,2803.33898305085,1335.94642857143,74,42,116,96.7213114754098
"./Ship3_Latin-square/2019-09-05_12h42m_Subject 46883.txt","46883",2019-09-05,"12:42",16,83,60,13,10,23,49,12,7,68,34,14,10,58,404,49,93,546,357.3,155.616666666667,2294.84745762712,1427.75925925926,45,55,100,96.7213114754098
"./Ship3_Latin-square/2019-09-05_12h42m_Subject 46894.txt","46894",2019-09-05,"12:42",8,81,60,10,11,21,35,4,9,48,16,1,13,30,293,43,49,385,698.283333333333,123.55,2579.61016949153,1966.22,77,54,131,90.1639344262295
"./Ship3_Latin-square/2019-09-05_12h42m_Subject 47088.txt","47088",2019-09-05,"12:42",24,81,60,15,6,21,87,24,5,116,86,37,10,133,266,0,68,334,519.05,244.716666666667,2064.28813559322,914.056603773585,38,53,91,90.1639344262295
"./Ship3_Latin-square/2019-09-05_12h42m_Subject 47228.txt","47228",2019-09-05,"12:42",8,79,60,8,11,19,29,4,4,37,23,6,9,38,510,61,76,647,240.483333333333,146.083333333333,2566.01694915254,1367.43396226415,40,114,154,93.4426229508197
"./Ship3_Latin-square/2019-09-05_12h42m_Subject 47243.txt","47243",2019-09-05,"12:42",8,82,60,12,10,22,44,7,13,64,48,5,10,63,633,114,122,869,321.366666666667,366.183333333333,2606.76271186441,1320.86206896552,128,82,210,98.3606557377049
"./Ship3_Latin-square/2019-09-05_12h42m_Subject 47249.txt","47249",2019-09-05,"12:42",24,76,55,14,7,21,89,23,21,133,86,70,13,169,212,18,40,270,1039.46296296296,258.666666666667,2111.07407407407,1528.67391304348,46,82,128,89.0909090909091
"./Ship3_Latin-square/2019-09-05_12h42m_Subject 47639.txt","47639",2019-09-05,"12:42",8,78,60,9,9,18,23,1,4,28,14,2,4,20,581,68,118,767,132.033333333333,133.35,2593.06779661017,1523.52727272727,53,89,142,95.0819672131148
"./Ship3_Latin-square/2019-09-05_12h42m_Subject 47649.txt","47649",2019-09-05,"12:42",0,79,60,9,10,19,40,4,10,54,37,5,18,60,483,81,89,653,609.966666666667,187.383333333333,2999.86440677966,1782.12244897959,79,130,209,88.5245901639344
"./Ship3_Latin-square/2019-09-05_12h42m_Subject 47758.txt","47758",2019-09-05,"12:42",24,78,60,13,5,18,76,5,9,90,21,11,1,33,501,0,70,571,384.116666666667,145.466666666667,2186.40677966102,948.379310344828,72,10,82,100
"./Ship3_Latin-square/2019-09-05_12h42m_Subject 47759.txt","47759",2019-09-05,"12:42",24,78,56,14,8,22,78,9,20,107,52,19,56,127,226,2,46,274,994.375,257.053571428571,2014.23214285714,1695.75,48,78,126,92.9824561403509
"./Ship3_Latin-square/2019-09-05_12h42m_Subject 47776.txt","47776",2019-09-05,"12:42",8,78,60,6,12,18,27,2,1,30,69,8,20,97,858,69,223,1150,116,159.15,2498.27118644068,1380.33898305085,26,69,95,100
"./Ship3_Latin-square/2019-09-05_12h42m_Subject 47799.txt","47799",2019-09-05,"12:42",24,85,60,12,13,25,73,4,21,98,72,61,31,164,229,3,95,327,378.216666666667,250.933333333333,1738.91525423729,1245.35185185185,52,37,89,91.8032786885246
"./Ship3_Latin-square/2019-09-05_12h45m_Subject 46881.txt","46881",2019-09-05,"12:45",4,80,60,10,10,20,49,17,4,70,48,4,27,79,474,81,96,651,377.433333333333,221.966666666667,2789.74576271186,1708.2037037037,39,137,176,95.0819672131148
"./Ship3_Latin-square/2019-09-05_12h45m_Subject 47087.txt","47087",2019-09-05,"12:45",4,80,60,8,12,20,45,11,9,65,87,14,9,110,429,70,105,604,500.95,360.116666666667,2789.81355932203,1724.93103448276,54,80,134,100
"./Ship3_Latin-square/2019-09-05_12h45m_Subject 47626.txt","47626",2019-09-05,"12:45",2,82,60,12,10,22,122,8,15,145,61,26,23,110,324,49,55,428,630.383333333333,214.95,2908.4406779661,2280.98076923077,101,91,192,90.1639344262295
"./Ship3_Latin-square/2019-09-05_12h45m_Subject 47634.txt","47634",2019-09-05,"12:45",4,81,60,10,11,21,66,8,16,90,52,14,19,85,585,65,151,801,663.133333333333,326.266666666667,2803.35593220339,1592.22807017544,83,76,159,98.3606557377049
"./Ship3_Latin-square/2019-09-05_12h45m_Subject 47640.txt","47640",2019-09-05,"12:45",4,82,60,12,10,22,38,5,5,48,19,9,4,32,887,134,226,1247,174.183333333333,129.783333333333,2810.08474576271,1255.31481481481,42,106,148,95.0819672131148
"./Ship3_Latin-square/2019-09-05_12h45m_Subject 47754.txt","47754",2019-09-05,"12:45",8,76,60,7,9,16,48,3,4,55,45,8,31,84,334,47,61,442,1297.18333333333,228.616666666667,2579.66101694915,2058.88235294118,24,117,141,86.8852459016393
"./Ship3_Latin-square/2019-09-05_12h45m_Subject 47800.txt","47800",2019-09-05,"12:45",0,81,60,11,10,21,45,10,2,57,55,13,18,86,572,78,89,739,381.966666666667,228.483333333333,2999.81355932203,1255.94827586207,49,66,115,100
"./Ship3_Latin-square/2019-09-05_14h00m_Subject 46876.txt","46876",2019-09-05,"14:00",2,76,60,8,8,16,57,7,3,67,39,6,6,51,427,51,63,541,550.433333333333,290.883333333333,2898.23728813559,1683.89795918367,44,151,195,90.1639344262295
"./Ship3_Latin-square/2019-09-05_14h00m_Subject 46877.txt","46877",2019-09-05,"14:00",2,87,60,10,17,27,105,23,4,132,149,16,155,320,1066,175,339,1580,286.9,378.583333333333,2877.89830508475,1092.58620689655,37,81,118,100
"./Ship3_Latin-square/2019-09-05_14h00m_Subject 46893.txt","46893",2019-09-05,"14:00",8,78,60,9,9,18,16,0,0,16,44,3,7,54,801,94,199,1094,90.2666666666667,190.05,2633.79661016949,1313.69491525424,71,59,130,100
"./Ship3_Latin-square/2019-09-05_14h00m_Subject 46895.txt","46895",2019-09-05,"14:00",0,80,55,6,19,25,50,7,16,73,29,16,13,58,367,24,133,524,1011.85454545455,228.363636363636,2999.92727272727,1893.45098039216,22,112,134,94.6428571428571
"./Ship3_Latin-square/2019-09-05_14h00m_Subject 47638.txt","47638",2019-09-05,"14:00",8,77,60,9,8,17,54,10,9,73,51,10,23,84,291,38,40,369,569.25,224.283333333333,2633.86440677966,1763.26785714286,66,25,91,95.0819672131148
"./Ship3_Latin-square/2019-09-05_14h00m_Subject 47757.txt","47757",2019-09-05,"14:00",24,71,50,14,7,21,122,26,21,169,48,15,12,75,217,17,44,278,1515.82,240.8,2118.32653061224,1593.23255813953,70,88,158,88.2352941176471
"./Ship3_Latin-square/2019-09-05_14h00m_Subject 47769.txt","47769",2019-09-05,"14:00",8,82,60,12,10,22,38,2,7,47,39,16,14,69,621,108,175,904,194.5,156.483333333333,2633.86440677966,1225,88,52,140,100
"./Ship3_Latin-square/2019-09-05_14h00m_Subject 47771.txt","47771",2019-09-05,"14:00",0,82,60,9,13,22,21,3,0,24,26,1,18,45,965,114,205,1284,115.25,156.85,2999.93220338983,1403.42105263158,18,141,159,98.3606557377049
"./Ship3_Latin-square/2019-09-05_14h00m_Subject 47775.txt","47775",2019-09-05,"14:00",0,81,60,7,14,21,64,6,13,83,10,6,4,20,455,55,104,614,422.266666666667,119.083333333333,2999.91525423729,1581.86440677966,54,31,85,100
"./Ship3_Latin-square/2019-09-05_14h00m_Subject 47781.txt","47781",2019-09-05,"14:00",4,80,60,9,11,20,25,3,3,31,50,22,25,97,906,74,209,1189,206.9,225.116666666667,2783.03389830508,1285.77586206897,73,72,145,98.3606557377049
"./Ship3_Latin-square/2019-09-05_14h00m_Subject 47782.txt","47782",2019-09-05,"14:00",24,77,60,12,5,17,57,5,5,67,22,24,3,49,472,1,51,524,245.25,114.633333333333,2064.33898305085,786.6,33,50,83,80.327868852459
"./Ship3_Latin-square/2019-09-05_14h00m_Subject 47783.txt","47783",2019-09-05,"14:00",4,83,60,12,11,23,47,12,10,69,47,10,11,68,584,122,126,832,626.516666666667,250,2810.13559322034,1578.57894736842,54,59,113,96.7213114754098
"./Ship3_Latin-square/2019-09-05_14h00m_Subject 47785.txt","47785",2019-09-05,"14:00",4,82,60,11,11,22,21,4,3,28,31,11,22,64,890,172,167,1229,185.5,190.6,2789.77966101695,1409.35714285714,58,71,129,96.7213114754098
"./Ship3_Latin-square/2019-09-05_14h00m_Subject 47786.txt","47786",2019-09-05,"14:00",4,74,51,8,15,23,102,21,48,171,87,10,124,221,378,51,204,633,1073.35294117647,361.294117647059,2749,2084.52,38,65,103,98.0769230769231
"./Ship3_Latin-square/2019-09-05_14h00m_Subject 47788.txt","47788",2019-09-05,"14:00",24,87,60,16,11,27,97,12,33,142,95,33,16,144,257,3,71,331,492.533333333333,259.066666666667,2023.67796610169,1411.36842105263,51,47,98,96.7213114754098
"./Ship3_Latin-square/2019-09-05_14h03m_Subject 46888.txt","46888",2019-09-05,"14:03",0,83,60,2,21,23,27,1,5,33,87,9,54,150,1076,36,388,1500,156.816666666667,265.083333333333,2999.93220338983,1126.01694915254,16,84,100,100
"./Ship3_Latin-square/2019-09-05_14h03m_Subject 46889.txt","46889",2019-09-05,"14:03",24,80,60,13,7,20,99,16,14,129,35,10,4,49,408,10,62,480,797.64406779661,195.949152542373,2064.33898305085,1529.07843137255,99,80,179,88.3333333333333
"./Ship3_Latin-square/2019-09-05_14h03m_Subject 46892.txt","46892",2019-09-05,"14:03",24,86,60,16,10,26,50,31,12,93,38,29,6,73,468,21,112,601,224.433333333333,247.583333333333,2023.69491525424,1210.29411764706,51,54,105,91.8032786885246
"./Ship3_Latin-square/2019-09-05_14h03m_Subject 46898.txt","46898",2019-09-05,"14:03",8,83,60,4,19,23,36,2,15,53,32,5,29,66,412,24,148,584,387.65,268.216666666667,2403.35593220339,1804.05555555556,36,122,158,98.3606557377049
"./Ship3_Latin-square/2019-09-05_14h03m_Subject 47097.txt","47097",2019-09-05,"14:03",4,81,60,10,11,21,16,3,1,20,72,13,16,101,761,107,173,1041,158.333333333333,208.6,2789.76271186441,1421.45762711864,49,76,125,100
"./Ship3_Latin-square/2019-09-05_14h03m_Subject 47099.txt","47099",2019-09-05,"14:03",24,79,60,13,6,19,111,7,20,138,55,34,8,97,412,1,65,478,462.483333333333,324.7,2064.32203389831,1031.83636363636,57,41,98,95.0819672131148
"./Ship3_Latin-square/2019-09-05_14h03m_Subject 47798.txt","47798",2019-09-05,"14:03",16,73,53,14,6,20,25,11,3,39,21,18,4,43,192,25,24,241,1429.45283018868,589.867924528302,2446.13461538462,1393.47619047619,70,35,105,85.1851851851852
"./Ship3_Latin-square/2019-09-05_15h10m_Subject 47080.txt","47080",2019-09-05,"15:10",8,80,60,10,10,20,37,3,2,42,17,1,7,25,482,66,92,640,333.55,152.1,2566.03389830508,1515.91111111111,65,137,202,83.6065573770492
"./Ship3_Latin-square/2019-09-05_15h10m_Subject 47089.txt","47089",2019-09-05,"15:10",0,85,60,12,13,25,61,3,9,73,101,50,32,183,407,49,108,564,574.483333333333,266.866666666667,2999.91525423729,1921.44444444444,66,132,198,95.0819672131148
"./Ship3_Latin-square/2019-09-05_15h10m_Subject 47762.txt","47762",2019-09-05,"15:10",0,81,60,7,14,21,44,5,14,63,40,5,19,64,325,44,90,459,853,237.55,2999.94915254237,2330.76,67,125,192,93.4426229508197
"./Ship3_Latin-square/2019-09-05_15h10m_Subject 47791.txt","47791",2019-09-05,"15:10",2,78,60,9,9,18,30,4,12,46,54,12,19,85,714,90,123,927,662.166666666667,254.783333333333,2901.64406779661,1359.9298245614,43,64,107,96.7213114754098
"./Ship3_Latin-square/2019-09-06_10h00m_Subject 46878.txt","46878",2019-09-06,"10:00",0,84,60,10,14,24,83,1,1,85,66,24,45,135,832,172,179,1183,395.716666666667,264.116666666667,2999.8813559322,1591.83050847458,57,81,138,100
"./Ship3_Latin-square/2019-09-06_10h00m_Subject 46885.txt","46885",2019-09-06,"10:00",2,80,58,10,12,22,86,23,17,126,22,21,36,79,295,43,78,416,1049.68421052632,196.298245614035,2901.70175438596,2640.83928571429,78,77,155,98.2758620689655
"./Ship3_Latin-square/2019-09-06_10h00m_Subject 46899.txt","46899",2019-09-06,"10:00",24,84,60,14,10,24,130,14,39,183,64,8,8,80,342,2,96,440,815.283333333333,250.433333333333,1901.67796610169,1089.20338983051,40,45,85,100
"./Ship3_Latin-square/2019-09-06_10h00m_Subject 47081.txt","47081",2019-09-06,"10:00",8,77,60,6,11,17,53,2,8,63,55,14,22,91,316,35,73,424,443.65,289.5,2552.42372881356,1663.68421052632,45,67,112,98.3606557377049
"./Ship3_Latin-square/2019-09-06_10h00m_Subject 47091.txt","47091",2019-09-06,"10:00",24,68,52,9,7,16,134,11,25,170,88,17,77,182,181,4,26,211,1249.59615384615,409.942307692308,1892.17307692308,1840.12244897959,59,110,169,94.3396226415094
"./Ship3_Latin-square/2019-09-06_10h00m_Subject 47231.txt","47231",2019-09-06,"10:00",24,59,44,11,4,15,81,8,10,99,32,30,7,69,103,4,9,116,2387.61363636364,335.931818181818,2127.15909090909,2918.18181818182,71,59,130,75.5555555555556
"./Ship3_Latin-square/2019-09-06_10h00m_Subject 47238.txt","47238",2019-09-06,"10:00",0,78,60,3,15,18,49,0,2,51,75,10,34,119,373,16,105,494,296.316666666667,370.75,2999.86440677966,1830.67272727273,28,91,119,93.4426229508197
"./Ship3_Latin-square/2019-09-06_10h00m_Subject 47242.txt","47242",2019-09-06,"10:00",0,84,60,10,14,24,48,4,2,54,65,12,26,103,827,147,175,1149,264.916666666667,252.083333333333,2999.93220338983,1157.08474576271,65,54,119,100
"./Ship3_Latin-square/2019-09-06_10h00m_Subject 47244.txt","47244",2019-09-06,"10:00",2,81,60,9,12,21,61,7,7,75,122,24,18,164,638,99,131,868,453.633333333333,482.1,2891.45762711864,1589.74576271186,66,144,210,100
"./Ship3_Latin-square/2019-09-06_10h00m_Subject 47633.txt","47633",2019-09-06,"10:00",0,78,60,10,8,18,40,5,4,49,92,17,33,142,456,90,79,625,315.433333333333,256.616666666667,2999.86440677966,1691.54237288136,52,64,116,100
"./Ship3_Latin-square/2019-09-06_10h00m_Subject 47636.txt","47636",2019-09-06,"10:00",16,75,55,13,7,20,132,18,12,162,72,23,11,106,287,33,43,363,1499.67272727273,221.727272727273,2359.89090909091,2447.49056603774,134,70,204,98.2142857142857
"./Ship3_Latin-square/2019-09-06_10h00m_Subject 47752.txt","47752",2019-09-06,"10:00",24,84,60,15,9,24,91,19,14,124,57,29,1,87,354,22,141,517,557.25,278.65,2023.64406779661,1187.47619047619,55,97,152,80.327868852459
"./Ship3_Latin-square/2019-09-06_10h00m_Subject 47767.txt","47767",2019-09-06,"10:00",0,82,60,9,13,22,79,6,10,95,19,13,8,40,231,32,50,313,686.683333333333,206.783333333333,2999.89830508475,2749.88888888889,88,116,204,73.7704918032787
"./Ship3_Latin-square/2019-09-06_10h00m_Subject 47768.txt","47768",2019-09-06,"10:00",16,70,54,10,6,16,119,17,21,157,96,16,8,120,204,22,42,268,1521.28301886792,494.735849056604,2305.60377358491,2396.06,80,92,172,96.2962962962963
"./Ship3_Latin-square/2019-09-06_10h00m_Subject 47780.txt","47780",2019-09-06,"10:00",2,77,57,8,12,20,102,9,9,120,79,29,21,129,325,32,84,441,916.964912280702,549.929824561404,2882.08928571429,2217.97872340426,44,130,174,87.9310344827586
"./Ship3_Latin-square/2019-09-06_10h05m_Subject 46884.txt","46884",2019-09-06,"10:05",4,81,60,11,10,21,38,6,53,97,75,24,5,104,277,67,53,397,470.966666666667,541.8,2810.16949152542,2982.23255813953,71,218,289,80.327868852459
"./Ship3_Latin-square/2019-09-06_10h05m_Subject 47083.txt","47083",2019-09-06,"10:05",2,55,39,9,7,16,116,18,30,164,76,41,26,143,193,33,42,268,2847.69230769231,594.487179487179,2907.69230769231,3301.68571428571,85,93,178,90
"./Ship3_Latin-square/2019-09-06_10h05m_Subject 47086.txt","47086",2019-09-06,"10:05",8,82,60,7,15,22,72,10,10,92,116,36,41,193,399,36,143,578,509.45,398.666666666667,2511.86440677966,1469.22033898305,38,91,129,100
"./Ship3_Latin-square/2019-09-06_10h05m_Subject 47246.txt","47246",2019-09-06,"10:05",4,80,60,8,12,20,90,9,7,106,71,18,12,101,398,54,76,528,779.166666666667,369.233333333333,2762.66101694915,2089.43103448276,65,129,194,98.3606557377049
"./Ship3_Latin-square/2019-09-06_10h05m_Subject 47635.txt","47635",2019-09-06,"10:05",0,79,60,7,12,19,62,2,9,73,66,11,14,91,509,53,100,662,504.583333333333,260.25,2999.84745762712,2153.01785714286,96,95,191,93.4426229508197
"./Ship3_Latin-square/2019-09-06_10h05m_Subject 47779.txt","47779",2019-09-06,"10:05",0,81,60,11,10,21,39,5,12,56,55,11,3,69,276,55,62,393,691.883333333333,201.816666666667,2999.81355932203,2639.26530612245,73,92,165,90.1639344262295
"./Ship3_Latin-square/2019-09-06_10h05m_Subject 47797.txt","47797",2019-09-06,"10:05",2,31,22,1,8,9,40,1,9,50,22,0,2,24,69,8,18,95,9644.27272727273,535.909090909091,2838.04761904762,2445.38888888889,3,45,48,91.304347826087
"./Ship3_Latin-square/2019-09-06_11h36m_Subject 46900.txt","46900",2019-09-06,"11:36",4,81,60,12,9,21,22,3,7,32,75,28,20,123,628,127,129,884,186.05,279.766666666667,2803.35593220339,1529.36206896552,50,97,147,100
"./Ship3_Latin-square/2019-09-06_11h36m_Subject 46986.txt","46986",2019-09-06,"11:36",4,37,26,11,0,11,156,22,0,178,24,138,0,162,120,35,0,155,4707.44,377.32,2967.92,2999.16666666667,74,5,79,96.1538461538462
"./Ship3_Latin-square/2019-09-06_11h36m_Subject 47076.txt","47076",2019-09-06,"11:36",0,80,58,9,13,22,31,4,5,40,23,9,33,65,531,72,155,758,958.775862068965,201.034482758621,2999.89655172414,2725.88888888889,76,105,181,94.9152542372881
"./Ship3_Latin-square/2019-09-06_11h36m_Subject 47079.txt","47079",2019-09-06,"11:36",2,78,60,10,8,18,36,9,5,50,70,12,9,91,318,52,51,421,564.483333333333,307.4,2905.01694915254,1877.21052631579,78,61,139,96.7213114754098
"./Ship3_Latin-square/2019-09-06_11h36m_Subject 47082.txt","47082",2019-09-06,"11:36",0,81,60,8,13,21,102,9,3,114,74,5,80,159,409,57,88,554,407.533333333333,306.233333333333,2999.91525423729,1544.61403508772,61,97,158,98.3606557377049
"./Ship3_Latin-square/2019-09-06_11h36m_Subject 47092.txt","47092",2019-09-06,"11:36",2,78,60,8,10,18,28,3,4,35,90,19,27,136,651,88,120,859,154.366666666667,306.65,2891.47457627119,1666.94915254237,82,68,150,100
"./Ship3_Latin-square/2019-09-06_11h36m_Subject 47226.txt","47226",2019-09-06,"11:36",0,78,60,6,12,18,30,7,18,55,55,11,18,84,708,69,132,909,225.7,263.083333333333,2999.93220338983,1588.75438596491,26,95,121,98.3606557377049
"./Ship3_Latin-square/2019-09-06_11h36m_Subject 47227.txt","47227",2019-09-06,"11:36",0,81,60,8,13,21,49,4,5,58,14,12,13,39,511,53,102,666,281.766666666667,130.4,2999.98305084746,1762.57692307692,63,85,148,90.1639344262295
"./Ship3_Latin-square/2019-09-06_11h36m_Subject 47250.txt","47250",2019-09-06,"11:36",8,79,60,10,9,19,23,2,3,28,9,9,1,19,656,47,122,825,248.35,118.866666666667,2606.67796610169,1332.36842105263,25,50,75,96.7213114754098
"./Ship3_Latin-square/2019-09-06_11h36m_Subject 47645.txt","47645",2019-09-06,"11:36",4,36,24,12,0,12,106,80,0,186,15,32,0,47,103,51,0,154,5453.70833333333,232.625,2999.95833333333,4977.27272727273,79,0,79,92
"./Ship3_Latin-square/2019-09-06_11h36m_Subject 47646.txt","47646",2019-09-06,"11:36",0,81,60,8,13,21,44,2,13,59,68,11,9,88,1031,145,256,1432,203.333333333333,197.733333333333,2999.91525423729,1513.12280701754,66,67,133,98.3606557377049
"./Ship3_Latin-square/2019-09-06_11h36m_Subject 47755.txt","47755",2019-09-06,"11:36",24,64,47,9,8,17,210,12,40,262,76,19,29,124,191,5,64,260,1642.21739130435,782.195652173913,1799.97826086957,2282.35,45,166,211,89.3617021276596
"./Ship3_Latin-square/2019-09-06_11h36m_Subject 47760.txt","47760",2019-09-06,"11:36",2,82,60,9,13,22,70,5,16,91,72,14,30,116,657,127,183,967,354.483333333333,251.466666666667,2894.84745762712,1225.84745762712,25,34,59,100
"./Ship3_Latin-square/2019-09-06_11h36m_Subject 47770.txt","47770",2019-09-06,"11:36",0,61,49,6,6,12,97,2,6,105,67,13,10,90,217,44,20,281,2508.30612244898,409.770833333333,2999.95833333333,4096.46153846154,70,140,210,83.6734693877551
"./Ship3_Latin-square/2019-09-06_11h36m_Subject 47795.txt","47795",2019-09-06,"11:36",0,86,60,4,22,26,25,3,9,37,18,3,18,39,306,16,139,461,362.216666666667,237.283333333333,2999.93220338983,2344.3137254902,14,67,81,93.4426229508197
"./Ship3_Latin-square/2019-09-06_11h40m_Subject 47229.txt","47229",2019-09-06,"11:40",8,79,60,10,9,19,11,2,4,17,43,11,12,66,808,135,113,1056,96.6,162.816666666667,2606.72881355932,1071.49152542373,44,47,91,100
"./Ship3_Latin-square/2019-09-06_11h40m_Subject 47233.txt","47233",2019-09-06,"11:40",4,84,60,10,14,24,22,4,4,30,67,6,24,97,489,70,130,689,131.2,306.233333333333,2776.23728813559,1374.86440677966,74,38,112,100
"./Ship3_Latin-square/2019-09-06_11h40m_Subject 47234.txt","47234",2019-09-06,"11:40",8,79,60,12,7,19,108,25,9,142,96,26,7,129,404,79,60,543,789.516666666667,574.833333333333,2660.96610169492,2102.26785714286,65,93,158,95.0819672131148
"./Ship3_Latin-square/2019-09-06_11h40m_Subject 47241.txt","47241",2019-09-06,"11:40",2,87,60,0,27,27,22,0,10,32,13,0,10,23,835,0,241,1076,182.65,175.033333333333,2806.77966101695,1313.59649122807,14,136,150,98.3606557377049
"./Ship3_Latin-square/2019-09-06_11h40m_Subject 47247.txt","47247",2019-09-06,"11:40",2,80,60,8,12,20,34,4,9,47,45,13,5,63,435,49,100,584,313.916666666667,242.183333333333,2884.72881355932,1964.93220338983,35,97,132,100
"./Ship3_Latin-square/2019-09-06_11h40m_Subject 47777.txt","47777",2019-09-06,"11:40",0,83,59,3,21,24,44,2,12,58,19,0,25,44,523,28,181,732,495.189655172414,325.344827586207,2999.94827586207,2120.68965517241,41,76,117,100
"./Ship3_Latin-square/2019-09-06_11h40m_Subject 47784.txt","47784",2019-09-06,"11:40",2,75,60,3,12,15,38,0,9,47,45,0,33,78,1016,35,202,1253,211.183333333333,170.666666666667,2871.15254237288,1341.57627118644,40,87,127,100
"./Ship3_Latin-square/2019-09-06_12h52m_Subject 46880.txt","46880",2019-09-06,"12:52",4,84,60,12,12,24,18,5,3,26,60,22,8,90,396,98,88,582,271.083333333333,297.916666666667,2789.77966101695,2890.40476190476,134,160,294,77.0491803278689
"./Ship3_Latin-square/2019-09-06_12h52m_Subject 46882.txt","46882",2019-09-06,"12:52",0,83,60,9,14,23,31,1,2,34,135,36,22,193,955,139,250,1344,140.516666666667,316.3,2999.98305084746,1711.19642857143,92,104,196,98.3606557377049
"./Ship3_Latin-square/2019-09-06_12h52m_Subject 46883.txt","46883",2019-09-06,"12:52",0,64,44,8,12,20,80,29,7,116,76,71,73,220,237,45,59,341,1395.81818181818,493.181818181818,2999.93181818182,2958.33333333333,53,124,177,88.8888888888889
"./Ship3_Latin-square/2019-09-06_12h52m_Subject 46894.txt","46894",2019-09-06,"12:52",24,66,48,9,9,18,99,11,23,133,44,20,5,69,118,1,49,168,1942.77083333333,463.9375,1774.40425531915,2394.79487179487,64,55,119,83.6734693877551
"./Ship3_Latin-square/2019-09-06_12h52m_Subject 47088.txt","47088",2019-09-06,"12:52",16,67,49,13,5,18,109,22,11,142,112,31,74,217,230,45,40,315,896.958333333333,557.75,2366.64583333333,1476.26086956522,48,91,139,95.9183673469388
"./Ship3_Latin-square/2019-09-06_12h52m_Subject 47228.txt","47228",2019-09-06,"12:52",24,84,58,12,14,26,78,6,30,114,64,40,23,127,167,15,83,265,761.224137931035,325.210526315789,1736.78947368421,1663.66666666667,58,110,168,82.7586206896552
"./Ship3_Latin-square/2019-09-06_12h52m_Subject 47243.txt","47243",2019-09-06,"12:52",24,68,51,12,5,17,211,11,29,251,88,18,4,110,311,6,36,353,1762,483.56,2039.92,1571.57142857143,124,62,186,98.0392156862745
"./Ship3_Latin-square/2019-09-06_12h52m_Subject 47249.txt","47249",2019-09-06,"12:52",16,76,56,15,5,20,66,22,8,96,113,43,19,175,220,49,28,297,1029.96363636364,423.781818181818,2476.16363636364,2088.4375,90,80,170,89.2857142857143
"./Ship3_Latin-square/2019-09-06_12h52m_Subject 47639.txt","47639",2019-09-06,"12:52",24,84,60,16,8,24,64,21,13,98,44,25,6,75,401,5,86,492,404.733333333333,258.683333333333,2105.05084745763,1970.23529411765,128,49,177,90.1639344262295
"./Ship3_Latin-square/2019-09-06_12h52m_Subject 47649.txt","47649",2019-09-06,"12:52",24,84,60,16,8,24,89,7,11,107,61,5,15,81,297,0,54,351,695.266666666667,375.733333333333,2064.32203389831,1658.74358974359,147,80,227,75.4098360655738
"./Ship3_Latin-square/2019-09-06_12h52m_Subject 47758.txt","47758",2019-09-06,"12:52",16,80,60,11,9,20,49,4,9,62,68,63,9,140,303,31,74,408,559.216666666667,385.05,2240.61016949153,1950.02040816327,69,99,168,86.8852459016393
"./Ship3_Latin-square/2019-09-06_12h52m_Subject 47759.txt","47759",2019-09-06,"12:52",16,81,58,11,12,23,154,24,12,190,93,23,175,291,310,25,96,431,825.362068965517,294.293103448276,2129.80701754386,1571.78431372549,62,104,166,89.6551724137931
"./Ship3_Latin-square/2019-09-06_12h52m_Subject 47776.txt","47776",2019-09-06,"12:52",24,77,60,11,6,17,71,5,11,87,64,29,6,99,585,1,91,677,324.833333333333,206.383333333333,2023.67796610169,1021.53571428571,43,25,68,96.7213114754098
"./Ship3_Latin-square/2019-09-06_12h52m_Subject 47799.txt","47799",2019-09-06,"12:52",16,78,60,10,8,18,82,13,4,99,116,50,9,175,315,40,58,413,414.95,412.95,2240.59322033898,1594.92727272727,40,71,111,95.0819672131148
"./Ship3_Latin-square/2019-09-06_12h55m_Subject 46881.txt","46881",2019-09-06,"12:55",0,78,60,6,12,18,29,1,1,31,16,1,6,23,577,60,141,778,248.083333333333,148.65,2999.84745762712,1697.87272727273,56,85,141,96.7213114754098
"./Ship3_Latin-square/2019-09-06_12h55m_Subject 47087.txt","47087",2019-09-06,"12:55",0,80,60,7,13,20,44,6,7,57,63,4,30,97,499,55,95,649,281.6,223.983333333333,2999.83050847458,1382.5593220339,31,71,102,100
"./Ship3_Latin-square/2019-09-06_12h55m_Subject 47626.txt","47626",2019-09-06,"12:55",4,77,60,9,8,17,29,4,1,34,109,33,8,150,315,37,41,393,326.9,344.45,2810.1186440678,2281.2,108,82,190,95.0819672131148
"./Ship3_Latin-square/2019-09-06_12h55m_Subject 47634.txt","47634",2019-09-06,"12:55",0,82,60,12,10,22,87,13,16,116,49,9,24,82,364,71,76,511,784.783333333333,388.9,2999.96610169492,1897.61818181818,96,62,158,96.7213114754098
"./Ship3_Latin-square/2019-09-06_12h55m_Subject 47640.txt","47640",2019-09-06,"12:55",0,79,60,9,10,19,34,7,4,45,26,11,8,45,665,69,158,892,205.733333333333,277.566666666667,2999.86440677966,1683.64583333333,44,167,211,88.5245901639344
"./Ship3_Latin-square/2019-09-06_12h55m_Subject 47754.txt","47754",2019-09-06,"12:55",24,46,32,8,6,14,74,12,10,96,38,12,34,84,94,0,18,112,3620.34375,500.59375,2100,2859.96296296296,39,50,89,87.8787878787879
"./Ship3_Latin-square/2019-09-06_12h55m_Subject 47800.txt","47800",2019-09-06,"12:55",8,78,60,11,7,18,56,14,6,76,78,20,9,107,453,73,68,594,480.3,246.633333333333,2620.28813559322,1256.20338983051,40,47,87,100
"./Ship3_Latin-square/2019-09-06_14h05m_Subject 46876.txt","46876",2019-09-06,"14:05",4,78,60,8,10,18,45,4,5,54,17,8,20,45,324,48,69,441,393.766666666667,173.833333333333,2796.59322033898,1880.8,76,123,199,93.4426229508197
"./Ship3_Latin-square/2019-09-06_14h05m_Subject 46877.txt","46877",2019-09-06,"14:05",16,86,60,13,13,26,42,2,18,62,80,16,25,121,713,91,267,1071,167.65,266.733333333333,2213.49152542373,1097.56862745098,36,203,239,86.8852459016393
"./Ship3_Latin-square/2019-09-06_14h05m_Subject 46893.txt","46893",2019-09-06,"14:05",24,83,60,11,12,23,69,4,15,88,52,18,18,88,443,10,178,631,277.133333333333,195.55,1738.89830508475,1131,47,43,90,100
"./Ship3_Latin-square/2019-09-06_14h05m_Subject 46895.txt","46895",2019-09-06,"14:05",24,34,24,10,0,10,47,14,0,61,51,137,0,188,72,3,0,75,1682.83333333333,781.5,2699.83333333333,1376.95454545455,27,12,39,96
"./Ship3_Latin-square/2019-09-06_14h05m_Subject 47638.txt","47638",2019-09-06,"14:05",24,79,60,10,9,19,86,30,17,133,66,13,29,108,224,4,43,271,637.333333333333,297.1,1820.25423728814,1019.03389830508,46,41,87,98.3606557377049
"./Ship3_Latin-square/2019-09-06_14h05m_Subject 47757.txt","47757",2019-09-06,"14:05",16,74,52,13,9,22,96,25,10,131,42,30,11,83,326,68,72,466,1608.36538461538,208.538461538462,2323.03846153846,1324.61224489796,72,131,203,94.3396226415094
"./Ship3_Latin-square/2019-09-06_14h05m_Subject 47769.txt","47769",2019-09-06,"14:05",24,85,60,16,9,25,86,14,13,113,46,39,32,117,398,26,55,479,588.233333333333,172.15,2064.35593220339,1155.0701754386,77,47,124,96.7213114754098
"./Ship3_Latin-square/2019-09-06_14h05m_Subject 47771.txt","47771",2019-09-06,"14:05",8,80,60,10,10,20,15,2,3,20,35,23,8,66,797,76,150,1023,118.55,212.783333333333,2606.71186440678,1417.85185185185,28,135,163,95.0819672131148
"./Ship3_Latin-square/2019-09-06_14h05m_Subject 47775.txt","47775",2019-09-06,"14:05",8,84,60,9,15,24,104,7,26,137,20,7,20,47,311,44,94,449,612.15,135.633333333333,2538.94915254237,1615.96610169492,46,46,92,100
"./Ship3_Latin-square/2019-09-06_14h05m_Subject 47781.txt","47781",2019-09-06,"14:05",0,81,60,7,14,21,17,2,0,19,52,8,17,77,1193,143,239,1575,128.983333333333,219.716666666667,2999.84745762712,1528.22033898305,108,49,157,100
"./Ship3_Latin-square/2019-09-06_14h05m_Subject 47782.txt","47782",2019-09-06,"14:05",16,80,60,12,8,20,33,8,9,50,12,8,5,25,535,50,83,668,241.15,108.633333333333,2321.98305084746,1069.92857142857,28,51,79,95.0819672131148
"./Ship3_Latin-square/2019-09-06_14h05m_Subject 47783.txt","47783",2019-09-06,"14:05",0,81,60,9,12,21,33,5,5,43,48,12,14,74,709,105,202,1016,267.1,220.683333333333,2999.89830508475,1356.28813559322,37,48,85,100
"./Ship3_Latin-square/2019-09-06_14h05m_Subject 47785.txt","47785",2019-09-06,"14:05",0,80,60,8,12,20,37,0,4,41,35,7,18,60,840,145,113,1098,342.383333333333,199.283333333333,2999.86440677966,1918.85714285714,105,99,204,95.0819672131148
"./Ship3_Latin-square/2019-09-06_14h05m_Subject 47786.txt","47786",2019-09-06,"14:05",8,81,60,9,12,21,47,9,9,65,36,34,23,93,499,31,170,700,357.983333333333,205.6,2552.47457627119,1807.85454545455,56,114,170,95.0819672131148
"./Ship3_Latin-square/2019-09-06_14h05m_Subject 47788.txt","47788",2019-09-06,"14:05",16,79,60,11,8,19,49,18,7,74,77,25,10,112,401,46,82,529,288.833333333333,200.283333333333,2294.84745762712,1391.16949152542,57,42,99,100
"./Ship3_Latin-square/2019-09-06_14h10m_Subject 46888.txt","46888",2019-09-06,"14:10",8,79,60,8,11,19,25,0,1,26,49,13,15,77,895,75,211,1181,108.683333333333,215.833333333333,2566.10169491525,1107.1186440678,42,66,108,100
"./Ship3_Latin-square/2019-09-06_14h10m_Subject 46889.txt","46889",2019-09-06,"14:10",2,78,60,5,13,18,17,0,7,24,27,3,35,65,908,64,201,1173,163.15,197.5,2881.33898305085,1418.25423728814,100,85,185,100
"./Ship3_Latin-square/2019-09-06_14h10m_Subject 46892.txt","46892",2019-09-06,"14:10",16,85,60,13,12,25,37,53,10,100,27,9,5,41,555,69,139,763,251.8,265.766666666667,2240.57627118644,1405.4406779661,53,69,122,100
"./Ship3_Latin-square/2019-09-06_14h10m_Subject 46898.txt","46898",2019-09-06,"14:10",2,80,60,7,13,20,35,1,3,39,36,10,5,51,545,51,100,696,253.283333333333,333.866666666667,2884.72881355932,2065.68965517241,62,131,193,100
"./Ship3_Latin-square/2019-09-06_14h10m_Subject 47097.txt","47097",2019-09-06,"14:10",0,82,60,9,13,22,42,3,2,47,108,17,43,168,851,114,206,1171,206.833333333333,324.816666666667,2999.84745762712,1373.15254237288,60,109,169,100
"./Ship3_Latin-square/2019-09-06_14h10m_Subject 47099.txt","47099",2019-09-06,"14:10",16,79,60,10,9,19,60,1,6,67,56,29,16,101,434,24,80,538,314.633333333333,304.766666666667,2240.66101694915,1354.33898305085,66,58,124,100
"./Ship3_Latin-square/2019-09-06_14h10m_Subject 47798.txt","47798",2019-09-06,"14:10",0,86,60,0,26,26,21,0,7,28,24,0,7,31,288,0,129,417,280.2,201.1,2999.84745762712,2449.89285714286,7,241,248,77.0491803278689
"./Ship3_Latin-square/2019-09-06_15h20m_Subject 47080.txt","47080",2019-09-06,"15:20",24,82,60,9,13,22,93,9,30,132,17,2,7,26,257,2,120,379,507.466666666667,138.033333333333,1698.27118644068,1235.91428571429,34,118,152,72.1311475409836
"./Ship3_Latin-square/2019-09-06_15h20m_Subject 47089.txt","47089",2019-09-06,"15:20",8,83,60,12,11,23,30,5,2,37,61,14,19,94,336,45,88,469,314.9,198.883333333333,2620.32203389831,1589.71428571429,89,47,136,95.0819672131148
"./Ship3_Latin-square/2019-09-06_15h20m_Subject 47762.txt","47762",2019-09-06,"15:20",24,53,38,9,6,15,103,6,25,134,24,9,1,34,98,7,12,117,2986.65789473684,471.289473684211,2027.02702702703,3670.06451612903,54,66,120,84.6153846153846
"./Ship3_Latin-square/2019-09-06_15h20m_Subject 47791.txt","47791",2019-09-06,"15:20",4,80,60,8,12,20,23,3,3,29,30,5,7,42,819,113,173,1105,179.066666666667,188.216666666667,2762.64406779661,1445.54237288136,25,64,89,100
"./Ship3_Latin-square/2019-09-07_09h46m_Subject 46884.txt","46884",2019-09-07,"09:46",0,77,56,10,11,21,38,6,5,49,35,8,17,60,250,73,42,365,805.660714285714,431.375,2999.875,2809.67741935484,89,145,234,71.9298245614035
"./Ship3_Latin-square/2019-09-07_09h46m_Subject 47083.txt","47083",2019-09-07,"09:46",4,73,55,8,10,18,69,13,1,83,64,21,23,108,261,38,67,366,1160.24074074074,476.037037037037,2785.11111111111,2696.31818181818,110,88,198,85.4545454545455
"./Ship3_Latin-square/2019-09-07_09h46m_Subject 47086.txt","47086",2019-09-07,"09:46",2,83,60,10,13,23,41,3,7,51,82,7,20,109,399,78,65,542,429.45,353.75,2894.8813559322,1774.56,93,72,165,90.1639344262295
"./Ship3_Latin-square/2019-09-07_09h46m_Subject 47246.txt","47246",2019-09-07,"09:46",0,82,60,4,18,22,48,2,5,55,26,12,9,47,322,26,118,466,528.6,197.55,2999.8813559322,2130.81132075472,39,121,160,91.8032786885246
"./Ship3_Latin-square/2019-09-07_09h46m_Subject 47635.txt","47635",2019-09-07,"09:46",24,81,60,10,11,21,75,7,20,102,84,13,15,112,220,6,78,304,415.266666666667,317.266666666667,1698.27118644068,1421.49152542373,77,45,122,100
"./Ship3_Latin-square/2019-09-07_09h46m_Subject 47779.txt","47779",2019-09-07,"09:46",24,54,38,11,5,16,39,4,8,51,18,6,1,25,64,7,14,85,2652.44736842105,153.394736842105,2242.02631578947,5022.19047619048,78,31,109,61.5384615384615
"./Ship3_Latin-square/2019-09-07_09h46m_Subject 47797.txt","47797",2019-09-07,"09:46",16,27,20,5,2,7,50,4,2,56,22,3,1,26,44,13,12,69,8748.73684210526,590.421052631579,2494.68421052632,4901,15,16,31,90
"./Ship3_Latin-square/2019-09-07_09h58m_Subject 46878.txt","46878",2019-09-07,"09:58",24,83,60,13,10,23,59,7,7,73,59,8,9,76,408,10,99,517,330.766666666667,237.25,1983.01694915254,1212.92156862745,65,51,116,86.8852459016393
"./Ship3_Latin-square/2019-09-07_09h58m_Subject 46885.txt","46885",2019-09-07,"09:58",4,76,60,7,9,16,67,8,8,83,16,2,0,18,311,32,43,386,513.333333333333,135.633333333333,2783.05084745763,1991.49122807018,48,74,122,96.7213114754098
"./Ship3_Latin-square/2019-09-07_09h58m_Subject 46899.txt","46899",2019-09-07,"09:58",2,79,60,8,11,19,33,5,8,46,52,7,8,67,570,84,107,761,286.283333333333,231.3,2898.30508474576,1366.89830508475,49,50,99,100
"./Ship3_Latin-square/2019-09-07_09h58m_Subject 47081.txt","47081",2019-09-07,"09:58",2,80,60,11,9,20,12,5,3,20,60,37,36,133,420,59,75,554,107.65,334.35,2911.76271186441,1377.53448275862,43,54,97,98.3606557377049
"./Ship3_Latin-square/2019-09-07_09h58m_Subject 47091.txt","47091",2019-09-07,"09:58",2,78,59,6,13,19,84,5,7,96,82,13,22,117,315,34,61,410,1039.03389830508,314.847457627119,2882.75862068966,2291.98214285714,63,114,177,96.6666666666667
"./Ship3_Latin-square/2019-09-07_09h58m_Subject 47231.txt","47231",2019-09-07,"09:58",2,76,59,3,14,17,56,3,14,73,25,8,9,42,201,14,59,274,1270.93103448276,191.120689655172,2865.46551724138,2636.6170212766,61,60,121,86.4406779661017
"./Ship3_Latin-square/2019-09-07_09h58m_Subject 47238.txt","47238",2019-09-07,"09:58",8,82,60,7,15,22,16,2,3,21,61,8,33,102,290,36,85,411,195.4,277.783333333333,2498.28813559322,1655.2,52,80,132,93.4426229508197
"./Ship3_Latin-square/2019-09-07_09h58m_Subject 47242.txt","47242",2019-09-07,"09:58",8,67,47,13,7,20,61,15,19,95,98,83,67,248,334,46,48,428,829.36170212766,497.702127659574,2710.55319148936,1675.85106382979,74,39,113,100
"./Ship3_Latin-square/2019-09-07_09h58m_Subject 47244.txt","47244",2019-09-07,"09:58",4,83,60,11,12,23,68,2,17,87,100,30,78,208,598,95,98,791,581.966666666667,256.666666666667,2803.35593220339,1292.38983050847,39,55,94,100
"./Ship3_Latin-square/2019-09-07_09h58m_Subject 47633.txt","47633",2019-09-07,"09:58",24,73,54,11,8,19,121,7,32,160,89,20,19,128,199,2,32,233,1289.05555555556,462.37037037037,1867.77358490566,1564.92307692308,65,41,106,98.1818181818182
"./Ship3_Latin-square/2019-09-07_09h58m_Subject 47636.txt","47636",2019-09-07,"09:58",0,73,56,8,9,17,94,9,5,108,53,13,47,113,293,31,43,367,1592.6,183.054545454545,2999.92727272727,3979.08,106,119,225,91.0714285714286
"./Ship3_Latin-square/2019-09-07_09h58m_Subject 47752.txt","47752",2019-09-07,"09:58",2,80,60,9,11,20,66,5,5,76,40,19,10,69,742,112,148,1002,438.6,192.216666666667,2891.50847457627,1534.20338983051,44,108,152,100
"./Ship3_Latin-square/2019-09-07_09h58m_Subject 47767.txt","47767",2019-09-07,"09:58",8,81,60,9,12,21,33,1,4,38,19,1,12,32,247,35,69,351,388.966666666667,165.1,2552.47457627119,1686.09803921569,65,54,119,88.5245901639344
"./Ship3_Latin-square/2019-09-07_09h58m_Subject 47768.txt","47768",2019-09-07,"09:58",0,80,60,4,16,20,116,11,19,146,63,5,21,89,492,39,102,633,945.083333333333,256.7,2999.86440677966,2250.29411764706,80,112,192,90.1639344262295
"./Ship3_Latin-square/2019-09-07_09h58m_Subject 47780.txt","47780",2019-09-07,"09:58",16,78,60,10,8,18,87,8,14,109,57,15,6,78,239,20,46,305,1020.25,366.133333333333,2267.76271186441,2494.32,78,94,172,88.5245901639344
"./Ship3_Latin-square/2019-09-07_10h54m_Subject 47229.txt","47229",2019-09-07,"10:54",24,81,60,12,9,21,111,3,23,137,97,18,6,121,392,8,114,514,555.2,398.25,1942.35593220339,1132.51724137931,63,48,111,98.3606557377049
"./Ship3_Latin-square/2019-09-07_10h54m_Subject 47233.txt","47233",2019-09-07,"10:54",0,81,60,4,17,21,18,1,2,21,36,3,8,47,379,24,124,527,145.85,203.8,2999.8813559322,1771.81034482759,45,92,137,98.3606557377049
"./Ship3_Latin-square/2019-09-07_10h54m_Subject 47234.txt","47234",2019-09-07,"10:54",2,82,60,10,12,22,71,8,8,87,172,29,35,236,615,80,170,865,484.85,572.983333333333,2898.25423728814,1607.4406779661,56,78,134,100
"./Ship3_Latin-square/2019-09-07_10h54m_Subject 47241.txt","47241",2019-09-07,"10:54",16,84,60,10,14,24,21,5,4,30,13,5,3,21,696,31,246,973,125,168.1,2077.93220338983,1255.60377358491,47,53,100,91.8032786885246
"./Ship3_Latin-square/2019-09-07_10h54m_Subject 47247.txt","47247",2019-09-07,"10:54",4,78,60,8,10,18,14,2,6,22,21,5,4,30,388,49,76,513,191.033333333333,173.616666666667,2789.76271186441,2081.8,76,113,189,90.1639344262295
"./Ship3_Latin-square/2019-09-07_10h54m_Subject 47777.txt","47777",2019-09-07,"10:54",8,81,60,10,11,21,38,7,11,56,11,0,4,15,363,60,95,518,364.383333333333,221.383333333333,2593.16949152542,1905.71186440678,75,54,129,100
"./Ship3_Latin-square/2019-09-07_10h54m_Subject 47784.txt","47784",2019-09-07,"10:54",4,78,60,5,13,18,39,7,10,56,100,5,51,156,1077,76,263,1416,143.333333333333,359.433333333333,2749.1186440678,1237.20338983051,34,85,119,100
"./Ship3_Latin-square/2019-09-07_11h11m_Subject 46900.txt","46900",2019-09-07,"11:11",0,75,60,6,9,15,15,2,0,17,40,4,4,48,726,68,98,892,187.883333333333,244.383333333333,2999.84745762712,1781.48275862069,87,87,174,98.3606557377049
"./Ship3_Latin-square/2019-09-07_11h11m_Subject 46986.txt","46986",2019-09-07,"11:11",8,57,42,10,5,15,103,18,13,134,17,8,4,29,166,43,32,241,2600.7380952381,165.142857142857,2707.29268292683,3031.7,57,45,102,97.6744186046512
"./Ship3_Latin-square/2019-09-07_11h11m_Subject 47076.txt","47076",2019-09-07,"11:11",8,82,60,12,10,22,15,1,3,19,11,2,32,45,543,88,113,744,155.616666666667,138.033333333333,2620.27118644068,1722.78571428571,116,81,197,98.3606557377049
"./Ship3_Latin-square/2019-09-07_11h11m_Subject 47079.txt","47079",2019-09-07,"11:11",4,79,60,8,11,19,23,3,5,31,58,8,15,81,283,40,69,392,764.5,254.033333333333,2769.4406779661,2075.47058823529,97,60,157,90.1639344262295
"./Ship3_Latin-square/2019-09-07_11h11m_Subject 47082.txt","47082",2019-09-07,"11:11",8,80,60,8,12,20,36,6,9,51,25,9,5,39,340,48,68,456,657.516666666667,178.583333333333,2525.40677966102,2657.84,65,105,170,93.4426229508197
"./Ship3_Latin-square/2019-09-07_11h11m_Subject 47092.txt","47092",2019-09-07,"11:11",4,78,60,6,12,18,20,0,6,26,89,16,10,115,652,50,163,865,167.816666666667,275.016666666667,2776.25423728814,1871.01694915254,59,138,197,100
"./Ship3_Latin-square/2019-09-07_11h11m_Subject 47226.txt","47226",2019-09-07,"11:11",8,83,60,12,11,23,47,16,3,66,36,8,13,57,421,63,107,591,494.216666666667,194.516666666667,2606.71186440678,2287.35185185185,46,59,105,93.4426229508197
"./Ship3_Latin-square/2019-09-07_11h11m_Subject 47227.txt","47227",2019-09-07,"11:11",8,83,60,9,14,23,37,6,11,54,15,12,6,33,350,45,104,499,317.5,160.05,2566.06779661017,1636.35416666667,42,109,151,83.6065573770492
"./Ship3_Latin-square/2019-09-07_11h11m_Subject 47250.txt","47250",2019-09-07,"11:11",24,73,52,13,8,21,78,9,30,117,75,18,25,118,314,0,76,390,1153.59615384615,627.096153846154,1984.55769230769,1404.14,32,45,77,98.1132075471698
"./Ship3_Latin-square/2019-09-07_11h11m_Subject 47645.txt","47645",2019-09-07,"11:11",8,40,28,9,3,12,80,24,17,121,47,29,4,80,93,27,6,126,4797.10714285714,465.321428571429,2771.32142857143,5949.51851851852,71,39,110,100
"./Ship3_Latin-square/2019-09-07_11h11m_Subject 47646.txt","47646",2019-09-07,"11:11",8,80,60,7,13,20,19,0,2,21,36,6,5,47,784,79,277,1140,164.9,154.033333333333,2538.96610169492,1310.88,35,87,122,91.8032786885246
"./Ship3_Latin-square/2019-09-07_11h11m_Subject 47755.txt","47755",2019-09-07,"11:11",2,78,56,9,13,22,61,8,5,74,42,12,13,67,574,85,119,778,1188.78571428571,302.875,2879.94545454545,2059.2962962963,61,159,220,98.2456140350877
"./Ship3_Latin-square/2019-09-07_11h11m_Subject 47760.txt","47760",2019-09-07,"11:11",4,78,60,8,10,18,76,10,5,91,44,12,12,68,665,86,111,862,317.75,187.35,2796.57627118644,1213.83050847458,16,29,45,100
"./Ship3_Latin-square/2019-09-07_11h11m_Subject 47770.txt","47770",2019-09-07,"11:11",24,48,36,7,5,12,63,10,14,87,49,16,10,75,80,4,17,101,3678.58333333333,621.555555555556,1933.30555555556,3794.53333333333,51,66,117,83.7837837837838
"./Ship3_Latin-square/2019-09-07_11h11m_Subject 47795.txt","47795",2019-09-07,"11:11",8,78,60,7,11,18,70,2,10,82,28,8,3,39,249,16,52,317,480.566666666667,203.566666666667,2566.05084745763,2185.01754385965,42,36,78,96.7213114754098
"./Ship3_Latin-square/2019-09-07_12h01m_Subject 46881.txt","46881",2019-09-07,"12:01",8,80,60,10,10,20,30,5,7,42,23,2,8,33,383,49,85,517,371,135.116666666667,2606.67796610169,1657.89130434783,66,117,183,86.8852459016393
"./Ship3_Latin-square/2019-09-07_12h01m_Subject 47087.txt","47087",2019-09-07,"12:01",8,79,60,10,9,19,67,9,5,81,48,15,10,73,249,34,46,329,925.216666666667,162.716666666667,2593.13559322034,2223.23636363636,60,58,118,95.0819672131148
"./Ship3_Latin-square/2019-09-07_12h01m_Subject 47626.txt","47626",2019-09-07,"12:01",0,79,60,7,12,19,22,1,4,27,75,7,54,136,320,59,73,452,336.166666666667,209.883333333333,2999.93220338983,2679.16326530612,108,121,229,85.2459016393443
"./Ship3_Latin-square/2019-09-07_12h01m_Subject 47634.txt","47634",2019-09-07,"12:01",8,80,60,13,7,20,63,7,8,78,17,8,9,34,380,41,46,467,454.7,191.666666666667,2660.8813559322,1617.96363636364,112,53,165,96.7213114754098
"./Ship3_Latin-square/2019-09-07_12h01m_Subject 47640.txt","47640",2019-09-07,"12:01",8,76,60,9,7,16,17,1,0,18,13,7,3,23,653,47,131,831,141.016666666667,129,2633.86440677966,1380.77358490566,52,67,119,95.0819672131148
"./Ship3_Latin-square/2019-09-07_12h01m_Subject 47754.txt","47754",2019-09-07,"12:01",16,44,31,10,3,13,33,14,2,49,29,9,42,80,89,19,10,118,4452.8064516129,323.516129032258,2535.41935483871,6278.53571428571,38,72,110,90.625
"./Ship3_Latin-square/2019-09-07_12h01m_Subject 47800.txt","47800",2019-09-07,"12:01",24,80,60,5,15,20,69,7,21,97,83,7,23,113,198,4,123,325,486.733333333333,244.383333333333,1535.50847457627,1405.22413793103,54,41,95,98.3606557377049
"./Ship3_Latin-square/2019-09-07_12h35m_Subject 46880.txt","46880",2019-09-07,"12:35",0,80,60,8,12,20,18,1,0,19,34,3,9,46,632,102,136,870,203.65,185.35,2999.89830508475,1842.18367346939,58,208,266,86.8852459016393
"./Ship3_Latin-square/2019-09-07_12h35m_Subject 46882.txt","46882",2019-09-07,"12:35",8,81,60,12,9,21,17,1,0,18,44,14,6,64,696,114,144,954,171.7,184.05,2606.71186440678,1784.51020408163,204,35,239,90.1639344262295
"./Ship3_Latin-square/2019-09-07_12h35m_Subject 46883.txt","46883",2019-09-07,"12:35",24,79,60,15,4,19,99,15,6,120,65,9,3,77,304,1,19,324,795.216666666667,444.55,2186.38983050847,1670.39215686275,84,52,136,86.8852459016393
"./Ship3_Latin-square/2019-09-07_12h35m_Subject 46894.txt","46894",2019-09-07,"12:35",16,83,60,11,12,23,39,12,10,61,55,11,5,71,309,45,75,429,684.183333333333,324.716666666667,2159.30508474576,1250.67924528302,57,58,115,93.4426229508197
"./Ship3_Latin-square/2019-09-07_12h35m_Subject 47088.txt","47088",2019-09-07,"12:35",8,84,60,14,10,24,49,7,6,62,78,33,19,130,630,110,89,829,297.266666666667,267.116666666667,2647.37288135593,1302.53571428571,51,143,194,95.0819672131148
"./Ship3_Latin-square/2019-09-07_12h35m_Subject 47228.txt","47228",2019-09-07,"12:35",16,82,60,10,12,22,27,4,5,36,40,20,12,72,416,46,111,573,326.8,183.333333333333,2186.38983050847,1799.44444444444,39,167,206,85.2459016393443
"./Ship3_Latin-square/2019-09-07_12h35m_Subject 47243.txt","47243",2019-09-07,"12:35",16,80,57,13,10,23,141,11,49,201,36,10,11,57,456,63,86,605,1205.63157894737,230,2285.69642857143,1506.39622641509,135,73,208,94.7368421052632
"./Ship3_Latin-square/2019-09-07_12h35m_Subject 47249.txt","47249",2019-09-07,"12:35",8,71,52,10,9,19,85,12,7,104,88,27,16,131,216,34,42,292,1819.94230769231,348.038461538462,2623.49019607843,3431.55319148936,67,86,153,96.2264150943396
"./Ship3_Latin-square/2019-09-07_12h35m_Subject 47639.txt","47639",2019-09-07,"12:35",16,83,60,11,12,23,31,5,8,44,31,3,46,80,367,46,88,501,273.1,216.066666666667,2186.42372881356,1787,76,100,176,90.1639344262295
"./Ship3_Latin-square/2019-09-07_12h35m_Subject 47649.txt","47649",2019-09-07,"12:35",2,67,49,5,13,18,37,1,2,40,32,9,48,89,292,35,66,393,1737.71428571429,204.163265306122,2866.625,3209.16216216216,34,149,183,82
"./Ship3_Latin-square/2019-09-07_12h35m_Subject 47758.txt","47758",2019-09-07,"12:35",8,80,60,10,10,20,17,2,1,20,59,1,2,62,603,78,122,803,208.016666666667,298.583333333333,2593.18644067797,1287.89655172414,57,46,103,100
"./Ship3_Latin-square/2019-09-07_12h35m_Subject 47759.txt","47759",2019-09-07,"12:35",8,84,60,13,11,24,79,12,3,94,17,11,7,35,586,102,130,818,299.683333333333,130.966666666667,2647.45762711864,1315.50943396226,32,89,121,93.4426229508197
"./Ship3_Latin-square/2019-09-07_12h35m_Subject 47776.txt","47776",2019-09-07,"12:35",16,79,60,11,8,19,37,3,5,45,51,20,40,111,722,61,169,952,174.35,145.116666666667,2267.76271186441,991.473684210526,42,45,87,96.7213114754098
"./Ship3_Latin-square/2019-09-07_12h35m_Subject 47799.txt","47799",2019-09-07,"12:35",8,78,60,8,10,18,47,31,2,80,65,14,29,108,400,33,107,540,325.6,213.3,2593.15254237288,1588.48214285714,54,76,130,96.7213114754098
"./Ship3_Latin-square/2019-09-07_13h18m_Subject 46888.txt","46888",2019-09-07,"13:18",24,83,60,16,7,23,34,3,7,44,82,57,18,157,422,12,93,527,183.866666666667,249.583333333333,2023.69491525424,899.884615384615,54,52,106,88.5245901639344
"./Ship3_Latin-square/2019-09-07_13h18m_Subject 46889.txt","46889",2019-09-07,"13:18",4,77,60,6,11,17,16,0,1,17,18,2,18,38,809,51,127,987,177,137.466666666667,2762.67796610169,1423.18965517241,74,132,206,100
"./Ship3_Latin-square/2019-09-07_13h18m_Subject 46892.txt","46892",2019-09-07,"13:18",8,71,50,9,12,21,49,4,5,58,32,18,6,56,263,31,104,398,1632.48,365.72,2559.18367346939,2987.93939393939,105,123,228,78.4313725490196
"./Ship3_Latin-square/2019-09-07_13h18m_Subject 46898.txt","46898",2019-09-07,"13:18",16,85,60,13,12,25,27,6,7,40,19,9,8,36,309,49,74,432,212.1,122.116666666667,2213.50847457627,1940.34782608696,39,110,149,83.6065573770492
"./Ship3_Latin-square/2019-09-07_13h18m_Subject 47097.txt","47097",2019-09-07,"13:18",8,82,60,10,12,22,15,2,2,19,54,14,16,84,579,66,136,781,118.333333333333,147.1,2552.52542372881,1577.13559322034,95,94,189,100
"./Ship3_Latin-square/2019-09-07_13h18m_Subject 47099.txt","47099",2019-09-07,"13:18",8,80,60,8,12,20,38,3,11,52,18,0,3,21,163,16,58,237,1071.96666666667,185.716666666667,2552.49152542373,2806.62857142857,55,101,156,70.4918032786885
"./Ship3_Latin-square/2019-09-07_13h18m_Subject 47798.txt","47798",2019-09-07,"13:18",24,83,59,14,10,24,99,10,28,137,76,86,37,199,287,1,102,390,538.322033898305,429.372881355932,1965.46551724138,1330.62,63,83,146,88.135593220339
"./Ship3_Latin-square/2019-09-07_13h43m_Subject 46876.txt","46876",2019-09-07,"13:43",0,81,60,9,12,21,42,5,4,51,8,2,1,11,567,86,114,767,470.05,128.516666666667,2999.91525423729,1535.27272727273,44,106,150,93.4426229508197
"./Ship3_Latin-square/2019-09-07_13h43m_Subject 46877.txt","46877",2019-09-07,"13:43",0,78,60,9,9,18,15,0,4,19,169,14,37,220,1046,154,171,1371,176.75,339.883333333333,2999.94915254237,1320.18965517241,50,99,149,98.3606557377049
"./Ship3_Latin-square/2019-09-07_13h43m_Subject 46893.txt","46893",2019-09-07,"13:43",16,79,60,10,9,19,31,5,10,46,45,7,9,61,601,77,88,766,144.183333333333,179.433333333333,2240.66101694915,1335.16949152542,83,44,127,100
"./Ship3_Latin-square/2019-09-07_13h43m_Subject 46895.txt","46895",2019-09-07,"13:43",2,62,44,9,9,18,46,18,6,70,149,59,20,228,164,33,60,257,1647.11363636364,1184.27272727273,2899.93181818182,2389.44736842105,38,89,127,91.1111111111111
"./Ship3_Latin-square/2019-09-07_13h43m_Subject 47638.txt","47638",2019-09-07,"13:43",16,73,54,11,8,19,55,12,11,78,120,14,40,174,178,24,25,227,1151.05555555556,592.944444444444,2275.41509433962,1799.9387755102,65,28,93,90.7407407407407
"./Ship3_Latin-square/2019-09-07_13h43m_Subject 47757.txt","47757",2019-09-07,"13:43",8,68,49,10,9,19,105,29,16,150,20,8,29,57,267,68,49,384,2078.70833333333,187.5,2616.58333333333,2164.02222222222,66,133,199,93.8775510204082
"./Ship3_Latin-square/2019-09-07_13h43m_Subject 47769.txt","47769",2019-09-07,"13:43",16,82,60,14,8,22,80,13,14,107,38,24,24,86,372,50,42,464,821.016666666667,157.883333333333,2349.1186440678,1431.68965517241,67,68,135,98.3606557377049
"./Ship3_Latin-square/2019-09-07_13h43m_Subject 47771.txt","47771",2019-09-07,"13:43",24,82,60,11,11,22,51,7,9,67,28,4,4,36,332,6,101,439,308.25,150.616666666667,1738.91525423729,1221.21951219512,26,66,92,78.6885245901639
"./Ship3_Latin-square/2019-09-07_13h43m_Subject 47775.txt","47775",2019-09-07,"13:43",24,80,60,9,11,20,125,18,21,164,80,28,20,128,160,1,81,242,891.3,254.45,1738.98305084746,1520.72413793103,48,46,94,98.3606557377049
"./Ship3_Latin-square/2019-09-07_13h43m_Subject 47781.txt","47781",2019-09-07,"13:43",8,82,60,11,11,22,29,3,7,39,72,10,29,111,641,47,173,861,255.083333333333,293.35,2593.22033898305,1488.03703703704,39,70,109,93.4426229508197
"./Ship3_Latin-square/2019-09-07_13h43m_Subject 47782.txt","47782",2019-09-07,"13:43",8,80,60,10,10,20,35,4,5,44,7,0,1,8,568,57,110,735,230.266666666667,93.6333333333333,2579.64406779661,1549.47272727273,23,93,116,91.8032786885246
"./Ship3_Latin-square/2019-09-07_13h43m_Subject 47783.txt","47783",2019-09-07,"13:43",8,79,60,10,9,19,32,1,6,39,26,6,7,39,591,72,66,729,341.9,144.516666666667,2593.18644067797,1687.80357142857,49,82,131,96.7213114754098
"./Ship3_Latin-square/2019-09-07_13h43m_Subject 47785.txt","47785",2019-09-07,"13:43",8,84,60,11,13,24,23,0,4,27,37,10,10,57,774,157,187,1118,329.316666666667,905.783333333333,2579.64406779661,1601.57894736842,44,139,183,98.3606557377049
"./Ship3_Latin-square/2019-09-07_13h43m_Subject 47786.txt","47786",2019-09-07,"13:43",2,78,60,7,11,18,33,3,12,48,86,22,9,117,571,37,89,697,506.666666666667,305.45,2888.10169491525,1957.15517241379,58,83,141,98.3606557377049
"./Ship3_Latin-square/2019-09-07_13h43m_Subject 47788.txt","47788",2019-09-07,"13:43",8,83,60,13,10,23,40,9,1,50,87,29,25,141,528,110,135,773,268.283333333333,228.633333333333,2606.71186440678,1442.62711864407,33,43,76,100
"./Ship3_Latin-square/2019-09-07_14h23m_Subject 47080.txt","47080",2019-09-07,"14:23",16,83,60,11,12,23,36,1,6,43,9,5,5,19,363,43,97,503,297.816666666667,130.066666666667,2186.38983050847,1506.97916666667,54,98,152,90.1639344262295
"./Ship3_Latin-square/2019-09-07_14h23m_Subject 47089.txt","47089",2019-09-07,"14:23",24,57,39,17,1,18,54,17,3,74,33,63,1,97,148,9,0,157,2057.4358974359,198.333333333333,2753.76923076923,3677.29411764706,105,18,123,87.5
"./Ship3_Latin-square/2019-09-07_14h23m_Subject 47762.txt","47762",2019-09-07,"14:23",2,85,60,12,13,25,45,5,8,58,39,18,21,78,398,97,94,589,427.016666666667,246.6,2898.23728813559,1827.68518518519,77,104,181,96.7213114754098
"./Ship3_Latin-square/2019-09-07_14h23m_Subject 47791.txt","47791",2019-09-07,"14:23",0,75,60,4,11,15,11,0,1,12,34,3,8,45,989,55,170,1214,91.9333333333333,182.05,2999.8813559322,1281.30508474576,19,48,67,100
"./Ship3_Latin-square/2019-09-09_10h19m_Subject 46878.txt","46878",2019-09-09,"10:19",2,85,60,13,12,25,45,23,11,79,51,28,59,138,450,160,112,722,364.566666666667,252.933333333333,2901.64406779661,2368.75,115,119,234,91.8032786885246
"./Ship3_Latin-square/2019-09-09_10h19m_Subject 46885.txt","46885",2019-09-09,"10:19",0,77,60,7,10,17,69,9,10,88,18,2,0,20,310,40,59,409,631.75,215.233333333333,2999.93220338983,2190.48275862069,52,73,125,98.3606557377049
"./Ship3_Latin-square/2019-09-09_10h19m_Subject 46899.txt","46899",2019-09-09,"10:19",4,82,60,8,14,22,49,6,7,62,47,9,14,70,514,80,145,739,326.566666666667,198.9,2755.8813559322,1481.06779661017,51,46,97,100
"./Ship3_Latin-square/2019-09-09_10h19m_Subject 47081.txt","47081",2019-09-09,"10:19",16,86,60,18,8,26,57,5,7,69,31,24,44,99,243,33,54,330,412.816666666667,246.8,2430.45762711864,1590.48275862069,59,23,82,98.3606557377049
"./Ship3_Latin-square/2019-09-09_10h19m_Subject 47091.txt","47091",2019-09-09,"10:19",4,76,60,6,10,16,43,7,5,55,82,8,11,101,177,23,48,248,980.35,402.083333333333,2776.25423728814,2873.09090909091,65,75,140,93.4426229508197
"./Ship3_Latin-square/2019-09-09_10h19m_Subject 47231.txt","47231",2019-09-09,"10:19",4,78,60,6,12,18,48,3,19,70,24,7,2,33,137,14,33,184,1177.98333333333,185.983333333333,2776.18644067797,3155.75609756098,69,60,129,75.4098360655738
"./Ship3_Latin-square/2019-09-09_10h19m_Subject 47238.txt","47238",2019-09-09,"10:19",24,74,60,10,4,14,34,1,2,37,70,9,8,87,276,8,23,307,339.216666666667,211.516666666667,2023.71186440678,990.689655172414,62,50,112,98.3606557377049
"./Ship3_Latin-square/2019-09-09_10h19m_Subject 47242.txt","47242",2019-09-09,"10:19",24,80,60,12,8,20,67,2,13,82,62,19,9,90,321,10,93,424,354.766666666667,246.35,2023.67796610169,1190.57142857143,63,48,111,95.0819672131148
"./Ship3_Latin-square/2019-09-09_10h19m_Subject 47244.txt","47244",2019-09-09,"10:19",0,83,60,5,18,23,40,6,20,66,52,9,53,114,363,37,121,521,700.35,235.6,2999.91525423729,2581.94339622642,50,163,213,90.1639344262295
"./Ship3_Latin-square/2019-09-09_10h19m_Subject 47633.txt","47633",2019-09-09,"10:19",2,80,60,11,9,20,56,20,8,84,66,14,21,101,257,56,44,357,586.283333333333,211.8,2901.67796610169,1871.79661016949,36,56,92,100
"./Ship3_Latin-square/2019-09-09_10h19m_Subject 47636.txt","47636",2019-09-09,"10:19",24,59,45,12,2,14,97,23,5,125,58,17,3,78,152,5,5,162,2532,441.666666666667,2236.31818181818,3578.54285714286,105,63,168,80
"./Ship3_Latin-square/2019-09-09_10h19m_Subject 47752.txt","47752",2019-09-09,"10:19",4,81,60,10,11,21,41,8,9,58,31,19,8,58,440,78,105,623,527.983333333333,146.45,2803.30508474576,2170.30188679245,55,115,170,91.8032786885246
"./Ship3_Latin-square/2019-09-09_10h19m_Subject 47767.txt","47767",2019-09-09,"10:19",24,53,39,12,2,14,99,8,32,139,14,3,1,18,95,1,1,97,2497.05128205128,221.615384615385,2446.05128205128,2867.58064516129,63,51,114,82.5
"./Ship3_Latin-square/2019-09-09_10h19m_Subject 47768.txt","47768",2019-09-09,"10:19",24,57,42,10,5,15,116,17,14,147,33,20,8,61,159,2,22,183,2194.48780487805,227.170731707317,2121.92682926829,2285.23529411765,65,58,123,85.7142857142857
"./Ship3_Latin-square/2019-09-09_10h19m_Subject 47780.txt","47780",2019-09-09,"10:19",0,79,60,6,13,19,51,11,10,72,58,7,30,95,377,34,108,519,327.266666666667,212,2999.86440677966,1961,40,72,112,98.3606557377049
"./Ship3_Latin-square/2019-09-09_10h22m_Subject 46884.txt","46884",2019-09-09,"10:22",8,82,59,12,11,23,46,6,11,63,32,6,2,40,143,29,26,198,916.28813559322,325.271186440678,2620.30508474576,3544.74193548387,84,91,175,66.6666666666667
"./Ship3_Latin-square/2019-09-09_10h22m_Subject 47083.txt","47083",2019-09-09,"10:22",0,77,58,6,13,19,60,4,9,73,53,3,30,86,268,25,73,366,1064.66666666667,357.771929824561,2999.89473684211,2602.2,119,74,193,89.6551724137931
"./Ship3_Latin-square/2019-09-09_10h22m_Subject 47086.txt","47086",2019-09-09,"10:22",16,74,56,12,6,18,68,14,6,88,43,13,2,58,214,25,33,272,800.454545454545,208.581818181818,2389.03636363636,2272.53846153846,82,49,131,98.2142857142857
"./Ship3_Latin-square/2019-09-09_10h22m_Subject 47246.txt","47246",2019-09-09,"10:22",8,79,60,10,9,19,58,4,3,65,24,3,2,29,380,52,74,506,715.866666666667,185.05,2579.61016949153,1524.125,20,101,121,96.7213114754098
"./Ship3_Latin-square/2019-09-09_10h22m_Subject 47635.txt","47635",2019-09-09,"10:22",2,80,60,14,6,20,37,9,7,53,61,24,13,98,398,84,42,524,472.116666666667,251.133333333333,2922,1637.94915254237,65,51,116,100
"./Ship3_Latin-square/2019-09-09_10h22m_Subject 47779.txt","47779",2019-09-09,"10:22",2,35,25,9,1,10,48,7,0,55,3,6,0,9,52,27,3,82,7155.5,129.833333333333,2974.91666666667,6640.83333333333,110,0,110,48
"./Ship3_Latin-square/2019-09-09_10h22m_Subject 47797.txt","47797",2019-09-09,"10:22",0,51,37,0,14,14,40,0,15,55,12,0,11,23,137,0,33,170,3943.91666666667,209.416666666667,2999.94444444444,2437.88888888889,15,83,98,83.7837837837838
"./Ship3_Latin-square/2019-09-09_11h35m_Subject 46900.txt","46900",2019-09-09,"11:35",8,77,60,8,9,17,8,15,0,23,66,4,48,118,699,69,154,922,149.283333333333,222.183333333333,2579.61016949153,1370.63157894737,53,85,138,96.7213114754098
"./Ship3_Latin-square/2019-09-09_11h35m_Subject 46986.txt","46986",2019-09-09,"11:35",2,77,58,11,8,19,65,13,11,89,9,24,1,34,263,36,31,330,1111.24561403509,144.017543859649,2912.19298245614,3414.73333333333,116,69,185,86.2068965517241
"./Ship3_Latin-square/2019-09-09_11h35m_Subject 47076.txt","47076",2019-09-09,"11:35",24,83,60,14,9,23,40,2,6,48,49,15,49,113,261,11,56,328,356.05,314.716666666667,1942.33898305085,1572.71111111111,69,101,170,80.327868852459
"./Ship3_Latin-square/2019-09-09_11h35m_Subject 47079.txt","47079",2019-09-09,"11:35",0,77,60,8,9,17,31,1,0,32,43,5,12,60,345,35,59,439,316.033333333333,192.883333333333,2999.96610169492,1903.69491525424,71,66,137,100
"./Ship3_Latin-square/2019-09-09_11h35m_Subject 47082.txt","47082",2019-09-09,"11:35",24,66,49,13,4,17,99,10,11,120,27,10,7,44,244,11,21,276,1828,165.291666666667,2249.89583333333,1819.04545454545,71,41,112,93.8775510204082
"./Ship3_Latin-square/2019-09-09_11h35m_Subject 47092.txt","47092",2019-09-09,"11:35",0,77,60,9,8,17,21,2,1,24,47,17,6,70,765,108,82,955,158.716666666667,207.933333333333,2999.91525423729,1954.13793103448,101,116,217,98.3606557377049
"./Ship3_Latin-square/2019-09-09_11h35m_Subject 47226.txt","47226",2019-09-09,"11:35",24,80,60,12,8,20,55,7,17,79,42,9,9,60,305,5,46,356,726.95,233.75,1983,1579.17391304348,57,75,132,83.6065573770492
"./Ship3_Latin-square/2019-09-09_11h35m_Subject 47227.txt","47227",2019-09-09,"11:35",24,84,60,15,9,24,62,10,9,81,33,27,7,67,230,2,49,281,446.483333333333,178.883333333333,2023.69491525424,1255.44444444444,38,56,94,81.9672131147541
"./Ship3_Latin-square/2019-09-09_11h35m_Subject 47250.txt","47250",2019-09-09,"11:35",16,83,60,13,10,23,37,4,11,52,36,5,22,63,357,31,107,495,306.883333333333,174.283333333333,2294.89830508475,1255.22641509434,33,63,96,93.4426229508197
"./Ship3_Latin-square/2019-09-09_11h35m_Subject 47645.txt","47645",2019-09-09,"11:35",2,30,22,7,1,8,84,7,18,109,20,17,1,38,93,54,1,148,6374.14285714286,247,2961.80952380952,4462.11764705882,65,16,81,81.8181818181818
"./Ship3_Latin-square/2019-09-09_11h35m_Subject 47646.txt","47646",2019-09-09,"11:35",24,78,60,12,6,18,50,2,9,61,27,6,8,41,429,2,57,488,545.916666666667,144.2,2023.66101694915,1139.325,61,68,129,73.7704918032787
"./Ship3_Latin-square/2019-09-09_11h35m_Subject 47755.txt","47755",2019-09-09,"11:35",4,82,60,5,17,22,51,5,10,66,49,3,20,72,404,31,124,559,418.766666666667,252.85,2728.76271186441,2913.85454545455,65,203,268,95.0819672131148
"./Ship3_Latin-square/2019-09-09_11h35m_Subject 47760.txt","47760",2019-09-09,"11:35",0,82,60,8,14,22,52,7,22,81,45,6,11,62,695,92,163,950,225.266666666667,249.716666666667,2999.89830508475,1370.23728813559,17,22,39,100
"./Ship3_Latin-square/2019-09-09_11h35m_Subject 47770.txt","47770",2019-09-09,"11:35",2,51,40,7,4,11,99,14,3,116,91,11,0,102,166,36,14,216,3184.25641025641,533.74358974359,2912.79487179487,4428.36363636364,59,71,130,90
"./Ship3_Latin-square/2019-09-09_11h35m_Subject 47795.txt","47795",2019-09-09,"11:35",24,66,48,15,3,18,72,16,4,92,36,16,3,55,149,4,21,174,1067.21276595745,471.042553191489,2336.14893617021,2242.9512195122,47,24,71,91.6666666666667
"./Ship3_Latin-square/2019-09-09_11h40m_Subject 47229.txt","47229",2019-09-09,"11:40",16,78,60,10,8,18,39,10,12,61,40,14,5,59,423,48,63,534,270.983333333333,188.483333333333,2267.69491525424,1291,63,63,126,95.0819672131148
"./Ship3_Latin-square/2019-09-09_11h40m_Subject 47233.txt","47233",2019-09-09,"11:40",8,84,60,10,14,24,31,0,4,35,31,8,16,55,336,39,89,464,202.383333333333,195.033333333333,2552.49152542373,1741.10526315789,57,77,134,98.3606557377049
"./Ship3_Latin-square/2019-09-09_11h40m_Subject 47234.txt","47234",2019-09-09,"11:40",16,85,60,15,10,25,42,7,5,54,38,18,7,63,313,53,58,424,342.75,184.683333333333,2349.13559322034,1924.26530612245,111,58,169,91.8032786885246
"./Ship3_Latin-square/2019-09-09_11h40m_Subject 47241.txt","47241",2019-09-09,"11:40",0,89,60,0,29,29,34,0,6,40,9,0,7,16,752,0,304,1056,166.716666666667,104.633333333333,2999.93220338983,1718.66666666667,0,135,135,98.3606557377049
"./Ship3_Latin-square/2019-09-09_11h40m_Subject 47247.txt","47247",2019-09-09,"11:40",0,79,60,8,11,19,32,3,3,38,19,6,7,32,215,51,43,309,427.3,196.7,2999.89830508475,2787.375,49,119,168,80.327868852459
"./Ship3_Latin-square/2019-09-09_11h40m_Subject 47777.txt","47777",2019-09-09,"11:40",24,64,45,9,10,19,104,13,28,145,32,13,14,59,124,3,29,156,2181.71111111111,357.113636363636,1745.45454545455,2416.27906976744,51,38,89,97.7777777777778
"./Ship3_Latin-square/2019-09-09_11h40m_Subject 47784.txt","47784",2019-09-09,"11:40",0,81,60,1,20,21,37,1,5,43,43,2,21,66,1126,10,268,1404,178.416666666667,206.966666666667,2999.8813559322,1438.79661016949,26,196,222,100
"./Ship3_Latin-square/2019-09-09_12h47m_Subject 46880.txt","46880",2019-09-09,"12:47",8,87,60,11,16,27,11,1,4,16,12,1,17,30,474,79,150,703,182.616666666667,111.35,2538.94915254237,2008.58536585366,66,167,233,73.7704918032787
"./Ship3_Latin-square/2019-09-09_12h47m_Subject 46882.txt","46882",2019-09-09,"12:47",24,77,54,13,10,23,79,9,22,110,63,19,5,87,381,1,59,441,1324.68518518519,222.037037037037,1933.27777777778,1843.13333333333,45,65,110,85.4545454545455
"./Ship3_Latin-square/2019-09-09_12h47m_Subject 46883.txt","46883",2019-09-09,"12:47",2,81,60,9,12,21,45,56,4,105,116,32,15,163,567,78,122,767,299.283333333333,254.666666666667,2894.8813559322,1623.1186440678,44,78,122,100
"./Ship3_Latin-square/2019-09-09_12h47m_Subject 46894.txt","46894",2019-09-09,"12:47",8,81,60,10,11,21,35,9,7,51,52,17,4,73,233,34,45,312,635.783333333333,333.533333333333,2566.08474576271,2055.74468085106,65,62,127,86.8852459016393
"./Ship3_Latin-square/2019-09-09_12h47m_Subject 47088.txt","47088",2019-09-09,"12:47",16,82,60,11,11,22,63,6,20,89,52,15,28,95,390,45,110,545,364.716666666667,217.116666666667,2186.40677966102,1279.64814814815,45,128,173,91.8032786885246
"./Ship3_Latin-square/2019-09-09_12h47m_Subject 47228.txt","47228",2019-09-09,"12:47",8,79,60,11,8,19,35,10,5,50,19,6,2,27,306,74,55,435,445.733333333333,126.35,2620.27118644068,1914.36956521739,43,142,185,81.9672131147541
"./Ship3_Latin-square/2019-09-09_12h47m_Subject 47243.txt","47243",2019-09-09,"12:47",8,81,60,12,9,21,101,10,35,146,36,7,9,52,492,83,74,649,611.333333333333,191.516666666667,2620.27118644068,1769.71929824561,114,70,184,100
"./Ship3_Latin-square/2019-09-09_12h47m_Subject 47249.txt","47249",2019-09-09,"12:47",16,72,56,12,4,16,77,12,6,95,76,27,4,107,179,26,17,222,1726,285.327272727273,2389.03636363636,2218.29411764706,82,43,125,94.6428571428571
"./Ship3_Latin-square/2019-09-09_12h47m_Subject 47639.txt","47639",2019-09-09,"12:47",8,77,60,9,8,17,27,2,3,32,14,4,9,27,641,76,90,807,166,131.033333333333,2606.74576271186,1541.87931034483,59,83,142,98.3606557377049
"./Ship3_Latin-square/2019-09-09_12h47m_Subject 47649.txt","47649",2019-09-09,"12:47",4,77,60,8,9,17,32,1,0,33,23,5,4,32,310,37,34,381,582.366666666667,165.983333333333,2803.35593220339,2530.4358974359,91,111,202,77.0491803278689
"./Ship3_Latin-square/2019-09-09_12h47m_Subject 47758.txt","47758",2019-09-09,"12:47",16,80,60,13,7,20,23,0,1,24,33,58,1,92,491,45,94,630,196.2,241.983333333333,2349.10169491525,1052.8431372549,97,33,130,93.4426229508197
"./Ship3_Latin-square/2019-09-09_12h47m_Subject 47759.txt","47759",2019-09-09,"12:47",16,81,60,12,9,21,24,8,1,33,52,19,13,84,398,33,84,515,186.533333333333,184.983333333333,2267.76271186441,1233.28571428571,49,49,98,96.7213114754098
"./Ship3_Latin-square/2019-09-09_12h47m_Subject 47776.txt","47776",2019-09-09,"12:47",8,81,60,8,13,21,26,4,7,37,58,12,45,115,697,128,172,997,160.4,182.983333333333,2511.83050847458,1422.61016949153,43,70,113,100
"./Ship3_Latin-square/2019-09-09_12h47m_Subject 47799.txt","47799",2019-09-09,"12:47",16,79,60,8,11,19,47,4,8,59,75,12,8,95,232,16,74,322,387.233333333333,233.766666666667,2132.16949152542,1521.07142857143,42,39,81,96.7213114754098
"./Ship3_Latin-square/2019-09-09_12h54m_Subject 46881.txt","46881",2019-09-09,"12:54",24,83,58,12,13,25,82,3,23,108,42,4,13,59,253,10,58,321,737.245614035088,190.175438596491,1778.85964912281,2163.84090909091,60,102,162,79.3103448275862
"./Ship3_Latin-square/2019-09-09_12h54m_Subject 47087.txt","47087",2019-09-09,"12:54",24,82,60,12,10,22,87,12,17,116,73,18,13,104,198,11,40,249,819.2,245.416666666667,1860.98305084746,1810.20338983051,88,57,145,100
"./Ship3_Latin-square/2019-09-09_12h54m_Subject 47626.txt","47626",2019-09-09,"12:54",8,82,60,10,12,22,36,3,9,48,87,9,9,105,238,27,69,334,426.283333333333,266.033333333333,2606.74576271186,2531.22641509434,96,79,175,90.1639344262295
"./Ship3_Latin-square/2019-09-09_12h54m_Subject 47634.txt","47634",2019-09-09,"12:54",24,79,56,12,11,23,104,15,34,153,39,10,7,56,181,3,65,249,1082.29090909091,224.036363636364,1865.41818181818,2163.43396226415,97,39,136,98.2142857142857
"./Ship3_Latin-square/2019-09-09_12h54m_Subject 47640.txt","47640",2019-09-09,"12:54",24,65,49,13,3,16,81,12,6,99,26,13,1,40,293,3,21,317,1231.52083333333,214.895833333333,2249.91666666667,1399.93023255814,51,34,85,89.7959183673469
"./Ship3_Latin-square/2019-09-09_12h54m_Subject 47754.txt","47754",2019-09-09,"12:54",8,48,35,8,5,13,33,52,4,89,20,18,91,129,103,23,6,132,2824.11764705882,299.441176470588,2670.55882352941,5835.52,46,138,184,80
"./Ship3_Latin-square/2019-09-09_12h54m_Subject 47800.txt","47800",2019-09-09,"12:54",16,75,60,10,5,15,70,2,2,74,64,16,2,82,264,30,34,328,871.783333333333,186.966666666667,2321.98305084746,2194.19642857143,59,98,157,95.0819672131148
"./Ship3_Latin-square/2019-09-09_13h59m_Subject 46876.txt","46876",2019-09-09,"13:59",8,79,60,11,8,19,31,5,3,39,2,0,3,5,355,45,71,471,1173.58333333333,109.383333333333,2633.84745762712,1530.94736842105,79,138,217,73.7704918032787
"./Ship3_Latin-square/2019-09-09_13h59m_Subject 46877.txt","46877",2019-09-09,"13:59",24,84,60,13,11,24,102,3,29,134,98,119,43,260,599,21,209,829,339.266666666667,276.883333333333,1901.62711864407,946.078431372549,33,144,177,90.1639344262295
"./Ship3_Latin-square/2019-09-09_13h59m_Subject 46893.txt","46893",2019-09-09,"13:59",8,82,60,9,13,22,16,1,2,19,35,5,6,46,744,84,161,989,99.6166666666667,187.133333333333,2538.94915254237,1374.30508474576,59,50,109,100
"./Ship3_Latin-square/2019-09-09_13h59m_Subject 46895.txt","46895",2019-09-09,"13:59",4,78,56,10,12,22,41,7,9,57,48,24,10,82,357,55,57,469,1148.58181818182,375.127272727273,2796.32727272727,2464.41666666667,51,75,126,94.6428571428571
"./Ship3_Latin-square/2019-09-09_13h59m_Subject 47638.txt","47638",2019-09-09,"13:59",8,79,60,11,8,19,97,13,9,119,52,21,40,113,264,38,43,345,1001.01666666667,242.316666666667,2620.30508474576,2153.83928571429,97,31,128,95.0819672131148
"./Ship3_Latin-square/2019-09-09_13h59m_Subject 47757.txt","47757",2019-09-09,"13:59",16,58,42,11,5,16,79,29,8,116,22,11,2,35,174,50,31,255,2366.2380952381,208.785714285714,2414.58536585366,3102.66666666667,76,86,162,86.046511627907
"./Ship3_Latin-square/2019-09-09_13h59m_Subject 47769.txt","47769",2019-09-09,"13:59",8,78,56,13,9,22,69,10,14,93,37,14,24,75,417,60,73,550,1239.10714285714,173.160714285714,2650.87272727273,1906.44642857143,82,74,156,100
"./Ship3_Latin-square/2019-09-09_13h59m_Subject 47771.txt","47771",2019-09-09,"13:59",16,81,60,11,10,21,45,2,8,55,29,14,35,78,490,56,132,678,362.55,152.45,2213.49152542373,1380.83673469388,26,143,169,86.8852459016393
"./Ship3_Latin-square/2019-09-09_13h59m_Subject 47775.txt","47775",2019-09-09,"13:59",16,83,59,14,10,24,125,32,3,160,54,39,13,106,289,40,70,399,948.423728813559,235.576271186441,2349.06779661017,1454.10169491525,52,18,70,100
"./Ship3_Latin-square/2019-09-09_13h59m_Subject 47781.txt","47781",2019-09-09,"13:59",24,78,60,10,8,18,50,1,6,57,43,22,13,78,445,2,130,577,382.35,205.55,1901.64406779661,1261.10204081633,97,39,136,85.2459016393443
"./Ship3_Latin-square/2019-09-09_13h59m_Subject 47782.txt","47782",2019-09-09,"13:59",16,75,60,7,8,15,57,1,0,58,16,2,6,24,580,37,123,740,193.933333333333,96.0666666666667,2213.52542372881,1066.67857142857,18,82,100,96.7213114754098
"./Ship3_Latin-square/2019-09-09_13h59m_Subject 47783.txt","47783",2019-09-09,"13:59",24,75,59,13,3,16,99,14,6,119,33,8,3,44,355,7,16,378,1566.45762711864,161.864406779661,2213.72413793103,2028.91071428571,78,35,113,96.6101694915254
"./Ship3_Latin-square/2019-09-09_13h59m_Subject 47785.txt","47785",2019-09-09,"13:59",24,85,60,14,11,25,94,12,20,126,45,6,23,74,332,1,90,423,712.316666666667,236.816666666667,1860.94915254237,1468.96,35,81,116,85.2459016393443
"./Ship3_Latin-square/2019-09-09_13h59m_Subject 47786.txt","47786",2019-09-09,"13:59",16,71,53,11,7,18,58,13,13,84,44,9,15,68,178,22,57,257,1693.92307692308,246.25,2292.26923076923,2838.17391304348,52,31,83,92.4528301886792
"./Ship3_Latin-square/2019-09-09_13h59m_Subject 47788.txt","47788",2019-09-09,"13:59",16,82,60,13,9,22,42,11,7,60,70,25,11,106,412,55,86,553,309.083333333333,212.45,2294.83050847458,1505.54237288136,55,29,84,100
"./Ship3_Latin-square/2019-09-09_14h03m_Subject 46888.txt","46888",2019-09-09,"14:03",16,80,60,13,7,20,40,6,6,52,45,16,10,71,505,47,106,658,423.016666666667,214.9,2322,1580.32203389831,47,43,90,100
"./Ship3_Latin-square/2019-09-09_14h03m_Subject 46889.txt","46889",2019-09-09,"14:03",0,82,60,3,19,22,8,0,4,12,26,4,21,51,801,59,195,1055,176.766666666667,233.966666666667,2999.86440677966,1670.9649122807,35,93,128,98.3606557377049
"./Ship3_Latin-square/2019-09-09_14h03m_Subject 46892.txt","46892",2019-09-09,"14:03",16,84,60,14,10,24,38,11,4,53,21,3,5,29,453,86,97,636,220.466666666667,243.45,2240.64406779661,1465.17307692308,37,125,162,91.8032786885246
"./Ship3_Latin-square/2019-09-09_14h03m_Subject 46898.txt","46898",2019-09-09,"14:03",0,83,60,6,17,23,30,2,5,37,5,5,8,18,527,40,101,668,285.416666666667,122,2999.8813559322,2224.6,33,225,258,86.8852459016393
"./Ship3_Latin-square/2019-09-09_14h03m_Subject 47097.txt","47097",2019-09-09,"14:03",24,85,60,17,8,25,87,4,15,106,81,45,10,136,385,0,90,475,332.816666666667,244.433333333333,2105.03389830508,1178.03389830508,102,29,131,100
"./Ship3_Latin-square/2019-09-09_14h03m_Subject 47099.txt","47099",2019-09-09,"14:03",16,84,60,12,12,24,30,10,7,47,40,10,10,60,516,54,150,720,224.466666666667,243.716666666667,2213.52542372881,1440.4406779661,73,39,112,100
"./Ship3_Latin-square/2019-09-09_14h03m_Subject 47798.txt","47798",2019-09-09,"14:03",2,81,60,6,15,21,23,2,5,30,18,2,1,21,158,11,69,238,677.233333333333,187.966666666667,2871.16949152542,2774.48,55,115,170,63.9344262295082
"./Ship3_Latin-square/2019-09-09_15h22m_Subject 47080.txt","47080",2019-09-09,"15:22",8,76,60,7,9,16,22,0,1,23,9,1,0,10,474,68,80,622,216.433333333333,116.266666666667,2552.49152542373,1658.91666666667,33,191,224,88.5245901639344
"./Ship3_Latin-square/2019-09-09_15h22m_Subject 47089.txt","47089",2019-09-09,"15:22",16,58,40,13,5,18,46,10,8,64,51,23,6,80,116,24,15,155,2171.45,430.75,2479.9,3866.09375,97,43,140,82.9268292682927
"./Ship3_Latin-square/2019-09-09_15h22m_Subject 47762.txt","47762",2019-09-09,"15:22",4,80,60,9,11,20,34,4,7,45,35,6,2,43,246,44,53,343,600.483333333333,193.466666666667,2796.57627118644,2624.47916666667,74,113,187,86.8852459016393
"./Ship3_Latin-square/2019-09-09_15h22m_Subject 47791.txt","47791",2019-09-09,"15:22",8,77,60,7,10,17,11,0,0,11,32,7,4,43,770,52,173,995,93.5166666666667,174.066666666667,2579.62711864407,1278.83050847458,27,48,75,100
"./Ship3_Latin-square/2019-09-10_10h09m_Subject 46878.txt","46878",2019-09-10,"10:09",4,80,60,9,11,20,28,1,1,30,39,12,11,62,779,130,148,1057,149.216666666667,233.15,2789.79661016949,1835.93103448276,85,93,178,98.3606557377049
"./Ship3_Latin-square/2019-09-10_10h09m_Subject 46885.txt","46885",2019-09-10,"10:09",8,81,60,10,11,21,56,5,8,69,7,3,2,12,291,35,48,374,718.733333333333,112.266666666667,2593.16949152542,1972.90740740741,73,64,137,91.8032786885246
"./Ship3_Latin-square/2019-09-10_10h09m_Subject 46899.txt","46899",2019-09-10,"10:09",0,86,60,10,16,26,56,30,12,98,38,22,14,74,752,110,239,1101,298.816666666667,147.666666666667,2999.94915254237,1103.15254237288,32,60,92,100
"./Ship3_Latin-square/2019-09-10_10h09m_Subject 47081.txt","47081",2019-09-10,"10:09",0,82,60,11,11,22,21,3,4,28,13,1,29,43,514,97,107,718,183.516666666667,112.983333333333,2999.94915254237,1564.34545454545,53,59,112,98.3606557377049
"./Ship3_Latin-square/2019-09-10_10h09m_Subject 47091.txt","47091",2019-09-10,"10:09",0,76,60,11,5,16,58,9,7,74,63,21,7,91,242,39,16,297,902.283333333333,294.533333333333,2999.91525423729,2455.65517241379,61,54,115,98.3606557377049
"./Ship3_Latin-square/2019-09-10_10h09m_Subject 47231.txt","47231",2019-09-10,"10:09",0,79,60,4,15,19,51,3,13,67,18,7,13,38,226,9,65,300,724.766666666667,130.483333333333,2999.91525423729,2416.08333333333,32,96,128,86.8852459016393
"./Ship3_Latin-square/2019-09-10_10h09m_Subject 47238.txt","47238",2019-09-10,"10:09",16,82,60,10,12,22,13,4,3,20,78,17,24,119,305,35,68,408,211.883333333333,353.25,2132.16949152542,1241.98275862069,34,49,83,98.3606557377049
"./Ship3_Latin-square/2019-09-10_10h09m_Subject 47242.txt","47242",2019-09-10,"10:09",16,81,60,13,8,21,77,7,14,98,55,35,9,99,440,64,86,590,427.816666666667,203.733333333333,2321.96610169492,1275.86206896552,66,50,116,98.3606557377049
"./Ship3_Latin-square/2019-09-10_10h09m_Subject 47244.txt","47244",2019-09-10,"10:09",8,78,60,11,7,18,26,2,0,28,107,20,10,137,444,46,97,587,343.75,411.4,2647.4406779661,1862,78,82,160,96.7213114754098
"./Ship3_Latin-square/2019-09-10_10h09m_Subject 47633.txt","47633",2019-09-10,"10:09",4,82,60,12,10,22,49,5,5,59,64,21,27,112,290,54,47,391,477.15,197,2816.91525423729,1643.38983050847,48,44,92,100
"./Ship3_Latin-square/2019-09-10_10h09m_Subject 47636.txt","47636",2019-09-10,"10:09",2,79,60,9,10,19,61,7,7,75,65,12,17,94,284,53,59,396,1003.41666666667,198.816666666667,2898.20338983051,3297.13461538462,121,122,243,91.8032786885246
"./Ship3_Latin-square/2019-09-10_10h09m_Subject 47752.txt","47752",2019-09-10,"10:09",0,78,60,8,10,18,56,3,5,64,36,16,10,62,613,76,98,787,469.633333333333,174.366666666667,2999.94915254237,1756.17543859649,71,67,138,96.7213114754098
"./Ship3_Latin-square/2019-09-10_10h09m_Subject 47767.txt","47767",2019-09-10,"10:09",16,49,38,10,1,11,96,18,51,165,36,81,0,117,137,14,10,161,3232.86842105263,388.5,2567.48648648649,3331.09090909091,53,45,98,92.3076923076923
"./Ship3_Latin-square/2019-09-10_10h09m_Subject 47768.txt","47768",2019-09-10,"10:09",2,36,25,11,0,11,48,14,0,62,6,10,0,16,97,75,0,172,5736.75,234.458333333333,2991.5,3251.5,162,7,169,36
"./Ship3_Latin-square/2019-09-10_10h09m_Subject 47780.txt","47780",2019-09-10,"10:09",24,52,38,12,2,14,83,19,5,107,82,28,2,112,150,5,10,165,3185.23684210526,1083.05405405405,2416.18918918919,3116.16216216216,69,12,81,100
"./Ship3_Latin-square/2019-09-10_10h15m_Subject 46884.txt","46884",2019-09-10,"10:15",24,43,31,8,4,12,44,2,3,49,69,8,3,80,99,6,8,113,3235.25806451613,2045.38709677419,1993.48387096774,8369.80952380952,48,43,91,75
"./Ship3_Latin-square/2019-09-10_10h15m_Subject 47083.txt","47083",2019-09-10,"10:15",8,76,58,11,7,18,54,3,5,62,49,14,16,79,272,28,31,331,1246.81034482759,308.827586206897,2641.36206896552,2437.3125,120,80,200,86.4406779661017
"./Ship3_Latin-square/2019-09-10_10h15m_Subject 47086.txt","47086",2019-09-10,"10:15",0,79,60,8,11,19,26,0,2,28,37,11,4,52,442,65,103,610,304.633333333333,190.866666666667,2999.93220338983,1872.01851851852,59,96,155,93.4426229508197
"./Ship3_Latin-square/2019-09-10_10h15m_Subject 47246.txt","47246",2019-09-10,"10:15",24,65,48,10,7,17,138,17,17,172,48,6,26,80,172,4,58,234,2252.40425531915,271.553191489362,1927.6170212766,1716.31818181818,55,68,123,97.9166666666667
"./Ship3_Latin-square/2019-09-10_10h15m_Subject 47635.txt","47635",2019-09-10,"10:15",4,81,60,9,12,21,44,4,5,53,61,9,26,96,481,68,82,631,440.05,244.333333333333,2783,1825.77966101695,50,75,125,100
"./Ship3_Latin-square/2019-09-10_10h15m_Subject 47779.txt","47779",2019-09-10,"10:15",4,82,59,11,12,23,39,2,6,47,35,12,18,65,174,35,56,265,1114.18644067797,169.016949152542,2799.98275862069,3228.39473684211,89,74,163,76.271186440678
"./Ship3_Latin-square/2019-09-10_10h15m_Subject 47797.txt","47797",2019-09-10,"10:15",24,20,14,5,1,6,28,5,4,37,11,13,1,25,27,5,3,35,8558.5,318,2485.64285714286,8452,10,4,14,100
"./Ship3_Latin-square/2019-09-10_11h38m_Subject 46900.txt","46900",2019-09-10,"11:38",24,81,60,14,7,21,68,2,12,82,40,17,6,63,468,9,98,575,337.816666666667,192.6,2023.62711864407,1204.29411764706,66,58,124,86.8852459016393
"./Ship3_Latin-square/2019-09-10_11h38m_Subject 46986.txt","46986",2019-09-10,"11:38",16,69,54,12,3,15,68,7,1,76,11,5,0,16,207,24,10,241,1815.92452830189,144.679245283019,2426.37735849057,3404.16666666667,160,48,208,72.2222222222222
"./Ship3_Latin-square/2019-09-10_11h38m_Subject 47076.txt","47076",2019-09-10,"11:38",16,82,60,11,11,22,33,3,6,42,50,2,36,88,437,36,153,626,277.5,233.15,2294.8813559322,1479.57407407407,76,114,190,95.0819672131148
"./Ship3_Latin-square/2019-09-10_11h38m_Subject 47079.txt","47079",2019-09-10,"11:38",8,86,60,6,20,26,33,2,7,42,57,3,33,93,193,20,110,323,449.716666666667,224.266666666667,2403.37288135593,1766.61538461538,65,210,275,57.3770491803279
"./Ship3_Latin-square/2019-09-10_11h38m_Subject 47082.txt","47082",2019-09-10,"11:38",16,81,60,12,9,21,149,10,4,163,34,5,7,46,376,37,80,493,914.933333333333,150.483333333333,2240.67796610169,1731.49122807018,74,80,154,100
"./Ship3_Latin-square/2019-09-10_11h38m_Subject 47092.txt","47092",2019-09-10,"11:38",8,81,60,10,11,21,19,0,3,22,48,14,11,73,609,87,132,828,102.383333333333,213.35,2579.62711864407,1616.08474576271,75,97,172,100
"./Ship3_Latin-square/2019-09-10_11h38m_Subject 47226.txt","47226",2019-09-10,"11:38",16,79,60,8,11,19,14,0,8,22,36,16,14,66,540,39,206,785,136.85,182.466666666667,2186.40677966102,1312.11538461538,36,63,99,90.1639344262295
"./Ship3_Latin-square/2019-09-10_11h38m_Subject 47227.txt","47227",2019-09-10,"11:38",16,82,60,13,9,22,74,20,9,103,33,21,5,59,240,42,32,314,663.433333333333,149.05,2294.84745762712,1692.14814814815,55,66,121,91.8032786885246
"./Ship3_Latin-square/2019-09-10_11h38m_Subject 47229.txt","47229",2019-09-10,"11:38",8,75,60,10,5,15,14,1,4,19,32,11,3,46,741,102,90,933,112.65,167.383333333333,2660.96610169492,1205.66101694915,64,55,119,100
"./Ship3_Latin-square/2019-09-10_11h38m_Subject 47233.txt","47233",2019-09-10,"11:38",24,83,60,14,9,23,55,2,13,70,57,24,12,93,283,6,64,353,264.9,215.55,2023.64406779661,872.71186440678,39,19,58,100
"./Ship3_Latin-square/2019-09-10_11h38m_Subject 47234.txt","47234",2019-09-10,"11:38",0,80,60,6,14,20,103,6,10,119,52,19,14,85,819,84,185,1088,266.733333333333,213.383333333333,2999.93220338983,1362.77966101695,39,121,160,100
"./Ship3_Latin-square/2019-09-10_11h38m_Subject 47241.txt","47241",2019-09-10,"11:38",24,77,60,10,7,17,32,3,7,42,9,5,1,15,501,8,125,634,147.566666666667,162.9,1901.59322033898,1088.18421052632,43,63,106,72.1311475409836
"./Ship3_Latin-square/2019-09-10_11h38m_Subject 47247.txt","47247",2019-09-10,"11:38",8,78,60,7,11,18,25,0,4,29,19,0,10,29,319,36,64,419,294.15,152.033333333333,2538.89830508475,2077.6170212766,59,107,166,88.5245901639344
"./Ship3_Latin-square/2019-09-10_11h38m_Subject 47250.txt","47250",2019-09-10,"11:38",8,79,60,10,9,19,16,3,5,24,17,0,4,21,807,110,137,1054,95.95,111.033333333333,2620.33898305085,1211.98181818182,30,67,97,96.7213114754098
"./Ship3_Latin-square/2019-09-10_11h38m_Subject 47645.txt","47645",2019-09-10,"11:38",16,39,28,8,3,11,83,23,12,118,20,5,3,28,107,18,13,138,5489.14285714286,291.5,2466.59259259259,4958.07692307692,55,34,89,93.1034482758621
"./Ship3_Latin-square/2019-09-10_11h38m_Subject 47646.txt","47646",2019-09-10,"11:38",16,78,60,11,7,18,58,6,10,74,43,19,3,65,473,38,125,636,457.45,168.4,2240.61016949153,1596.1568627451,42,87,129,91.8032786885246
"./Ship3_Latin-square/2019-09-10_11h38m_Subject 47755.txt","47755",2019-09-10,"11:38",0,81,60,7,14,21,50,1,9,60,37,1,29,67,641,66,87,794,360.8,359.183333333333,2999.94915254237,1941.47368421053,84,160,244,96.7213114754098
"./Ship3_Latin-square/2019-09-10_11h38m_Subject 47760.txt","47760",2019-09-10,"11:38",8,81,60,10,11,21,42,8,9,59,57,8,19,84,764,75,209,1048,171.183333333333,230.3,2593.18644067797,1032.67796610169,12,31,43,100
"./Ship3_Latin-square/2019-09-10_11h38m_Subject 47770.txt","47770",2019-09-10,"11:38",4,51,39,6,6,12,73,6,6,85,50,10,3,63,178,18,23,219,3719.64102564103,364.769230769231,2805.07692307692,4410.94117647059,54,88,142,90
"./Ship3_Latin-square/2019-09-10_11h38m_Subject 47777.txt","47777",2019-09-10,"11:38",16,80,60,10,10,20,59,5,15,79,34,2,7,43,337,42,118,497,450.983333333333,305.35,2240.64406779661,1567.96551724138,71,53,124,100
"./Ship3_Latin-square/2019-09-10_11h38m_Subject 47784.txt","47784",2019-09-10,"11:38",8,79,60,10,9,19,34,0,4,38,59,54,8,121,943,107,208,1258,113.066666666667,205.516666666667,2620.27118644068,1140.54237288136,56,71,127,100
"./Ship3_Latin-square/2019-09-10_11h38m_Subject 47795.txt","47795",2019-09-10,"11:38",16,69,51,12,6,18,92,27,58,177,40,14,18,72,162,15,20,197,1062.96078431373,384.529411764706,2403.90196078431,2790.77551020408,63,86,149,96.1538461538462
"./Ship3_Latin-square/2019-09-10_13h02m_Subject 46880.txt","46880",2019-09-10,"13:02",24,81,60,13,8,21,78,6,14,98,21,9,6,36,290,0,72,362,558.283333333333,170.816666666667,1982.96610169492,1637.82,71,52,123,85.2459016393443
"./Ship3_Latin-square/2019-09-10_13h02m_Subject 46882.txt","46882",2019-09-10,"13:02",16,80,60,10,10,20,77,7,12,96,193,71,49,313,396,33,157,586,535.716666666667,523.25,2213.50847457627,1609.41176470588,54,118,172,90.1639344262295
"./Ship3_Latin-square/2019-09-10_13h02m_Subject 46883.txt","46883",2019-09-10,"13:02",4,84,60,12,12,24,33,2,5,40,36,14,9,59,416,87,97,600,237.216666666667,167.7,2803.35593220339,1807.24074074074,99,60,159,93.4426229508197
"./Ship3_Latin-square/2019-09-10_13h02m_Subject 46894.txt","46894",2019-09-10,"13:02",16,78,60,9,9,18,77,11,14,102,39,10,4,53,234,26,39,299,753.266666666667,193.6,2186.4406779661,2214.38775510204,75,83,158,85.2459016393443
"./Ship3_Latin-square/2019-09-10_13h02m_Subject 47088.txt","47088",2019-09-10,"13:02",4,78,60,10,8,18,27,4,1,32,96,23,10,129,794,135,112,1041,147.933333333333,344.316666666667,2816.8813559322,1131.64406779661,53,88,141,100
"./Ship3_Latin-square/2019-09-10_13h02m_Subject 47228.txt","47228",2019-09-10,"13:02",16,79,60,9,10,19,21,5,1,27,35,16,4,55,367,46,116,529,322.1,181.816666666667,2186.40677966102,1539.57142857143,56,125,181,91.8032786885246
"./Ship3_Latin-square/2019-09-10_13h02m_Subject 47243.txt","47243",2019-09-10,"13:02",16,81,60,12,9,21,116,15,23,154,37,11,64,112,459,56,81,596,681.016666666667,196.55,2267.69491525424,1611.28813559322,111,87,198,100
"./Ship3_Latin-square/2019-09-10_13h02m_Subject 47249.txt","47249",2019-09-10,"13:02",4,77,60,9,8,17,70,5,24,99,124,23,50,197,308,50,48,406,511.333333333333,440.416666666667,2816.8813559322,1599.66101694915,82,45,127,100
"./Ship3_Latin-square/2019-09-10_13h02m_Subject 47639.txt","47639",2019-09-10,"13:02",16,81,60,12,9,21,35,7,5,47,22,7,8,37,448,38,89,575,258.5,162.1,2267.67796610169,1539.7037037037,71,83,154,91.8032786885246
"./Ship3_Latin-square/2019-09-10_13h02m_Subject 47649.txt","47649",2019-09-10,"13:02",0,78,60,6,12,18,48,4,11,63,24,1,13,38,532,59,120,711,336.7,229.2,2999.89830508475,1836.69565217391,92,184,276,81.9672131147541
"./Ship3_Latin-square/2019-09-10_13h02m_Subject 47758.txt","47758",2019-09-10,"13:02",4,83,60,12,11,23,38,9,0,47,49,3,34,86,821,149,166,1136,194.3,209.083333333333,2796.52542372881,1421.5,99,96,195,96.7213114754098
"./Ship3_Latin-square/2019-09-10_13h02m_Subject 47759.txt","47759",2019-09-10,"13:02",4,77,60,8,9,17,128,34,97,259,56,45,57,158,560,69,114,743,515.033333333333,196.4,2783,1740.625,40,194,234,93.4426229508197
"./Ship3_Latin-square/2019-09-10_13h02m_Subject 47776.txt","47776",2019-09-10,"13:02",16,77,60,8,9,17,27,3,3,33,46,12,11,69,646,48,136,830,150.883333333333,149.666666666667,2213.50847457627,1103.35714285714,35,57,92,98.3606557377049
"./Ship3_Latin-square/2019-09-10_13h02m_Subject 47799.txt","47799",2019-09-10,"13:02",4,84,60,9,15,24,25,16,1,42,99,26,44,169,639,106,166,911,242.75,316.85,2749.1186440678,1383.68421052632,35,76,111,98.3606557377049
"./Ship3_Latin-square/2019-09-10_13h08m_Subject 46881.txt","46881",2019-09-10,"13:08",16,79,60,11,8,19,59,4,5,68,32,5,6,43,375,56,94,525,650.766666666667,198.4,2294.86440677966,1478.75925925926,67,83,150,95.0819672131148
"./Ship3_Latin-square/2019-09-10_13h08m_Subject 47087.txt","47087",2019-09-10,"13:08",16,84,60,13,11,24,52,37,14,103,56,49,40,145,254,46,56,356,518.5,208.75,2240.59322033898,1599.77586206897,75,72,147,98.3606557377049
"./Ship3_Latin-square/2019-09-10_13h08m_Subject 47626.txt","47626",2019-09-10,"13:08",24,68,50,11,7,18,88,1,15,104,92,16,2,110,197,0,24,221,1747.56,437.56,2039.94,2828.04651162791,87,101,188,88.2352941176471
"./Ship3_Latin-square/2019-09-10_13h08m_Subject 47632.txt","47632",2019-09-10,"13:08",4,82,60,11,11,22,96,2,9,107,110,88,44,242,847,162,207,1216,316.566666666667,335.2,2796.5593220339,1444.18965517241,77,192,269,96.7213114754098
"./Ship3_Latin-square/2019-09-10_13h08m_Subject 47634.txt","47634",2019-09-10,"13:08",16,83,58,14,11,25,90,17,21,128,24,3,11,38,243,32,81,356,938.929824561404,216.228070175439,2270.14035087719,1988.30357142857,99,34,133,98.2758620689655
"./Ship3_Latin-square/2019-09-10_13h08m_Subject 47640.txt","47640",2019-09-10,"13:08",16,77,58,10,9,19,51,16,10,77,33,6,6,45,300,29,93,422,1093.18965517241,162.578947368421,2213.9649122807,2020.11111111111,45,86,131,86.2068965517241
"./Ship3_Latin-square/2019-09-10_13h08m_Subject 47754.txt","47754",2019-09-10,"13:08",16,36,27,5,4,9,31,6,4,41,25,7,61,93,59,4,7,70,7561.84615384615,391.576923076923,2261.42307692308,5103.80952380952,10,95,105,85.1851851851852
"./Ship3_Latin-square/2019-09-10_13h08m_Subject 47800.txt","47800",2019-09-10,"13:08",8,77,60,9,8,17,55,6,7,68,56,14,7,77,329,45,40,414,535.15,186.6,2620.28813559322,1890.85454545455,68,81,149,95.0819672131148
"./Ship3_Latin-square/2019-09-10_14h24m_Subject 46876.txt","46876",2019-09-10,"14:24",24,39,29,9,1,10,53,11,1,65,15,10,1,26,109,0,6,115,2616.10714285714,250.178571428571,2399.92857142857,2617.58333333333,49,25,74,86.2068965517241
"./Ship3_Latin-square/2019-09-10_14h24m_Subject 46877.txt","46877",2019-09-10,"14:24",2,81,60,12,9,21,56,0,4,60,61,81,165,307,1056,212,194,1462,169,194.566666666667,2908.42372881356,1238.89655172414,48,146,194,100
"./Ship3_Latin-square/2019-09-10_14h24m_Subject 46893.txt","46893",2019-09-10,"14:24",16,81,60,13,8,21,19,2,2,23,54,13,26,93,670,72,133,875,95.0166666666667,178.15,2267.71186440678,1052.56896551724,63,59,122,98.3606557377049
"./Ship3_Latin-square/2019-09-10_14h24m_Subject 46895.txt","46895",2019-09-10,"14:24",0,79,60,6,13,19,48,5,9,62,13,13,10,36,284,33,77,394,688.033333333333,150.45,3000,2595.26086956522,29,95,124,85.2459016393443
"./Ship3_Latin-square/2019-09-10_14h24m_Subject 47638.txt","47638",2019-09-10,"14:24",16,79,59,13,7,20,69,13,10,92,41,18,13,72,199,28,30,257,1030.49152542373,261.864406779661,2310.25862068966,2266.27272727273,86,31,117,95
"./Ship3_Latin-square/2019-09-10_14h24m_Subject 47757.txt","47757",2019-09-10,"14:24",4,66,47,10,9,19,88,38,15,141,32,13,20,65,250,64,41,355,1864.17021276596,296.085106382979,2799.9347826087,2403.86666666667,67,90,157,97.9166666666667
"./Ship3_Latin-square/2019-09-10_14h24m_Subject 47769.txt","47769",2019-09-10,"14:24",16,79,58,15,6,21,85,10,10,105,33,15,23,71,330,50,36,416,1125.81034482759,166.879310344828,2410.45614035088,1994.57142857143,86,73,159,98.3050847457627
"./Ship3_Latin-square/2019-09-10_14h24m_Subject 47771.txt","47771",2019-09-10,"14:24",8,78,60,11,7,18,25,5,1,31,16,10,2,28,595,91,109,795,133.716666666667,139.933333333333,2660.91525423729,1383.09090909091,43,90,133,93.4426229508197
"./Ship3_Latin-square/2019-09-10_14h24m_Subject 47775.txt","47775",2019-09-10,"14:24",8,83,60,12,11,23,69,17,11,97,25,20,7,52,405,67,87,559,597.183333333333,143.716666666667,2606.74576271186,1829.49152542373,46,56,102,100
"./Ship3_Latin-square/2019-09-10_14h24m_Subject 47781.txt","47781",2019-09-10,"14:24",16,77,60,11,6,17,35,4,5,44,54,18,2,74,596,29,109,734,219.75,230.8,2294.8813559322,1264.8,55,58,113,95.0819672131148
"./Ship3_Latin-square/2019-09-10_14h24m_Subject 47782.txt","47782",2019-09-10,"14:24",4,79,60,7,12,19,36,4,1,41,19,3,5,27,896,118,142,1156,150.683333333333,103.066666666667,2776.25423728814,1414.1186440678,28,152,180,100
"./Ship3_Latin-square/2019-09-10_14h24m_Subject 47783.txt","47783",2019-09-10,"14:24",16,71,54,13,4,17,104,14,2,120,40,22,4,66,352,28,56,436,1821.05555555556,159.277777777778,2456.50943396226,2232.36538461538,66,36,102,98.1818181818182
"./Ship3_Latin-square/2019-09-10_14h24m_Subject 47785.txt","47785",2019-09-10,"14:24",16,81,60,11,10,21,52,6,2,60,33,8,31,72,413,46,120,579,373.266666666667,264.133333333333,2240.64406779661,1480.5,42,93,135,90.1639344262295
"./Ship3_Latin-square/2019-09-10_14h24m_Subject 47786.txt","47786",2019-09-10,"14:24",0,69,50,8,11,19,73,10,15,98,24,4,14,42,330,49,59,438,2138.9,164.3,2999.89795918367,2166.77083333333,35,55,90,98.0392156862745
"./Ship3_Latin-square/2019-09-10_14h24m_Subject 47788.txt","47788",2019-09-10,"14:24",4,78,60,7,11,18,29,3,3,35,82,11,14,107,727,83,132,942,292.466666666667,211.883333333333,2782.94915254237,1320.49152542373,36,44,80,100
"./Ship3_Latin-square/2019-09-10_14h30m_Subject 46888.txt","46888",2019-09-10,"14:30",8,77,60,7,10,17,42,1,2,45,80,0,14,94,813,84,161,1058,151.066666666667,284.633333333333,2566.01694915254,1267.66666666667,36,83,119,96.7213114754098
"./Ship3_Latin-square/2019-09-10_14h30m_Subject 46889.txt","46889",2019-09-10,"14:30",8,77,60,5,12,17,8,2,0,10,22,3,3,28,988,62,246,1296,65.1333333333333,151.25,2511.79661016949,1318.42105263158,50,137,187,98.3606557377049
"./Ship3_Latin-square/2019-09-10_14h30m_Subject 46892.txt","46892",2019-09-10,"14:30",4,81,60,8,13,21,27,1,3,31,90,11,11,112,861,115,155,1131,159.883333333333,402.35,2782.98305084746,1451.89655172414,74,143,217,98.3606557377049
"./Ship3_Latin-square/2019-09-10_14h30m_Subject 46898.txt","46898",2019-09-10,"14:30",24,74,60,9,5,14,38,4,3,45,30,8,4,42,288,19,34,341,307.65,190.316666666667,2023.69491525424,1731.54761904762,44,92,136,78.6885245901639
"./Ship3_Latin-square/2019-09-10_14h30m_Subject 47097.txt","47097",2019-09-10,"14:30",16,81,60,13,8,21,62,6,4,72,59,41,36,136,505,66,88,659,331.2,177.716666666667,2294.89830508475,1257.36206896552,67,60,127,98.3606557377049
"./Ship3_Latin-square/2019-09-10_14h30m_Subject 47099.txt","47099",2019-09-10,"14:30",4,81,60,9,12,21,9,2,3,14,86,28,34,148,1165,184,248,1597,78.2833333333333,277.133333333333,2783,1244.77966101695,58,98,156,100
"./Ship3_Latin-square/2019-09-10_14h30m_Subject 47798.txt","47798",2019-09-10,"14:30",4,85,60,6,19,25,21,2,3,26,17,0,6,23,243,18,98,359,217.283333333333,179.433333333333,2715.22033898305,1844.8,41,159,200,70.4918032786885
"./Ship3_Latin-square/2019-09-10_15h30m_Subject 47080.txt","47080",2019-09-10,"15:30",16,81,60,9,12,21,27,0,5,32,12,0,4,16,376,36,110,522,210.683333333333,127.083333333333,2132.10169491525,1683.36734693878,52,117,169,90.1639344262295
"./Ship3_Latin-square/2019-09-10_15h30m_Subject 47089.txt","47089",2019-09-10,"15:30",8,51,36,13,2,15,49,18,1,68,79,73,6,158,108,35,6,149,2922.74285714286,826.942857142857,2862.68571428571,3874.90322580645,103,10,113,91.6666666666667
"./Ship3_Latin-square/2019-09-10_15h30m_Subject 47762.txt","47762",2019-09-10,"15:30",0,79,60,7,12,19,24,4,3,31,32,5,9,46,229,30,48,307,358.216666666667,378.916666666667,2999.86440677966,2565.17948717949,86,129,215,72.1311475409836
"./Ship3_Latin-square/2019-09-10_15h30m_Subject 47791.txt","47791",2019-09-10,"15:30",24,84,60,14,10,24,41,7,4,52,63,29,15,107,361,3,71,435,320.55,341.85,1983.03389830508,1144.50980392157,27,67,94,86.8852459016393
"./Ship3_Latin-square/2019-09-11_09h50m_Subject 46878.txt","46878",2019-09-11,"09:50",0,79,60,8,11,19,24,2,4,30,13,6,32,51,1028,155,182,1365,145.033333333333,140.566666666667,2999.8813559322,1842.12068965517,79,115,194,98.3606557377049
"./Ship3_Latin-square/2019-09-11_09h50m_Subject 46885.txt","46885",2019-09-11,"09:50",24,80,60,12,8,20,101,14,9,124,25,8,4,37,171,7,44,222,896.25,168.8,1901.64406779661,2065.48148148148,71,53,124,93.4426229508197
"./Ship3_Latin-square/2019-09-11_09h50m_Subject 46899.txt","46899",2019-09-11,"09:50",8,79,60,11,8,19,47,5,4,56,28,14,4,46,683,93,121,897,239.883333333333,192.35,2661.01694915254,1163.15254237288,29,30,59,100
"./Ship3_Latin-square/2019-09-11_09h50m_Subject 47081.txt","47081",2019-09-11,"09:50",24,84,59,16,9,25,104,4,31,139,84,14,13,111,269,3,59,331,657.423728813559,541.932203389831,1965.46551724138,1419.86274509804,44,92,136,89.8305084745763
"./Ship3_Latin-square/2019-09-11_09h50m_Subject 47091.txt","47091",2019-09-11,"09:50",8,78,60,6,12,18,43,0,5,48,72,8,14,94,240,26,61,327,474.166666666667,238.916666666667,2538.93220338983,2222.05084745763,65,63,128,100
"./Ship3_Latin-square/2019-09-11_09h50m_Subject 47231.txt","47231",2019-09-11,"09:50",8,80,58,13,9,22,63,6,10,79,32,23,4,59,153,30,22,205,1122.86206896552,200.068965517241,2655.15517241379,2601.12244897959,41,62,103,86.4406779661017
"./Ship3_Latin-square/2019-09-11_09h50m_Subject 47238.txt","47238",2019-09-11,"09:50",8,82,60,10,12,22,42,3,2,47,54,12,19,85,546,58,143,747,174.783333333333,256.95,2552.49152542373,1087.40677966102,42,48,90,100
"./Ship3_Latin-square/2019-09-11_09h50m_Subject 47242.txt","47242",2019-09-11,"09:50",8,83,60,13,10,23,53,5,7,65,81,46,11,138,612,123,139,874,310.466666666667,285.45,2647.33898305085,1340.35593220339,71,58,129,100
"./Ship3_Latin-square/2019-09-11_09h50m_Subject 47244.txt","47244",2019-09-11,"09:50",24,78,60,10,8,18,60,5,8,73,120,24,18,162,279,11,53,343,577.716666666667,528.75,1860.98305084746,1394.69387755102,60,100,160,85.2459016393443
"./Ship3_Latin-square/2019-09-11_09h50m_Subject 47633.txt","47633",2019-09-11,"09:50",0,78,60,7,11,18,36,4,4,44,65,10,18,93,430,51,79,560,522.3,175.566666666667,2999.93220338983,1949.37288135593,56,78,134,100
"./Ship3_Latin-square/2019-09-11_09h50m_Subject 47636.txt","47636",2019-09-11,"09:50",4,69,51,11,7,18,93,21,8,122,72,12,9,93,288,58,31,377,1807.86274509804,243.960784313725,2827.45098039216,3224.66666666667,106,92,198,100
"./Ship3_Latin-square/2019-09-11_09h50m_Subject 47752.txt","47752",2019-09-11,"09:50",8,80,60,8,12,20,51,6,6,63,46,7,20,73,679,76,206,961,340.833333333333,151.366666666667,2566.08474576271,1181.32203389831,51,80,131,100
"./Ship3_Latin-square/2019-09-11_09h50m_Subject 47767.txt","47767",2019-09-11,"09:50",8,83,60,13,10,23,173,26,16,215,28,5,7,40,346,58,101,505,690.45,176.35,2647.42372881356,1398.01785714286,37,58,95,98.3606557377049
"./Ship3_Latin-square/2019-09-11_09h50m_Subject 47768.txt","47768",2019-09-11,"09:50",4,82,60,12,10,22,86,8,8,102,28,37,22,87,507,63,101,671,634.933333333333,194.033333333333,2810.15254237288,2246.72916666667,112,173,285,83.6065573770492
"./Ship3_Latin-square/2019-09-11_09h50m_Subject 47780.txt","47780",2019-09-11,"09:50",2,79,60,9,10,19,92,8,16,116,26,12,4,42,361,35,95,491,569.65,239.65,2894.84745762712,2034.03773584906,76,61,137,93.4426229508197
"./Ship3_Latin-square/2019-09-11_09h55m_Subject 46884.txt","46884",2019-09-11,"09:55",16,68,51,10,7,17,50,5,9,64,43,2,6,51,178,23,24,225,1955.6,493.42,2327.94,4180.28125,107,82,189,74.5098039215686
"./Ship3_Latin-square/2019-09-11_09h55m_Subject 47083.txt","47083",2019-09-11,"09:55",24,59,41,12,6,18,80,12,22,114,70,25,11,106,122,1,14,137,2292.2,562.975,2219.9,3577.64705882353,76,73,149,85.3658536585366
"./Ship3_Latin-square/2019-09-11_09h55m_Subject 47086.txt","47086",2019-09-11,"09:55",24,82,60,16,6,22,98,18,10,126,22,50,2,74,291,12,44,347,850.583333333333,165.616666666667,2186.35593220339,1320.32142857143,63,34,97,96.7213114754098
"./Ship3_Latin-square/2019-09-11_09h55m_Subject 47246.txt","47246",2019-09-11,"09:55",16,70,51,12,7,19,76,21,7,104,26,6,20,52,277,44,92,413,1819.45098039216,210.43137254902,2359.96,1540.68181818182,44,76,120,90.3846153846154
"./Ship3_Latin-square/2019-09-11_09h55m_Subject 47635.txt","47635",2019-09-11,"09:55",0,76,60,2,14,16,25,0,3,28,56,7,14,77,590,19,140,749,197.083333333333,240.333333333333,2999.91525423729,1848.47457627119,57,84,141,100
"./Ship3_Latin-square/2019-09-11_09h55m_Subject 47779.txt","47779",2019-09-11,"09:55",0,77,55,11,11,22,26,4,4,34,27,10,8,45,206,32,29,267,1377.87272727273,159.8,2999.89090909091,3321.57142857143,93,84,177,73.2142857142857
"./Ship3_Latin-square/2019-09-11_09h55m_Subject 47797.txt","47797",2019-09-11,"09:55",2,74,57,5,12,17,37,4,2,43,27,10,8,45,236,21,58,315,1100.75,215.803571428571,2874.92857142857,2622.19607843137,34,118,152,91.2280701754386
"./Ship3_Latin-square/2019-09-11_11h09m_Subject 46900.txt","46900",2019-09-11,"11:09",16,78,60,8,10,18,49,1,3,53,147,94,4,245,483,30,123,636,250.933333333333,460.966666666667,2132.13559322034,1311.58490566038,44,101,145,91.8032786885246
"./Ship3_Latin-square/2019-09-11_11h09m_Subject 46986.txt","46986",2019-09-11,"11:09",0,70,51,8,11,19,96,7,9,112,19,6,36,61,235,54,48,337,1806.58823529412,199.86,2999.88,3262.28260869565,75,78,153,96.078431372549
"./Ship3_Latin-square/2019-09-11_11h09m_Subject 47076.txt","47076",2019-09-11,"11:09",8,80,60,10,10,20,21,0,4,25,25,17,59,101,351,39,105,495,299.583333333333,217.65,2593.16949152542,2145.5306122449,80,167,247,83.6065573770492
"./Ship3_Latin-square/2019-09-11_11h09m_Subject 47079.txt","47079",2019-09-11,"11:09",24,77,60,12,5,17,68,12,12,92,61,12,5,78,178,10,35,223,460.866666666667,247.3,1942.32203389831,1749.87037037037,107,48,155,93.4426229508197
"./Ship3_Latin-square/2019-09-11_11h09m_Subject 47082.txt","47082",2019-09-11,"11:09",8,82,60,11,11,22,156,6,10,172,170,33,49,252,424,83,96,603,548.3,439.066666666667,2606.71186440678,1853.67857142857,76,128,204,95.0819672131148
"./Ship3_Latin-square/2019-09-11_11h09m_Subject 47092.txt","47092",2019-09-11,"11:09",24,83,60,12,11,23,64,0,15,79,58,21,12,91,356,12,131,499,243.816666666667,227.033333333333,1820.27118644068,1221.74576271186,92,39,131,100
"./Ship3_Latin-square/2019-09-11_11h09m_Subject 47226.txt","47226",2019-09-11,"11:09",8,80,60,7,13,20,8,0,3,11,64,3,15,82,748,87,185,1020,86.3833333333333,187,2525.35593220339,1543.05454545455,24,123,147,96.7213114754098
"./Ship3_Latin-square/2019-09-11_11h09m_Subject 47227.txt","47227",2019-09-11,"11:09",8,81,60,12,9,21,77,17,8,102,59,21,20,100,243,65,71,379,796.95,276.733333333333,2620.27118644068,2264.55102040816,58,101,159,90.1639344262295
"./Ship3_Latin-square/2019-09-11_11h09m_Subject 47250.txt","47250",2019-09-11,"11:09",16,81,60,10,11,21,44,4,8,56,18,10,15,43,465,30,130,625,236.066666666667,116.433333333333,2159.23728813559,1361.46296296296,52,63,115,95.0819672131148
"./Ship3_Latin-square/2019-09-11_11h09m_Subject 47645.txt","47645",2019-09-11,"11:09",0,54,40,7,7,14,124,15,21,160,39,18,29,86,155,59,34,248,2947.82051282051,248.230769230769,2999.84615384615,4308.74358974359,77,50,127,100
"./Ship3_Latin-square/2019-09-11_11h09m_Subject 47646.txt","47646",2019-09-11,"11:09",8,79,60,9,10,19,68,11,7,86,50,23,16,89,707,74,164,945,427.3,188.883333333333,2579.62711864407,1483.77777777778,30,117,147,91.8032786885246
"./Ship3_Latin-square/2019-09-11_11h09m_Subject 47755.txt","47755",2019-09-11,"11:09",8,82,60,7,15,22,69,5,10,84,30,2,14,46,418,43,128,589,604,293.583333333333,2484.72881355932,2637.65384615385,75,209,284,93.4426229508197
"./Ship3_Latin-square/2019-09-11_11h09m_Subject 47760.txt","47760",2019-09-11,"11:09",24,82,60,12,10,22,72,6,17,95,56,13,18,87,358,1,103,462,514.95,234.7,1942.32203389831,957.305084745763,28,18,46,100
"./Ship3_Latin-square/2019-09-11_11h09m_Subject 47770.txt","47770",2019-09-11,"11:09",0,49,34,7,8,15,71,6,10,87,40,9,8,57,124,31,33,188,3891.33333333333,374.787878787879,2999.87878787879,5169.85714285714,51,66,117,85.2941176470588
"./Ship3_Latin-square/2019-09-11_11h09m_Subject 47795.txt","47795",2019-09-11,"11:09",8,83,60,13,10,23,94,9,9,112,37,19,7,63,383,80,100,563,540.75,223.483333333333,2647.35593220339,1685.38983050847,36,34,70,100
"./Ship3_Latin-square/2019-09-11_11h14m_Subject 47229.txt","47229",2019-09-11,"11:14",16,83,60,13,10,23,27,1,6,34,40,21,16,77,598,55,108,761,157.85,178.516666666667,2267.69491525424,1142.39285714286,77,64,141,96.7213114754098
"./Ship3_Latin-square/2019-09-11_11h14m_Subject 47233.txt","47233",2019-09-11,"11:14",16,80,60,10,10,20,21,2,8,31,30,11,7,48,406,40,98,544,102.633333333333,143.283333333333,2213.52542372881,1116.85454545455,76,72,148,98.3606557377049
"./Ship3_Latin-square/2019-09-11_11h14m_Subject 47234.txt","47234",2019-09-11,"11:14",24,84,60,13,11,24,32,3,6,41,61,16,18,95,382,23,147,552,230.683333333333,182.016666666667,1942.30508474576,1042.55769230769,70,57,127,91.8032786885246
"./Ship3_Latin-square/2019-09-11_11h14m_Subject 47237.txt","47237",2019-09-11,"11:14",4,75,60,9,6,15,79,9,3,91,23,6,6,35,518,72,55,645,544.45,214.7,2816.89830508475,1256.875,57,57,114,95.0819672131148
"./Ship3_Latin-square/2019-09-11_11h14m_Subject 47241.txt","47241",2019-09-11,"11:14",2,88,60,0,28,28,24,0,10,34,12,0,2,14,1033,0,372,1405,106.516666666667,118.933333333333,2803.38983050847,1744.14285714286,5,236,241,96.7213114754098
"./Ship3_Latin-square/2019-09-11_11h14m_Subject 47247.txt","47247",2019-09-11,"11:14",24,71,60,7,4,11,74,6,9,89,31,3,4,38,171,1,12,184,675.916666666667,201.85,1901.62711864407,1776.29787234043,43,70,113,80.327868852459
"./Ship3_Latin-square/2019-09-11_11h14m_Subject 47777.txt","47777",2019-09-11,"11:14",8,80,60,9,11,20,45,7,7,59,25,1,5,31,411,70,107,588,402.633333333333,256.483333333333,2566.06779661017,1335.33898305085,60,49,109,100
"./Ship3_Latin-square/2019-09-11_11h14m_Subject 47784.txt","47784",2019-09-11,"11:14",24,70,54,14,2,16,195,31,6,232,74,9,6,89,440,4,28,472,1893.92452830189,306.943396226415,2320.66037735849,1506.90196078431,101,47,148,98.1481481481482
"./Ship3_Latin-square/2019-09-11_12h29m_Subject 46880.txt","46880",2019-09-11,"12:29",16,75,60,9,6,15,21,2,4,27,11,10,4,25,424,24,81,529,216.933333333333,124.783333333333,2240.64406779661,1390,53,83,136,86.8852459016393
"./Ship3_Latin-square/2019-09-11_12h29m_Subject 46882.txt","46882",2019-09-11,"12:29",8,82,60,12,10,22,118,16,20,154,154,46,25,225,522,82,161,765,531.783333333333,574.983333333333,2620.27118644068,1607.90566037736,78,146,224,91.8032786885246
"./Ship3_Latin-square/2019-09-11_12h29m_Subject 46883.txt","46883",2019-09-11,"12:29",0,80,60,8,12,20,50,2,6,58,123,10,5,138,523,67,121,711,219.233333333333,306.6,2999.86440677966,1926.62068965517,61,96,157,98.3606557377049
"./Ship3_Latin-square/2019-09-11_12h29m_Subject 46894.txt","46894",2019-09-11,"12:29",4,78,60,7,11,18,49,8,4,61,36,3,1,40,386,50,86,522,860.6,200.25,2776.25423728814,1973.06896551724,66,70,136,98.3606557377049
"./Ship3_Latin-square/2019-09-11_12h29m_Subject 47088.txt","47088",2019-09-11,"12:29",24,78,60,10,8,18,85,7,21,113,72,12,14,98,347,3,63,413,355.983333333333,244.566666666667,1901.64406779661,959.12962962963,47,87,134,91.8032786885246
"./Ship3_Latin-square/2019-09-11_12h29m_Subject 47228.txt","47228",2019-09-11,"12:29",4,77,60,7,10,17,27,2,3,32,36,5,6,47,498,60,69,627,355.966666666667,165.7,2783,1541.22807017544,32,78,110,96.7213114754098
"./Ship3_Latin-square/2019-09-11_12h29m_Subject 47243.txt","47243",2019-09-11,"12:29",4,80,60,10,10,20,79,12,10,101,46,40,13,99,663,122,129,914,306.683333333333,298.466666666667,2803.33898305085,1553.5593220339,133,75,208,100
"./Ship3_Latin-square/2019-09-11_12h29m_Subject 47249.txt","47249",2019-09-11,"12:29",24,52,37,11,4,15,58,26,5,89,53,55,8,116,183,14,24,221,762.108108108108,331.459459459459,2221.59459459459,1624.45945945946,70,29,99,100
"./Ship3_Latin-square/2019-09-11_12h29m_Subject 47639.txt","47639",2019-09-11,"12:29",4,83,60,12,11,23,12,4,2,18,10,3,13,26,878,169,172,1219,118.15,112.35,2796.57627118644,1566.25423728814,65,104,169,100
"./Ship3_Latin-square/2019-09-11_12h29m_Subject 47649.txt","47649",2019-09-11,"12:29",8,77,60,10,7,17,32,2,6,40,17,13,7,37,454,68,73,595,286.083333333333,150.616666666667,2620.28813559322,1688.16363636364,72,65,137,93.4426229508197
"./Ship3_Latin-square/2019-09-11_12h29m_Subject 47758.txt","47758",2019-09-11,"12:29",24,83,60,13,10,23,46,2,14,62,20,4,13,37,372,2,107,481,305.116666666667,137.916666666667,1942.30508474576,1275.66666666667,83,60,143,81.9672131147541
"./Ship3_Latin-square/2019-09-11_12h29m_Subject 47759.txt","47759",2019-09-11,"12:29",24,83,60,14,9,23,38,6,9,53,62,11,13,86,297,5,93,395,280.683333333333,210.566666666667,1901.66101694915,949.277777777778,32,35,67,91.8032786885246
"./Ship3_Latin-square/2019-09-11_12h29m_Subject 47776.txt","47776",2019-09-11,"12:29",4,82,60,9,13,22,20,3,3,26,78,24,15,117,992,168,231,1391,92.5666666666667,220.35,2776.27118644068,1338.61016949153,55,54,109,100
"./Ship3_Latin-square/2019-09-11_12h29m_Subject 47799.txt","47799",2019-09-11,"12:29",24,82,60,11,11,22,51,12,12,75,70,34,15,119,281,0,116,397,281.3,228.283333333333,1779.62711864407,1215.61818181818,80,15,95,95.0819672131148
"./Ship3_Latin-square/2019-09-11_12h35m_Subject 46881.txt","46881",2019-09-11,"12:35",8,82,60,10,12,22,61,4,6,71,21,4,25,50,493,66,113,672,370.5,140.716666666667,2579.64406779661,1760.05357142857,31,141,172,98.3606557377049
"./Ship3_Latin-square/2019-09-11_12h35m_Subject 47087.txt","47087",2019-09-11,"12:35",8,81,58,10,13,23,45,23,6,74,57,15,14,86,318,57,73,448,955.105263157895,200.59649122807,2550.85964912281,2626.50877192982,62,73,135,100
"./Ship3_Latin-square/2019-09-11_12h35m_Subject 47626.txt","47626",2019-09-11,"12:35",16,63,48,9,6,15,43,7,5,55,45,11,9,65,221,24,25,270,1294.04255319149,230.063829787234,2285,2969.14285714286,68,71,139,89.5833333333333
"./Ship3_Latin-square/2019-09-11_12h35m_Subject 47632.txt","47632",2019-09-11,"12:35",8,86,60,14,12,26,28,4,14,46,14,27,26,67,780,138,199,1117,827.8,122.366666666667,2633.84745762712,1572.49122807018,87,164,251,95.0819672131148
"./Ship3_Latin-square/2019-09-11_12h35m_Subject 47634.txt","47634",2019-09-11,"12:35",8,72,54,12,6,18,90,18,7,115,92,44,31,167,261,46,28,335,1044.25925925926,608.462962962963,2703.62962962963,1768.88679245283,76,47,123,98.1818181818182
"./Ship3_Latin-square/2019-09-11_12h35m_Subject 47640.txt","47640",2019-09-11,"12:35",8,71,52,11,8,19,88,14,34,136,29,6,8,43,172,36,35,243,1784.67307692308,212.843137254902,2654.8431372549,3623.38095238095,66,92,158,86.5384615384615
"./Ship3_Latin-square/2019-09-11_12h35m_Subject 47754.txt","47754",2019-09-11,"12:35",4,55,40,8,7,15,113,11,14,138,68,11,44,123,160,27,21,208,2463.53846153846,374.282051282051,2794.82051282051,3670.66666666667,22,169,191,85
"./Ship3_Latin-square/2019-09-11_12h35m_Subject 47800.txt","47800",2019-09-11,"12:35",16,77,60,10,7,17,49,12,9,70,63,12,5,80,256,41,36,333,491.6,229.5,2294.86440677966,1900.64285714286,68,59,127,95.0819672131148
"./Ship3_Latin-square/2019-09-11_13h50m_Subject 46876.txt","46876",2019-09-11,"13:50",16,46,35,10,1,11,36,6,0,42,13,13,0,26,144,17,6,167,807.735294117647,179.588235294118,2529.38235294118,5443.17857142857,60,24,84,88.5714285714286
"./Ship3_Latin-square/2019-09-11_13h50m_Subject 46877.txt","46877",2019-09-11,"13:50",4,78,60,7,11,18,21,1,2,24,275,120,13,408,1071,110,228,1409,127.466666666667,474.7,2789.81355932203,1192.87719298246,28,228,256,96.7213114754098
"./Ship3_Latin-square/2019-09-11_13h50m_Subject 46893.txt","46893",2019-09-11,"13:50",4,78,60,9,9,18,15,1,2,18,63,7,7,77,1077,156,197,1430,64.5,228.716666666667,2789.79661016949,1481.64406779661,58,97,155,100
"./Ship3_Latin-square/2019-09-11_13h50m_Subject 46895.txt","46895",2019-09-11,"13:50",8,77,58,8,11,19,49,7,5,61,17,3,7,27,245,27,77,349,1491.70689655172,167.448275862069,2578.91228070175,2107.74468085106,57,58,115,86.4406779661017
"./Ship3_Latin-square/2019-09-11_13h50m_Subject 47638.txt","47638",2019-09-11,"13:50",4,77,55,12,10,22,71,19,13,103,67,30,35,132,264,39,59,362,1136.76363636364,306.090909090909,2814.75925925926,1800.61538461538,67,23,90,94.6428571428571
"./Ship3_Latin-square/2019-09-11_13h50m_Subject 47757.txt","47757",2019-09-11,"13:50",24,66,47,14,5,19,123,28,15,166,34,16,7,57,172,21,28,221,1741.3829787234,240.042553191489,2217.32608695652,2225.9756097561,73,65,138,91.4893617021277
"./Ship3_Latin-square/2019-09-11_13h50m_Subject 47769.txt","47769",2019-09-11,"13:50",4,79,58,13,8,21,64,32,11,107,31,10,19,60,449,117,63,629,994.98275862069,265.586206896552,2838.59649122807,2276.42857142857,145,77,222,96.6101694915254
"./Ship3_Latin-square/2019-09-11_13h50m_Subject 47771.txt","47771",2019-09-11,"13:50",16,80,60,11,9,20,27,4,4,35,23,15,22,60,467,33,102,602,175.716666666667,151.15,2267.74576271186,1325.63043478261,42,129,171,83.6065573770492
"./Ship3_Latin-square/2019-09-11_13h50m_Subject 47775.txt","47775",2019-09-11,"13:50",16,80,60,11,9,20,99,16,14,129,39,15,3,57,285,32,65,382,698.183333333333,153.883333333333,2267.76271186441,1779.05263157895,61,41,102,96.7213114754098
"./Ship3_Latin-square/2019-09-11_13h50m_Subject 47781.txt","47781",2019-09-11,"13:50",8,81,60,13,8,21,23,4,3,30,30,25,3,58,702,84,135,921,225.116666666667,161.333333333333,2674.50847457627,1771.03571428571,109,65,174,95.0819672131148
"./Ship3_Latin-square/2019-09-11_13h50m_Subject 47782.txt","47782",2019-09-11,"13:50",24,77,60,11,6,17,73,11,8,92,34,17,6,57,354,8,62,424,504.15,153.016666666667,1942.33898305085,1233.79545454545,21,85,106,78.6885245901639
"./Ship3_Latin-square/2019-09-11_13h50m_Subject 47783.txt","47783",2019-09-11,"13:50",8,72,52,13,7,20,100,18,14,132,54,28,10,92,354,53,30,437,1617.86274509804,336.352941176471,2701.94117647059,2097.88,91,45,136,98.0769230769231
"./Ship3_Latin-square/2019-09-11_13h50m_Subject 47785.txt","47785",2019-09-11,"13:50",8,79,60,10,9,19,19,4,2,25,32,5,13,50,529,122,51,702,403.2,390.783333333333,2606.74576271186,1754.56140350877,80,82,162,98.3606557377049
"./Ship3_Latin-square/2019-09-11_13h50m_Subject 47786.txt","47786",2019-09-11,"13:50",24,56,41,12,3,15,104,17,9,130,29,11,2,42,158,2,20,180,3037.575,590.575,2279.975,2935.41025641026,59,7,66,100
"./Ship3_Latin-square/2019-09-11_13h50m_Subject 47788.txt","47788",2019-09-11,"13:50",24,82,60,14,8,22,79,7,6,92,81,40,11,132,287,7,60,354,519.783333333333,343.1,2064.30508474576,1279.27272727273,56,35,91,93.4426229508197
"./Ship3_Latin-square/2019-09-11_13h53m_Subject 46888.txt","46888",2019-09-11,"13:53",16,84,60,11,13,24,18,5,5,28,43,9,31,83,477,63,143,683,113.133333333333,176.1,2159.25423728814,1341.22033898305,37,100,137,100
"./Ship3_Latin-square/2019-09-11_13h53m_Subject 46889.txt","46889",2019-09-11,"13:53",24,74,60,9,5,14,44,8,8,60,28,1,4,33,530,12,79,621,221.983333333333,145.533333333333,1820.28813559322,981.604166666667,58,83,141,81.9672131147541
"./Ship3_Latin-square/2019-09-11_13h53m_Subject 46892.txt","46892",2019-09-11,"13:53",24,80,60,13,7,20,51,5,4,60,43,3,3,49,459,26,82,567,207.483333333333,280,1983,1031.64444444444,58,79,137,85.2459016393443
"./Ship3_Latin-square/2019-09-11_13h53m_Subject 46898.txt","46898",2019-09-11,"13:53",2,77,60,5,12,17,27,0,4,31,25,6,7,38,668,83,78,829,176.866666666667,204.766666666667,2888.10169491525,1691.03636363636,61,119,180,93.4426229508197
"./Ship3_Latin-square/2019-09-11_13h53m_Subject 47097.txt","47097",2019-09-11,"13:53",8,78,60,10,8,18,16,2,3,21,77,15,19,111,695,92,119,906,145.883333333333,222.15,2633.81355932203,1359.96610169492,83,72,155,100
"./Ship3_Latin-square/2019-09-11_13h53m_Subject 47099.txt","47099",2019-09-11,"13:53",24,84,60,13,11,24,48,8,19,75,36,18,12,66,439,3,133,575,203.283333333333,200.95,1901.64406779661,1229.02272727273,72,78,150,81.9672131147541
"./Ship3_Latin-square/2019-09-11_13h53m_Subject 47798.txt","47798",2019-09-11,"13:53",0,82,60,4,18,22,18,0,7,25,8,3,0,11,205,8,93,306,403.966666666667,120.683333333333,2999.91525423729,2415.45454545455,37,139,176,77.0491803278689
"./Ship3_Latin-square/2019-09-11_15h03m_Subject 47080.txt","47080",2019-09-11,"15:03",4,79,60,7,12,19,19,3,1,23,19,4,10,33,662,89,155,906,141.883333333333,179.15,2783.01694915254,1664.9649122807,43,119,162,100
"./Ship3_Latin-square/2019-09-11_15h03m_Subject 47089.txt","47089",2019-09-11,"15:03",16,73,54,14,5,19,84,7,14,105,60,28,6,94,191,20,15,226,1512.47169811321,259.433962264151,2426.35849056604,2614.25490196078,87,54,141,96.2962962962963
"./Ship3_Latin-square/2019-09-11_15h03m_Subject 47762.txt","47762",2019-09-11,"15:03",8,80,60,9,11,20,25,1,9,35,18,1,12,31,207,33,44,284,561.416666666667,141,2579.62711864407,2237.92307692308,93,101,194,77.0491803278689
"./Ship3_Latin-square/2019-09-11_15h03m_Subject 47791.txt","47791",2019-09-11,"15:03",16,81,60,10,11,21,15,2,18,35,19,12,31,62,485,43,108,636,137.9,155.85,2159.23728813559,1723.60416666667,29,179,208,85.2459016393443
"./Ship3_Latin-square/2019-09-12_10h09m_Subject 46878.txt","46878",2019-09-12,"10:09",8,79,60,10,9,19,24,1,5,30,30,11,27,68,648,139,96,883,148.1,170.283333333333,2579.66101694915,1835.20338983051,99,77,176,100
"./Ship3_Latin-square/2019-09-12_10h09m_Subject 46885.txt","46885",2019-09-12,"10:09",16,73,53,13,7,20,95,12,25,132,8,6,18,32,203,42,25,270,1365.32075471698,112.207547169811,2366.03773584906,2388.65957446808,73,53,126,88.8888888888889
"./Ship3_Latin-square/2019-09-12_10h09m_Subject 46899.txt","46899",2019-09-12,"10:09",24,68,49,17,2,19,105,19,8,132,43,22,0,65,342,8,24,374,1938.87755102041,174.367346938776,2510.08163265306,1239.09090909091,83,25,108,90
"./Ship3_Latin-square/2019-09-12_10h09m_Subject 47081.txt","47081",2019-09-12,"10:09",2,80,60,9,11,20,27,8,4,39,26,0,8,34,613,115,123,851,186.933333333333,136.266666666667,2891.52542372881,1341.42372881356,44,60,104,100
"./Ship3_Latin-square/2019-09-12_10h09m_Subject 47091.txt","47091",2019-09-12,"10:09",24,77,59,14,4,18,69,16,4,89,70,38,7,115,202,8,11,221,1283.67796610169,245.593220338983,2213.74137931034,2206.89473684211,102,39,141,96.6666666666667
"./Ship3_Latin-square/2019-09-12_10h09m_Subject 47231.txt","47231",2019-09-12,"10:09",24,60,44,13,3,16,72,11,6,89,50,55,3,108,108,8,2,118,1680.02272727273,673.840909090909,2399.90909090909,2762.8,63,26,89,93.3333333333333
"./Ship3_Latin-square/2019-09-12_10h09m_Subject 47238.txt","47238",2019-09-12,"10:09",16,81,60,13,8,21,25,3,3,31,27,18,9,54,459,64,78,601,311.766666666667,149.1,2376.22033898305,1004.8,45,51,96,93.4426229508197
"./Ship3_Latin-square/2019-09-12_10h09m_Subject 47242.txt","47242",2019-09-12,"10:09",16,83,60,15,8,23,45,13,9,67,77,72,6,155,455,53,117,625,306.816666666667,244.4,2376.16949152542,1263.79310344828,43,57,100,98.3606557377049
"./Ship3_Latin-square/2019-09-12_10h09m_Subject 47244.txt","47244",2019-09-12,"10:09",16,83,60,14,9,23,56,8,11,75,80,43,13,136,347,50,48,445,574.05,326.866666666667,2294.83050847458,1566.94545454545,62,78,140,95.0819672131148
"./Ship3_Latin-square/2019-09-12_10h09m_Subject 47633.txt","47633",2019-09-12,"10:09",8,80,60,7,13,20,40,2,6,48,56,9,9,74,354,40,67,461,480.483333333333,160.35,2498.25423728814,1743.5593220339,56,67,123,100
"./Ship3_Latin-square/2019-09-12_10h09m_Subject 47636.txt","47636",2019-09-12,"10:09",0,81,60,3,18,21,86,3,21,110,73,1,58,132,432,38,95,565,889.566666666667,188.3,2999.94915254237,2402.03571428571,74,115,189,95.0819672131148
"./Ship3_Latin-square/2019-09-12_10h09m_Subject 47752.txt","47752",2019-09-12,"10:09",24,80,60,14,6,20,91,19,12,122,80,39,6,125,312,24,49,385,523.266666666667,268.583333333333,1982.98305084746,1022.20338983051,52,44,96,100
"./Ship3_Latin-square/2019-09-12_10h09m_Subject 47767.txt","47767",2019-09-12,"10:09",16,68,50,11,7,18,91,10,21,122,178,7,4,189,147,20,26,193,1390.08,834.52,2346.85714285714,2814.91111111111,64,59,123,94.1176470588235
"./Ship3_Latin-square/2019-09-12_10h09m_Subject 47768.txt","47768",2019-09-12,"10:09",0,82,60,7,15,22,75,3,5,83,32,6,11,49,703,82,147,932,603.266666666667,232.533333333333,2999.8813559322,1977.50877192982,72,113,185,98.3606557377049
"./Ship3_Latin-square/2019-09-12_10h09m_Subject 47780.txt","47780",2019-09-12,"10:09",4,78,60,8,10,18,103,10,11,124,42,8,54,104,346,40,80,466,751.3,206.9,2789.79661016949,1661.54237288136,61,45,106,100
"./Ship3_Latin-square/2019-09-12_10h12m_Subject 46884.txt","46884",2019-09-12,"10:12",8,77,60,8,9,17,46,3,7,56,26,4,19,49,188,58,30,276,766.5,337.066666666667,2579.5593220339,2414.65306122449,62,85,147,88.5245901639344
"./Ship3_Latin-square/2019-09-12_10h12m_Subject 47083.txt","47083",2019-09-12,"10:12",16,73,52,11,10,21,81,7,7,95,42,12,30,84,220,24,65,309,1608.75,258.711538461538,2215.62745098039,2632.09302325581,132,56,188,86.7924528301887
"./Ship3_Latin-square/2019-09-12_10h12m_Subject 47086.txt","47086",2019-09-12,"10:12",2,74,60,6,8,14,46,5,3,54,21,12,5,38,477,49,72,598,368.616666666667,180.866666666667,2888.1186440678,1320.03389830508,32,65,97,100
"./Ship3_Latin-square/2019-09-12_10h12m_Subject 47246.txt","47246",2019-09-12,"10:12",8,80,60,10,10,20,52,7,13,72,35,9,3,47,369,50,83,502,449.7,232,2606.71186440678,1726.75,41,111,152,96.7213114754098
"./Ship3_Latin-square/2019-09-12_10h12m_Subject 47635.txt","47635",2019-09-12,"10:12",8,82,60,11,11,22,37,3,8,48,46,15,10,71,551,73,111,735,265.55,180.966666666667,2593.16949152542,1479.67796610169,47,88,135,100
"./Ship3_Latin-square/2019-09-12_10h12m_Subject 47779.txt","47779",2019-09-12,"10:12",8,59,45,8,6,14,30,6,3,39,24,5,3,32,70,17,8,95,3084.72727272727,157.545454545455,2636.31818181818,4083.20833333333,57,55,112,64.4444444444444
"./Ship3_Latin-square/2019-09-12_10h12m_Subject 47797.txt","47797",2019-09-12,"10:12",4,79,58,7,14,21,34,5,8,47,30,1,8,39,187,34,49,270,1110.84482758621,231.793103448276,2754.36842105263,3050.5,15,134,149,79.6610169491525
"./Ship3_Latin-square/2019-09-12_11h32m_Subject 46900.txt","46900",2019-09-12,"11:32",8,79,60,13,6,19,23,4,0,27,71,75,24,170,684,118,85,887,167.016666666667,245.7,2674.50847457627,1270.0350877193,55,93,148,95.0819672131148
"./Ship3_Latin-square/2019-09-12_11h32m_Subject 46986.txt","46986",2019-09-12,"11:32",24,59,41,12,6,18,75,17,14,106,11,4,4,19,126,8,25,159,2868.29268292683,167.292682926829,2121.92682926829,4340.5,106,28,134,88.0952380952381
"./Ship3_Latin-square/2019-09-12_11h32m_Subject 47076.txt","47076",2019-09-12,"11:32",16,81,60,11,10,21,17,0,4,21,47,7,24,78,520,63,127,710,157.95,242.316666666667,2240.59322033898,1166.73684210526,48,108,156,96.7213114754098
"./Ship3_Latin-square/2019-09-12_11h32m_Subject 47079.txt","47079",2019-09-12,"11:32",16,80,60,10,10,20,44,4,1,49,57,8,9,74,309,52,62,423,499,232.566666666667,2240.64406779661,1396.79661016949,68,61,129,100
"./Ship3_Latin-square/2019-09-12_11h32m_Subject 47082.txt","47082",2019-09-12,"11:32",16,80,60,9,11,20,52,1,7,60,119,81,64,264,333,36,94,463,247.333333333333,318.5,2186.38983050847,1311.28813559322,56,38,94,100
"./Ship3_Latin-square/2019-09-12_11h32m_Subject 47092.txt","47092",2019-09-12,"11:32",16,79,60,12,7,19,27,4,3,34,27,13,8,48,571,48,101,720,163.333333333333,162.966666666667,2321.98305084746,1190.20689655172,83,49,132,98.3606557377049
"./Ship3_Latin-square/2019-09-12_11h32m_Subject 47226.txt","47226",2019-09-12,"11:32",16,79,60,8,11,19,22,0,0,22,82,5,15,102,699,73,233,1005,138.15,199,2105.06779661017,1285.18181818182,30,50,80,96.7213114754098
"./Ship3_Latin-square/2019-09-12_11h32m_Subject 47227.txt","47227",2019-09-12,"11:32",16,79,60,10,9,19,75,15,12,102,37,22,6,65,234,33,51,318,697.65,148.3,2240.64406779661,1500.76785714286,35,84,119,95.0819672131148
"./Ship3_Latin-square/2019-09-12_11h32m_Subject 47250.txt","47250",2019-09-12,"11:32",4,80,60,10,10,20,11,2,3,16,20,7,11,38,898,122,176,1196,108.916666666667,123.283333333333,2803.30508474576,1290.4406779661,28,64,92,100
"./Ship3_Latin-square/2019-09-12_11h32m_Subject 47645.txt","47645",2019-09-12,"11:32",24,43,31,9,3,12,84,32,6,122,28,20,4,52,89,6,14,109,3053.53333333333,316.1,2199.86666666667,3913.71428571429,71,24,95,96.7741935483871
"./Ship3_Latin-square/2019-09-12_11h32m_Subject 47646.txt","47646",2019-09-12,"11:32",16,82,60,11,11,22,22,9,1,32,79,22,21,122,805,51,314,1170,198.916666666667,157.166666666667,2213.47457627119,941.218181818182,15,73,88,96.7213114754098
"./Ship3_Latin-square/2019-09-12_11h32m_Subject 47755.txt","47755",2019-09-12,"11:32",24,84,60,16,8,24,138,12,33,183,44,7,5,56,400,18,113,531,522.766666666667,216.833333333333,2023.69491525424,1057.28260869565,68,140,208,81.9672131147541
"./Ship3_Latin-square/2019-09-12_11h32m_Subject 47760.txt","47760",2019-09-12,"11:32",16,82,60,11,11,22,71,8,4,83,72,21,7,100,458,44,124,626,286.283333333333,463.766666666667,2213.54237288136,1050.93220338983,17,20,37,100
"./Ship3_Latin-square/2019-09-12_11h32m_Subject 47770.txt","47770",2019-09-12,"11:32",8,48,36,6,6,12,43,6,6,55,48,10,8,66,109,14,11,134,3618.6,381.114285714286,2565.68571428571,5653,57,65,122,83.3333333333333
"./Ship3_Latin-square/2019-09-12_11h32m_Subject 47795.txt","47795",2019-09-12,"11:32",16,79,60,10,9,19,90,14,16,120,44,15,6,65,274,19,32,325,599.95,186.916666666667,2267.72881355932,1596,58,16,74,100
"./Ship3_Latin-square/2019-09-12_11h37m_Subject 47229.txt","47229",2019-09-12,"11:37",4,78,60,9,9,18,27,3,4,34,24,7,7,38,907,160,119,1186,140.6,135.95,2796.5593220339,1161.10169491525,20,73,93,100
"./Ship3_Latin-square/2019-09-12_11h37m_Subject 47233.txt","47233",2019-09-12,"11:37",8,80,60,8,12,20,14,2,0,16,15,5,29,49,411,44,116,571,84,138.883333333333,2566.06779661017,1272.48275862069,51,54,105,98.3606557377049
"./Ship3_Latin-square/2019-09-12_11h37m_Subject 47234.txt","47234",2019-09-12,"11:37",2,80,60,8,12,20,83,43,28,154,81,9,28,118,532,82,119,733,633.316666666667,318.566666666667,2888.06779661017,1948.5,20,98,118,98.3606557377049
"./Ship3_Latin-square/2019-09-12_11h37m_Subject 47237.txt","47237",2019-09-12,"11:37",8,78,60,10,8,18,28,5,2,35,19,19,20,58,452,62,121,635,219.35,184.716666666667,2620.25423728814,1407.1724137931,44,48,92,98.3606557377049
"./Ship3_Latin-square/2019-09-12_11h37m_Subject 47241.txt","47241",2019-09-12,"11:37",4,83,60,1,22,23,19,0,9,28,8,0,3,11,997,19,356,1372,76.1833333333333,135.55,2661,1650.81034482759,18,163,181,98.3606557377049
"./Ship3_Latin-square/2019-09-12_11h37m_Subject 47247.txt","47247",2019-09-12,"11:37",16,71,60,5,6,11,22,0,1,23,38,4,0,42,336,17,54,407,273.25,185.7,2186.38983050847,1388.63461538462,44,72,116,90.1639344262295
"./Ship3_Latin-square/2019-09-12_11h37m_Subject 47777.txt","47777",2019-09-12,"11:37",16,84,60,12,12,24,48,4,15,67,20,1,1,22,378,63,87,528,420.433333333333,212.416666666667,2159.23728813559,1714.22807017544,72,64,136,100
"./Ship3_Latin-square/2019-09-12_11h37m_Subject 47784.txt","47784",2019-09-12,"11:37",16,81,60,12,9,21,111,19,12,142,99,88,13,200,522,50,81,653,626.016666666667,281.983333333333,2294.8813559322,1244.8813559322,53,84,137,100
"./Ship3_Latin-square/2019-09-12_12h45m_Subject 46880.txt","46880",2019-09-12,"12:45",8,79,60,6,13,19,9,0,0,9,19,2,9,30,616,32,223,871,97.2333333333333,164.583333333333,2511.83050847458,2014.6,98,260,358,81.9672131147541
"./Ship3_Latin-square/2019-09-12_12h45m_Subject 46882.txt","46882",2019-09-12,"12:45",16,85,60,14,11,25,60,15,5,80,129,11,11,151,432,43,207,682,314.033333333333,461.683333333333,2267.77966101695,1707.14285714286,70,152,222,80.327868852459
"./Ship3_Latin-square/2019-09-12_12h45m_Subject 46883.txt","46883",2019-09-12,"12:45",8,79,60,11,8,19,32,2,6,40,95,31,4,130,322,56,47,425,268.083333333333,249.233333333333,2633.89830508475,1721.92307692308,54,90,144,91.8032786885246
"./Ship3_Latin-square/2019-09-12_12h45m_Subject 46894.txt","46894",2019-09-12,"12:45",24,82,56,15,11,26,67,21,15,103,31,14,14,59,211,8,94,313,601.928571428571,164.75,1928.5,2171.17073170732,81,77,158,82.4561403508772
"./Ship3_Latin-square/2019-09-12_12h45m_Subject 46896.txt","46896",2019-09-12,"12:45",4,82,60,9,13,22,26,1,7,34,64,33,17,114,701,112,145,958,206.916666666667,363.016666666667,2769.4406779661,1187.8813559322,16,37,53,100
"./Ship3_Latin-square/2019-09-12_12h45m_Subject 47088.txt","47088",2019-09-12,"12:45",2,80,60,9,11,20,44,13,6,63,100,36,38,174,676,112,113,901,205.283333333333,301.666666666667,2891.47457627119,1398.84482758621,51,133,184,98.3606557377049
"./Ship3_Latin-square/2019-09-12_12h45m_Subject 47228.txt","47228",2019-09-12,"12:45",24,83,60,10,13,23,45,7,8,60,20,18,14,52,269,18,142,429,383.45,112.633333333333,1698.18644067797,1636.44444444444,32,121,153,73.7704918032787
"./Ship3_Latin-square/2019-09-12_12h45m_Subject 47243.txt","47243",2019-09-12,"12:45",24,82,60,12,10,22,114,8,26,148,37,12,17,66,396,10,99,505,365.016666666667,191.166666666667,1820.30508474576,1227.63793103448,142,45,187,98.3606557377049
"./Ship3_Latin-square/2019-09-12_12h45m_Subject 47249.txt","47249",2019-09-12,"12:45",2,80,60,7,13,20,61,2,7,70,83,19,29,131,412,56,79,547,460.35,280.483333333333,2884.69491525424,1275.86440677966,56,49,105,100
"./Ship3_Latin-square/2019-09-12_12h45m_Subject 47639.txt","47639",2019-09-12,"12:45",24,83,60,13,10,23,37,3,8,48,42,15,9,66,444,17,104,565,215.733333333333,222.183333333333,1982.94915254237,1354.66666666667,80,67,147,90.1639344262295
"./Ship3_Latin-square/2019-09-12_12h45m_Subject 47649.txt","47649",2019-09-12,"12:45",24,85,60,13,12,25,52,15,15,82,15,4,3,22,205,10,52,267,944.75,140.583333333333,1779.61016949153,2321.72972972973,76,72,148,77.0491803278689
"./Ship3_Latin-square/2019-09-12_12h45m_Subject 47758.txt","47758",2019-09-12,"12:45",2,80,60,7,13,20,30,10,1,41,31,1,7,39,859,84,186,1129,118.35,137.4,2881.27118644068,1317.61016949153,32,63,95,100
"./Ship3_Latin-square/2019-09-12_12h45m_Subject 47759.txt","47759",2019-09-12,"12:45",2,83,60,12,11,23,33,19,9,61,72,32,16,120,616,106,131,853,339.483333333333,278.316666666667,2901.62711864407,1238.10526315789,25,71,96,98.3606557377049
"./Ship3_Latin-square/2019-09-12_12h45m_Subject 47776.txt","47776",2019-09-12,"12:45",24,69,60,8,1,9,60,1,2,63,39,11,5,55,716,14,19,749,195.55,137.916666666667,2064.32203389831,707.741379310345,51,22,73,98.3606557377049
"./Ship3_Latin-square/2019-09-12_12h45m_Subject 47799.txt","47799",2019-09-12,"12:45",2,78,60,7,11,18,25,4,3,32,75,12,19,106,942,139,177,1258,176.166666666667,269.116666666667,2884.69491525424,1026.8813559322,28,31,59,100
"./Ship3_Latin-square/2019-09-12_12h49m_Subject 46881.txt","46881",2019-09-12,"12:49",16,79,60,9,10,19,39,6,5,50,26,6,6,38,372,37,108,517,286.65,148.733333333333,2186.37288135593,1311.19298245614,32,88,120,98.3606557377049
"./Ship3_Latin-square/2019-09-12_12h49m_Subject 47087.txt","47087",2019-09-12,"12:49",16,67,50,10,7,17,47,5,7,59,39,11,3,53,226,31,28,285,1179,213.102040816327,2314.26530612245,2737.69387755102,88,35,123,100
"./Ship3_Latin-square/2019-09-12_12h49m_Subject 47626.txt","47626",2019-09-12,"12:49",8,78,58,10,10,20,85,28,19,132,44,18,52,114,288,39,45,372,992.263157894737,182.929824561404,2578.9298245614,2249.66,72,123,195,91.3793103448276
"./Ship3_Latin-square/2019-09-12_12h49m_Subject 47632.txt","47632",2019-09-12,"12:49",2,83,60,9,14,23,46,7,8,61,54,22,87,163,620,102,119,841,769,230,2881.35593220339,1568.22413793103,42,98,140,98.3606557377049
"./Ship3_Latin-square/2019-09-12_12h49m_Subject 47634.txt","47634",2019-09-12,"12:49",16,85,60,14,11,25,58,9,12,79,29,32,14,75,259,44,91,394,736.559322033898,169.779661016949,2294.86440677966,1866.78723404255,129,51,180,83.3333333333333
"./Ship3_Latin-square/2019-09-12_12h49m_Subject 47640.txt","47640",2019-09-12,"12:49",16,61,46,12,3,15,63,14,6,83,24,6,0,30,240,29,10,279,2247.35555555556,161.755555555556,2502.22222222222,1836.08333333333,80,44,124,84.7826086956522
"./Ship3_Latin-square/2019-09-12_12h49m_Subject 47754.txt","47754",2019-09-12,"12:49",24,56,44,8,4,12,81,5,10,96,45,8,39,92,100,2,20,122,3060.20454545455,307.5,1909.02272727273,4253.05263157895,28,90,118,88.8888888888889
"./Ship3_Latin-square/2019-09-12_12h49m_Subject 47800.txt","47800",2019-09-12,"12:49",4,76,60,8,8,16,81,9,12,102,68,15,16,99,371,60,42,473,680.433333333333,233.566666666667,2803.37288135593,1992.03389830508,83,60,143,100
"./Ship3_Latin-square/2019-09-12_13h51m_Subject 46876.txt","46876",2019-09-12,"13:51",8,64,45,9,10,19,42,7,11,60,26,6,17,49,248,24,53,325,1272.37777777778,777.133333333333,2545.45454545455,2404.83783783784,44,99,143,86.9565217391304
"./Ship3_Latin-square/2019-09-12_13h51m_Subject 46877.txt","46877",2019-09-12,"13:51",0,80,60,10,10,20,17,0,7,24,88,13,11,112,793,167,93,1053,157.866666666667,335.716666666667,2999.96610169492,1652.42105263158,58,131,189,96.7213114754098
"./Ship3_Latin-square/2019-09-12_13h51m_Subject 46893.txt","46893",2019-09-12,"13:51",24,79,60,11,8,19,32,0,10,42,79,15,18,112,580,17,109,706,129.316666666667,234.566666666667,1860.96610169492,915.561403508772,42,36,78,96.7213114754098
"./Ship3_Latin-square/2019-09-12_13h51m_Subject 46895.txt","46895",2019-09-12,"13:51",24,69,49,13,7,20,74,9,8,91,65,24,11,100,102,3,39,144,1366.12244897959,670.375,2099.91666666667,3244.15384615385,58,62,120,85.7142857142857
"./Ship3_Latin-square/2019-09-12_13h51m_Subject 47638.txt","47638",2019-09-12,"13:51",24,78,59,12,7,19,70,11,14,95,52,9,9,70,149,4,29,182,1196.42372881356,233.879310344828,2006.86206896552,2436.11320754717,95,43,138,91.5254237288136
"./Ship3_Latin-square/2019-09-12_13h51m_Subject 47757.txt","47757",2019-09-12,"13:51",2,75,53,8,14,22,92,16,22,130,44,8,16,68,351,56,97,504,1370.77358490566,237.88679245283,2884.61538461538,2256.42,47,184,231,96.2962962962963
"./Ship3_Latin-square/2019-09-12_13h51m_Subject 47769.txt","47769",2019-09-12,"13:51",24,74,56,13,5,18,140,35,23,198,46,22,10,78,211,8,21,240,1316.85454545455,295.872727272727,2039.96363636364,1976.49056603774,67,75,142,96.4285714285714
"./Ship3_Latin-square/2019-09-12_13h51m_Subject 47771.txt","47771",2019-09-12,"13:51",4,82,60,11,11,22,16,1,5,22,39,22,14,75,717,119,150,986,124.733333333333,203.616666666667,2796.52542372881,1481.48214285714,29,116,145,95.0819672131148
"./Ship3_Latin-square/2019-09-12_13h51m_Subject 47775.txt","47775",2019-09-12,"13:51",4,79,60,10,9,19,70,17,6,93,56,6,5,67,434,58,64,556,469.683333333333,250.083333333333,2789.74576271186,1707.64406779661,41,39,80,100
"./Ship3_Latin-square/2019-09-12_13h51m_Subject 47781.txt","47781",2019-09-12,"13:51",16,81,60,10,11,21,19,3,8,30,43,13,1,57,594,35,190,819,193.35,185.25,2213.47457627119,1521.9512195122,40,149,189,77.0491803278689
"./Ship3_Latin-square/2019-09-12_13h51m_Subject 47782.txt","47782",2019-09-12,"13:51",2,81,60,9,12,21,33,6,4,43,19,2,1,22,826,157,143,1126,161.116666666667,109.633333333333,2894.86440677966,1183.83050847458,22,82,104,100
"./Ship3_Latin-square/2019-09-12_13h51m_Subject 47783.txt","47783",2019-09-12,"13:51",16,71,53,13,5,18,87,11,10,108,140,29,6,175,241,33,27,301,1054.26923076923,1110.78846153846,2384.59615384615,1968.36170212766,86,57,143,92.4528301886792
"./Ship3_Latin-square/2019-09-12_13h51m_Subject 47785.txt","47785",2019-09-12,"13:51",16,86,60,14,12,26,34,3,7,44,31,14,13,58,427,61,105,593,225,192.2,2267.79661016949,1813.74545454545,71,95,166,96.7213114754098
"./Ship3_Latin-square/2019-09-12_13h51m_Subject 47786.txt","47786",2019-09-12,"13:51",2,77,57,9,11,20,130,7,15,152,79,14,24,117,358,59,114,531,1325.05357142857,229.178571428571,2896.39285714286,2040.2962962963,35,40,75,100
"./Ship3_Latin-square/2019-09-12_13h51m_Subject 47788.txt","47788",2019-09-12,"13:51",2,76,60,7,9,16,20,3,4,27,64,13,13,90,772,111,130,1013,153.933333333333,185.083333333333,2894.8813559322,1469.08474576271,30,34,64,100
"./Ship3_Latin-square/2019-09-12_13h59m_Subject 46888.txt","46888",2019-09-12,"13:59",4,79,60,7,12,19,19,1,1,21,66,7,8,81,960,120,207,1287,119.366666666667,199.35,2769.4406779661,1642.77586206897,47,79,126,98.3606557377049
"./Ship3_Latin-square/2019-09-12_13h59m_Subject 46889.txt","46889",2019-09-12,"13:59",16,79,60,8,11,19,33,56,2,91,18,5,11,34,795,65,260,1120,167.383333333333,123.6,2105.03389830508,1095,73,89,162,100
"./Ship3_Latin-square/2019-09-12_13h59m_Subject 46892.txt","46892",2019-09-12,"13:59",2,79,60,8,11,19,24,4,2,30,49,4,1,54,852,156,163,1171,102.216666666667,203.633333333333,2894.91525423729,1584.81355932203,77,83,160,100
"./Ship3_Latin-square/2019-09-12_13h59m_Subject 46898.txt","46898",2019-09-12,"13:59",4,80,60,7,13,20,30,5,3,38,12,2,5,19,508,44,99,651,174.683333333333,138.033333333333,2776.20338983051,2011.50980392157,48,155,203,90.1639344262295
"./Ship3_Latin-square/2019-09-12_13h59m_Subject 47097.txt","47097",2019-09-12,"13:59",16,76,60,7,9,16,19,3,7,29,63,11,13,87,558,57,68,683,364.1,205.016666666667,2159.27118644068,1289.3275862069,90,77,167,98.3606557377049
"./Ship3_Latin-square/2019-09-12_13h59m_Subject 47099.txt","47099",2019-09-12,"13:59",2,83,60,12,11,23,18,5,0,23,58,30,5,93,1564,330,336,2230,69.3833333333333,190.216666666667,2905.06779661017,1087.96610169492,62,104,166,100
"./Ship3_Latin-square/2019-09-12_13h59m_Subject 47798.txt","47798",2019-09-12,"13:59",8,84,60,11,13,24,34,2,4,40,20,8,0,28,165,29,56,250,588.516666666667,191.966666666667,2593.16949152542,2316.9375,50,56,106,90.1639344262295
"./Ship3_Latin-square/2019-09-12_15h12m_Subject 47080.txt","47080",2019-09-12,"15:12",24,83,60,12,11,23,42,5,10,57,30,8,12,50,347,12,180,539,197.566666666667,168.95,1779.62711864407,1029.60975609756,30,101,131,77.0491803278689
"./Ship3_Latin-square/2019-09-12_15h12m_Subject 47089.txt","47089",2019-09-12,"15:12",4,67,49,10,8,18,78,7,8,93,97,40,45,182,214,34,45,293,1750.41666666667,472.854166666667,2808.33333333333,2487.0243902439,103,41,144,87.7551020408163
"./Ship3_Latin-square/2019-09-12_15h12m_Subject 47762.txt","47762",2019-09-12,"15:12",24,49,36,9,4,13,88,5,14,107,21,5,2,28,85,4,12,101,2572.68571428571,413.142857142857,2108.54285714286,2414.86206896552,52,40,92,86.1111111111111
"./Ship3_Latin-square/2019-09-12_15h12m_Subject 47791.txt","47791",2019-09-12,"15:12",8,83,60,12,11,23,12,1,1,14,17,5,5,27,598,112,103,813,143.616666666667,139.816666666667,2606.76271186441,1566.41509433962,43,107,150,95.0819672131148
"./Ship3_Latin-square/2019-09-13_09h58m_Subject 46878.txt","46878",2019-09-13,"09:58",24,84,60,11,13,24,102,3,45,150,57,8,17,82,319,9,119,447,612.05,226.65,1779.62711864407,1689.05172413793,68,69,137,98.3606557377049
"./Ship3_Latin-square/2019-09-13_09h58m_Subject 46885.txt","46885",2019-09-13,"09:58",8,81,60,9,12,21,98,11,18,127,20,1,22,43,313,35,57,405,823.65,157.783333333333,2538.91525423729,1692.1724137931,54,52,106,98.3606557377049
"./Ship3_Latin-square/2019-09-13_09h58m_Subject 46899.txt","46899",2019-09-13,"09:58",16,83,60,13,10,23,95,14,31,140,57,12,13,82,400,44,94,538,669.1,273.016666666667,2267.77966101695,1400.65517241379,47,43,90,98.3606557377049
"./Ship3_Latin-square/2019-09-13_09h58m_Subject 47081.txt","47081",2019-09-13,"09:58",4,78,60,8,10,18,36,5,2,43,27,9,6,42,477,45,103,625,168.916666666667,170.466666666667,2789.76271186441,1497.5,56,57,113,96.7213114754098
"./Ship3_Latin-square/2019-09-13_09h58m_Subject 47091.txt","47091",2019-09-13,"09:58",16,79,60,6,13,19,48,4,9,61,66,14,15,95,277,21,82,380,411.683333333333,307.483333333333,2077.93220338983,1609.62711864407,58,67,125,100
"./Ship3_Latin-square/2019-09-13_09h58m_Subject 47231.txt","47231",2019-09-13,"09:58",16,75,56,11,8,19,63,13,12,88,47,34,3,84,172,16,37,225,1278,242.690909090909,2301.76363636364,2231.85106382979,48,77,125,87.5
"./Ship3_Latin-square/2019-09-13_09h58m_Subject 47238.txt","47238",2019-09-13,"09:58",4,81,60,12,9,21,16,4,2,22,45,18,15,78,501,128,81,710,144.8,199.4,2816.94915254237,1477.3275862069,56,55,111,98.3606557377049
"./Ship3_Latin-square/2019-09-13_09h58m_Subject 47242.txt","47242",2019-09-13,"09:58",4,83,60,8,15,23,54,1,6,61,125,36,26,187,695,88,217,1000,231.733333333333,322.033333333333,2755.89830508475,1286.86440677966,40,89,129,100
"./Ship3_Latin-square/2019-09-13_09h58m_Subject 47244.txt","47244",2019-09-13,"09:58",8,82,60,10,12,22,52,6,4,62,67,26,126,219,426,80,97,603,523.4,244.9,2579.64406779661,1781.37288135593,71,111,182,100
"./Ship3_Latin-square/2019-09-13_09h58m_Subject 47633.txt","47633",2019-09-13,"09:58",24,83,60,12,11,23,92,8,29,129,78,21,28,127,238,5,72,315,601.733333333333,288.533333333333,1861,1153.49152542373,56,52,108,100
"./Ship3_Latin-square/2019-09-13_09h58m_Subject 47636.txt","47636",2019-09-13,"09:58",8,74,60,7,7,14,64,9,5,78,101,13,14,128,263,22,41,326,1152.78333333333,246.266666666667,2593.18644067797,2920.98214285714,141,81,222,95.0819672131148
"./Ship3_Latin-square/2019-09-13_09h58m_Subject 47752.txt","47752",2019-09-13,"09:58",16,84,60,15,9,24,82,6,9,97,48,32,28,108,445,61,47,553,632.283333333333,164.35,2403.32203389831,1235.33333333333,77,59,136,91.8032786885246
"./Ship3_Latin-square/2019-09-13_09h58m_Subject 47767.txt","47767",2019-09-13,"09:58",4,73,52,13,8,21,88,43,4,135,121,54,81,256,232,57,48,337,859.076923076923,799.673076923077,2830.65384615385,2053.55102040816,57,90,147,96.2264150943396
"./Ship3_Latin-square/2019-09-13_09h58m_Subject 47768.txt","47768",2019-09-13,"09:58",8,78,60,10,8,18,42,4,6,52,18,6,9,33,384,69,81,534,651.316666666667,160.433333333333,2620.30508474576,2008.16981132075,96,73,169,91.8032786885246
"./Ship3_Latin-square/2019-09-13_09h58m_Subject 47780.txt","47780",2019-09-13,"09:58",0,79,60,6,13,19,53,5,17,75,53,10,9,72,415,51,101,567,449.783333333333,300.833333333333,2999.91525423729,1922.20338983051,48,45,93,100
"./Ship3_Latin-square/2019-09-13_10h03m_Subject 46884.txt","46884",2019-09-13,"10:03",16,64,45,9,10,19,52,3,20,75,31,11,3,45,146,20,25,191,1448.86666666667,803.066666666667,2199.93181818182,4209.05882352941,76,78,154,82.6086956521739
"./Ship3_Latin-square/2019-09-13_10h03m_Subject 47083.txt","47083",2019-09-13,"10:03",8,69,50,8,11,19,71,9,12,92,62,7,35,104,251,32,77,360,1623.24,288.06,2542.79591836735,2504.08888888889,98,67,165,92.156862745098
"./Ship3_Latin-square/2019-09-13_10h03m_Subject 47086.txt","47086",2019-09-13,"10:03",4,74,60,7,7,14,42,0,3,45,26,2,0,28,414,57,54,525,287.233333333333,189.716666666667,2796.52542372881,1609.20689655172,48,56,104,98.3606557377049
"./Ship3_Latin-square/2019-09-13_10h03m_Subject 47246.txt","47246",2019-09-13,"10:03",16,19,13,6,0,6,14,7,0,21,4,20,0,24,30,12,0,42,3704.75,222,2999.83333333333,1767.75,67,0,67,53.8461538461538
"./Ship3_Latin-square/2019-09-13_10h03m_Subject 47635.txt","47635",2019-09-13,"10:03",24,81,60,10,11,21,107,20,26,153,79,21,15,115,200,1,73,274,628.733333333333,289.333333333333,1820.22033898305,1571.74576271186,67,50,117,100
"./Ship3_Latin-square/2019-09-13_10h03m_Subject 47779.txt","47779",2019-09-13,"10:03",24,30,23,0,7,7,26,0,7,33,10,0,7,17,23,0,16,39,9200.72727272727,184.954545454545,1036.31818181818,8300.75,13,78,91,39.1304347826087
"./Ship3_Latin-square/2019-09-13_10h03m_Subject 47797.txt","47797",2019-09-13,"10:03",0,75,55,7,13,20,55,3,3,61,22,15,2,39,307,58,52,417,1356.59259259259,177.166666666667,2999.88888888889,2434,24,92,116,92.7272727272727
"./Ship3_Latin-square/2019-09-13_11h40m_Subject 46900.txt","46900",2019-09-13,"11:40",16,80,60,10,10,20,28,1,8,37,85,32,29,146,493,33,115,641,192.133333333333,284.45,2132.18644067797,1147.35294117647,7,161,168,91.8032786885246
"./Ship3_Latin-square/2019-09-13_11h40m_Subject 46986.txt","46986",2019-09-13,"11:40",2,43,34,7,2,9,48,12,4,64,3,10,5,18,132,57,13,202,5537.35294117647,127.382352941176,2927.18181818182,5443.48,81,26,107,82.8571428571429
"./Ship3_Latin-square/2019-09-13_11h40m_Subject 47076.txt","47076",2019-09-13,"11:40",4,74,60,8,6,14,7,0,2,9,18,3,14,35,622,112,62,796,122.4,188.816666666667,2810.13559322034,1496.96610169492,51,90,141,100
"./Ship3_Latin-square/2019-09-13_11h40m_Subject 47079.txt","47079",2019-09-13,"11:40",8,84,60,10,14,24,29,1,2,32,58,10,18,86,284,58,74,416,488.666666666667,348.716666666667,2538.91525423729,1473.64,34,81,115,88.5245901639344
"./Ship3_Latin-square/2019-09-13_11h40m_Subject 47082.txt","47082",2019-09-13,"11:40",4,57,42,7,8,15,82,16,6,104,131,34,34,199,309,59,68,436,3003.73170731707,465.09756097561,2785.31707317073,2455.15,43,37,80,100
"./Ship3_Latin-square/2019-09-13_11h40m_Subject 47092.txt","47092",2019-09-13,"11:40",8,77,60,8,9,17,15,3,3,21,39,11,8,58,676,76,121,873,115.85,184.05,2593.13559322034,1398.61016949153,64,89,153,100
"./Ship3_Latin-square/2019-09-13_11h40m_Subject 47098.txt","47098",2019-09-13,"11:40",4,83,60,9,14,23,69,9,6,84,30,35,57,122,378,34,96,508,441.75,180.716666666667,2762.67796610169,1887.28571428571,40,148,188,85.2459016393443
"./Ship3_Latin-square/2019-09-13_11h40m_Subject 47226.txt","47226",2019-09-13,"11:40",4,77,60,6,11,17,16,1,6,23,57,8,6,71,1081,131,135,1347,189.666666666667,200.016666666667,2762.66101694915,1665.21153846154,33,183,216,91.8032786885246
"./Ship3_Latin-square/2019-09-13_11h40m_Subject 47227.txt","47227",2019-09-13,"11:40",4,77,60,8,9,17,69,6,7,82,91,20,5,116,448,49,76,573,433.45,344.2,2789.76271186441,1510.51724137931,38,83,121,100
"./Ship3_Latin-square/2019-09-13_11h40m_Subject 47250.txt","47250",2019-09-13,"11:40",24,72,53,12,7,19,75,0,11,86,30,15,23,68,349,7,59,415,1536.36538461538,179.903846153846,2030.75,1460.375,37,57,94,84.9056603773585
"./Ship3_Latin-square/2019-09-13_11h40m_Subject 47645.txt","47645",2019-09-13,"11:40",2,67,48,8,11,19,108,16,16,140,45,29,32,106,259,45,57,361,1936.97916666667,230.770833333333,2891.58333333333,2928.73913043478,74,97,171,97.9591836734694
"./Ship3_Latin-square/2019-09-13_11h40m_Subject 47646.txt","47646",2019-09-13,"11:40",4,83,60,11,12,23,50,6,1,57,103,24,85,212,966,179,193,1338,511.116666666667,262.333333333333,2796.54237288136,1515.21428571429,98,100,198,95.0819672131148
"./Ship3_Latin-square/2019-09-13_11h40m_Subject 47755.txt","47755",2019-09-13,"11:40",16,78,60,11,7,18,65,13,12,90,21,14,2,37,480,65,89,634,348.783333333333,229.4,2294.8813559322,1297.22222222222,68,148,216,93.4426229508197
"./Ship3_Latin-square/2019-09-13_11h40m_Subject 47760.txt","47760",2019-09-13,"11:40",8,77,60,9,8,17,52,8,6,66,37,21,4,62,762,98,104,964,193.466666666667,150.25,2606.72881355932,987.322033898305,12,18,30,100
"./Ship3_Latin-square/2019-09-13_11h40m_Subject 47770.txt","47770",2019-09-13,"11:40",24,46,34,9,3,12,83,7,4,94,41,12,8,61,130,4,7,141,4345,392.333333333333,2199.93939393939,4786.14814814815,98,24,122,88.2352941176471
"./Ship3_Latin-square/2019-09-13_11h40m_Subject 47795.txt","47795",2019-09-13,"11:40",4,77,60,8,9,17,69,6,6,81,56,17,5,78,451,81,76,608,480.416666666667,282.133333333333,2789.79661016949,1640.46428571429,23,54,77,98.3606557377049
"./Ship3_Latin-square/2019-09-13_11h45m_Subject 47229.txt","47229",2019-09-13,"11:45",24,79,60,11,8,19,92,3,21,116,39,13,6,58,375,2,81,458,382.316666666667,196.383333333333,1901.61016949153,970.651162790698,45,95,140,80.327868852459
"./Ship3_Latin-square/2019-09-13_11h45m_Subject 47233.txt","47233",2019-09-13,"11:45",16,56,39,17,0,17,70,25,0,95,29,16,0,45,187,48,0,235,2430.15789473684,253.421052631579,2915.68421052632,4506.58333333333,195,6,201,69.2307692307692
"./Ship3_Latin-square/2019-09-13_11h45m_Subject 47234.txt","47234",2019-09-13,"11:45",4,85,60,11,14,25,31,22,10,63,46,18,8,72,585,130,135,850,228.833333333333,306.1,2776.20338983051,1241.66666666667,38,71,109,96.7213114754098
"./Ship3_Latin-square/2019-09-13_11h45m_Subject 47237.txt","47237",2019-09-13,"11:45",2,79,60,8,11,19,48,3,8,59,31,11,40,82,623,94,150,867,269.583333333333,232,2894.89830508475,1446.8275862069,20,109,129,98.3606557377049
"./Ship3_Latin-square/2019-09-13_11h45m_Subject 47241.txt","47241",2019-09-13,"11:45",0,87,60,0,27,27,23,0,1,24,7,0,5,12,1210,0,418,1628,92.1666666666667,121.183333333333,2999.94915254237,1559.1724137931,3,162,165,96.7213114754098
"./Ship3_Latin-square/2019-09-13_11h45m_Subject 47247.txt","47247",2019-09-13,"11:45",8,73,60,5,8,13,13,0,5,18,33,1,5,39,409,38,53,500,145.95,166.766666666667,2566.08474576271,1773.70588235294,42,121,163,90.1639344262295
"./Ship3_Latin-square/2019-09-13_11h45m_Subject 47777.txt","47777",2019-09-13,"11:45",4,81,60,8,13,21,46,15,9,70,10,4,12,26,522,62,93,677,405.05,184.183333333333,2769.47457627119,1883.30508474576,59,67,126,100
"./Ship3_Latin-square/2019-09-13_11h45m_Subject 47784.txt","47784",2019-09-13,"11:45",8,79,60,9,10,19,65,22,2,89,68,12,18,98,749,73,151,973,435.283333333333,221.566666666667,2579.62711864407,1238.81355932203,65,89,154,100
"./Ship3_Latin-square/2019-09-13_13h07m_Subject 46880.txt","46880",2019-09-13,"13:07",16,86,60,13,13,26,27,2,11,40,22,33,12,67,507,51,113,671,182.416666666667,169.083333333333,2213.54237288136,1560.06818181818,76,153,229,77.0491803278689
"./Ship3_Latin-square/2019-09-13_13h07m_Subject 46882.txt","46882",2019-09-13,"13:07",4,82,60,9,13,22,24,2,23,49,32,7,34,73,627,64,152,843,162.583333333333,188.7,2776.25423728814,2049.44230769231,40,174,214,95.0819672131148
"./Ship3_Latin-square/2019-09-13_13h07m_Subject 46883.txt","46883",2019-09-13,"13:07",24,74,57,10,7,17,81,3,17,101,74,18,13,105,172,4,32,208,1287.61403508772,499.660714285714,1928.5,2292.05882352941,62,48,110,92.9824561403509
"./Ship3_Latin-square/2019-09-13_13h07m_Subject 46894.txt","46894",2019-09-13,"13:07",2,77,60,8,9,17,32,3,5,40,61,11,19,91,955,120,166,1241,197.083333333333,193.216666666667,2898.20338983051,1305.54237288136,63,32,95,100
"./Ship3_Latin-square/2019-09-13_13h07m_Subject 46896.txt","46896",2019-09-13,"13:07",8,79,60,10,9,19,22,0,2,24,32,2,6,40,739,111,173,1023,148.85,169.05,2606.76271186441,1079.5593220339,22,29,51,100
"./Ship3_Latin-square/2019-09-13_13h07m_Subject 47088.txt","47088",2019-09-13,"13:07",0,83,60,6,17,23,24,2,2,28,83,4,23,110,1174,141,284,1599,101.55,308,2999.91525423729,1353.06779661017,53,135,188,100
"./Ship3_Latin-square/2019-09-13_13h07m_Subject 47228.txt","47228",2019-09-13,"13:07",2,79,60,4,15,19,29,3,5,37,34,4,26,64,478,40,102,620,490.083333333333,141.75,2864.33898305085,1780.16071428571,21,86,107,95.0819672131148
"./Ship3_Latin-square/2019-09-13_13h07m_Subject 47243.txt","47243",2019-09-13,"13:07",2,83,60,11,12,23,43,9,7,59,57,17,8,82,836,140,188,1164,247.516666666667,236.7,2891.50847457627,1212.30508474576,116,62,178,100
"./Ship3_Latin-square/2019-09-13_13h07m_Subject 47249.txt","47249",2019-09-13,"13:07",0,79,60,8,11,19,74,3,11,88,81,16,35,132,356,38,64,458,408.4,211.583333333333,2999.8813559322,1592.1186440678,71,33,104,100
"./Ship3_Latin-square/2019-09-13_13h07m_Subject 47639.txt","47639",2019-09-13,"13:07",2,83,60,10,13,23,19,1,3,23,5,0,6,11,874,152,177,1203,118.15,110.666666666667,2891.52542372881,1608.28813559322,56,102,158,100
"./Ship3_Latin-square/2019-09-13_13h07m_Subject 47649.txt","47649",2019-09-13,"13:07",16,82,60,11,11,22,45,1,8,54,30,2,24,56,300,26,62,388,851.25,155.283333333333,2186.35593220339,1976.94594594595,82,122,204,77.0491803278689
"./Ship3_Latin-square/2019-09-13_13h07m_Subject 47758.txt","47758",2019-09-13,"13:07",0,78,60,6,12,18,7,12,1,20,26,3,14,43,933,101,196,1230,71.85,130.2,2999.8813559322,1432.83050847458,43,60,103,100
"./Ship3_Latin-square/2019-09-13_13h07m_Subject 47759.txt","47759",2019-09-13,"13:07",0,83,60,11,12,23,10,3,2,15,23,36,2,61,759,154,152,1065,102.316666666667,171.933333333333,2999.93220338983,1370.85964912281,35,58,93,98.3606557377049
"./Ship3_Latin-square/2019-09-13_13h07m_Subject 47776.txt","47776",2019-09-13,"13:07",2,78,60,10,8,18,64,22,12,98,21,8,5,34,416,67,104,587,843.766666666667,142.2,2908.40677966102,1792.76271186441,33,40,73,100
"./Ship3_Latin-square/2019-09-13_13h07m_Subject 47799.txt","47799",2019-09-13,"13:07",0,82,60,9,13,22,20,3,1,24,89,21,22,132,901,95,183,1179,157.416666666667,253.033333333333,2999.8813559322,1472.40677966102,32,58,90,100
"./Ship3_Latin-square/2019-09-13_13h12m_Subject 46881.txt","46881",2019-09-13,"13:12",4,72,60,4,8,12,43,1,5,49,46,2,1,49,486,39,63,588,321.583333333333,252.516666666667,2769.45762711864,1460.625,26,123,149,96.7213114754098
"./Ship3_Latin-square/2019-09-13_13h12m_Subject 47087.txt","47087",2019-09-13,"13:12",4,79,60,8,11,19,75,21,5,101,39,32,5,76,368,44,64,476,446.516666666667,152.083333333333,2782.98305084746,1996.8275862069,86,65,151,98.3606557377049
"./Ship3_Latin-square/2019-09-13_13h12m_Subject 47626.txt","47626",2019-09-13,"13:12",16,81,60,11,10,21,70,6,4,80,67,10,7,84,283,36,57,376,572.816666666667,234.7,2159.25423728814,1856.08474576271,81,59,140,100
"./Ship3_Latin-square/2019-09-13_13h12m_Subject 47632.txt","47632",2019-09-13,"13:12",16,79,60,13,6,19,45,13,21,79,25,27,6,58,446,49,70,565,471.433333333333,146.166666666667,2322,1352.92857142857,74,70,144,95.0819672131148
"./Ship3_Latin-square/2019-09-13_13h12m_Subject 47634.txt","47634",2019-09-13,"13:12",4,87,60,12,15,27,49,7,12,68,26,19,38,83,386,71,97,554,603.266666666667,205.266666666667,2783.01694915254,1431.87931034483,74,44,118,100
"./Ship3_Latin-square/2019-09-13_13h12m_Subject 47640.txt","47640",2019-09-13,"13:12",4,80,57,12,11,23,64,11,8,83,23,23,14,60,525,109,130,764,1345.33333333333,145.446428571429,2799.92857142857,1662.03773584906,57,74,131,96.4912280701754
"./Ship3_Latin-square/2019-09-13_13h12m_Subject 47754.txt","47754",2019-09-13,"13:12",2,59,44,7,8,15,50,4,4,58,29,8,50,87,344,40,79,463,3136.34090909091,246.772727272727,2897.58139534884,3434.02631578947,32,128,160,93.3333333333333
"./Ship3_Latin-square/2019-09-13_13h12m_Subject 47800.txt","47800",2019-09-13,"13:12",24,80,60,9,11,20,79,6,21,106,83,12,31,126,164,0,75,239,629.75,270.7,1738.94915254237,1689.7,51,107,158,85.2459016393443
"./Ship3_Latin-square/2019-09-13_14h22m_Subject 46876.txt","46876",2019-09-13,"14:22",16,36,27,9,0,9,26,11,0,37,4,31,0,35,156,21,0,177,2185.30769230769,92.4615384615385,2692.26923076923,7251.29166666667,35,14,49,92.5925925925926
"./Ship3_Latin-square/2019-09-13_14h22m_Subject 46877.txt","46877",2019-09-13,"14:22",8,81,60,11,10,21,19,0,2,21,83,10,13,106,966,111,224,1301,100.683333333333,232.933333333333,2606.67796610169,1146.49152542373,41,145,186,98.3606557377049
"./Ship3_Latin-square/2019-09-13_14h22m_Subject 46893.txt","46893",2019-09-13,"14:22",2,80,60,8,12,20,20,2,0,22,64,7,6,77,990,144,233,1367,76.9166666666667,241.566666666667,2891.49152542373,1575.35593220339,52,115,167,100
"./Ship3_Latin-square/2019-09-13_14h22m_Subject 46895.txt","46895",2019-09-13,"14:22",16,65,47,11,7,18,38,14,3,55,65,12,10,87,115,11,32,158,1599,637.95652173913,2373.84782608696,3610.93103448276,47,78,125,74.468085106383
"./Ship3_Latin-square/2019-09-13_14h22m_Subject 47638.txt","47638",2019-09-13,"14:22",2,79,57,11,11,22,66,11,10,87,28,13,31,72,304,39,65,408,1092.66666666667,217.824561403509,2899.89285714286,2066.48076923077,79,49,128,94.8275862068966
"./Ship3_Latin-square/2019-09-13_14h22m_Subject 47757.txt","47757",2019-09-13,"14:22",0,67,49,7,11,18,76,10,10,96,57,16,9,82,270,46,67,383,1672.10204081633,396.387755102041,2999.97916666667,2942.94736842105,48,163,211,84
"./Ship3_Latin-square/2019-09-13_14h22m_Subject 47769.txt","47769",2019-09-13,"14:22",2,83,60,15,8,23,21,8,1,30,51,25,10,86,629,116,111,856,251,319.616666666667,2922,1703.85714285714,103,60,163,98.3606557377049
"./Ship3_Latin-square/2019-09-13_14h22m_Subject 47771.txt","47771",2019-09-13,"14:22",24,84,60,16,8,24,72,13,6,91,21,24,4,49,306,8,50,364,359.383333333333,134.516666666667,2064.37288135593,1483.36363636364,51,59,110,80.327868852459
"./Ship3_Latin-square/2019-09-13_14h22m_Subject 47775.txt","47775",2019-09-13,"14:22",24,81,60,14,7,21,124,30,18,172,40,12,4,56,227,0,51,278,822.3,153.166666666667,2023.67796610169,1389.79310344828,41,38,79,96.7213114754098
"./Ship3_Latin-square/2019-09-13_14h22m_Subject 47781.txt","47781",2019-09-13,"14:22",4,81,60,5,16,21,87,9,12,108,29,4,22,55,472,46,186,704,729.183333333333,164.816666666667,2721.96610169492,2213.47368421053,34,95,129,96.7213114754098
"./Ship3_Latin-square/2019-09-13_14h22m_Subject 47782.txt","47782",2019-09-13,"14:22",0,78,60,6,12,18,25,2,1,28,20,6,5,31,803,97,184,1084,145.75,112.7,2999.91525423729,1323.18644067797,17,41,58,100
"./Ship3_Latin-square/2019-09-13_14h22m_Subject 47783.txt","47783",2019-09-13,"14:22",4,73,53,10,10,20,87,7,15,109,66,22,27,115,387,115,75,577,1396.45283018868,369.641509433962,2784.61538461538,2215.10204081633,61,94,155,94.4444444444444
"./Ship3_Latin-square/2019-09-13_14h22m_Subject 47785.txt","47785",2019-09-13,"14:22",4,80,60,9,11,20,42,4,5,51,43,1,13,57,642,198,103,943,439.6,205.516666666667,2796.61016949153,1703.65384615385,84,95,179,91.8032786885246
"./Ship3_Latin-square/2019-09-13_14h22m_Subject 47786.txt","47786",2019-09-13,"14:22",4,73,51,7,15,22,77,6,20,103,21,8,17,46,437,55,120,612,1808.37254901961,128.294117647059,2759.98,2009.64705882353,39,38,77,100
"./Ship3_Latin-square/2019-09-13_14h22m_Subject 47788.txt","47788",2019-09-13,"14:22",0,79,60,7,12,19,38,3,8,49,76,19,10,105,771,90,145,1006,267.766666666667,202.433333333333,2999.91525423729,1442.16949152542,37,45,82,98.3606557377049
"./Ship3_Latin-square/2019-09-13_14h25m_Subject 46888.txt","46888",2019-09-13,"14:25",24,84,60,15,9,24,26,13,3,42,62,44,14,120,291,21,66,378,229.416666666667,232.666666666667,2023.71186440678,1461.21568627451,77,56,133,86.8852459016393
"./Ship3_Latin-square/2019-09-13_14h25m_Subject 46889.txt","46889",2019-09-13,"14:25",8,79,60,9,10,19,26,1,0,27,44,6,4,54,878,167,195,1240,148.916666666667,209.683333333333,2579.5593220339,1735.01818181818,74,211,285,93.4426229508197
"./Ship3_Latin-square/2019-09-13_14h25m_Subject 46892.txt","46892",2019-09-13,"14:25",0,77,60,6,11,17,40,0,3,43,34,7,1,42,868,106,144,1118,216.5,170.883333333333,2999.89830508475,1630.60344827586,64,128,192,98.3606557377049
"./Ship3_Latin-square/2019-09-13_14h25m_Subject 46898.txt","46898",2019-09-13,"14:25",0,76,60,5,11,16,21,0,5,26,6,0,32,38,530,62,82,674,198.9,121.466666666667,2999.86440677966,1865.69642857143,36,128,164,95.0819672131148
"./Ship3_Latin-square/2019-09-13_14h25m_Subject 47097.txt","47097",2019-09-13,"14:25",4,81,60,12,9,21,75,28,3,106,76,52,7,135,562,122,72,756,304.233333333333,327.883333333333,2810.15254237288,1659.07142857143,79,81,160,98.3606557377049
"./Ship3_Latin-square/2019-09-13_14h25m_Subject 47099.txt","47099",2019-09-13,"14:25",0,80,60,8,12,20,25,1,0,26,23,8,20,51,793,125,188,1106,167.666666666667,162.616666666667,2999.8813559322,1680.03571428571,69,63,132,96.7213114754098
"./Ship3_Latin-square/2019-09-13_14h25m_Subject 47798.txt","47798",2019-09-13,"14:25",24,50,39,11,0,11,49,11,0,60,33,29,0,62,96,8,0,104,3158.30769230769,738.615384615385,2446.12820512821,1897.4375,56,26,82,82.5
"./Ship3_Latin-square/2019-09-13_15h38m_Subject 47080.txt","47080",2019-09-13,"15:38",2,84,60,8,16,24,17,4,4,25,21,5,4,30,726,78,271,1075,129.283333333333,174.15,2877.96610169492,1664.83333333333,52,233,285,93.4426229508197
"./Ship3_Latin-square/2019-09-13_15h38m_Subject 47089.txt","47089",2019-09-13,"15:38",24,58,41,13,4,17,83,11,16,110,68,25,7,100,122,0,3,125,2090.14634146341,610.658536585366,2297.51219512195,2662.66666666667,73,39,112,88.0952380952381
"./Ship3_Latin-square/2019-09-13_15h38m_Subject 47762.txt","47762",2019-09-13,"15:38",16,57,40,7,10,17,75,11,22,108,10,2,8,20,85,20,25,130,3369.475,121.725,2079.925,3917.8064516129,48,71,119,80.4878048780488
"./Ship3_Latin-square/2019-09-13_15h38m_Subject 47791.txt","47791",2019-09-13,"15:38",16,83,60,15,8,23,17,6,2,25,24,7,2,33,461,72,109,642,362.6,176.483333333333,2322,1622.20408163265,30,124,154,88.5245901639344
"./Ship3_Latin-square/2019-09-14_13h36m_Subject 46881.txt","46881",2019-09-14,"13:36",24,81,60,13,8,21,109,14,15,138,48,13,7,68,293,9,70,372,500.233333333333,168.516666666667,1901.64406779661,986.859649122807,16,46,62,96.7213114754098
"./Ship3_Latin-square/2019-09-14_13h36m_Subject 47087.txt","47087",2019-09-14,"13:36",24,74,51,10,13,23,107,6,35,148,47,20,28,95,154,2,69,225,883.98,240.9,1655.98,1751.14285714286,45,147,192,74.5098039215686
"./Ship3_Latin-square/2019-09-14_13h36m_Subject 47626.txt","47626",2019-09-14,"13:36",4,80,60,10,10,20,61,16,14,91,39,6,3,48,297,54,50,401,511.833333333333,140.5,2810.10169491525,1986.68,73,80,153,91.8032786885246
"./Ship3_Latin-square/2019-09-14_13h36m_Subject 47632.txt","47632",2019-09-14,"13:36",0,80,60,8,12,20,40,3,5,48,40,55,19,114,693,75,189,957,513.6,179.733333333333,2999.93220338983,1418.18644067797,34,113,147,100
"./Ship3_Latin-square/2019-09-14_13h36m_Subject 47634.txt","47634",2019-09-14,"13:36",24,81,60,13,8,21,101,10,14,125,36,11,8,55,184,6,30,220,850.783333333333,218.616666666667,2023.66101694915,2067.75925925926,102,53,155,91.8032786885246
"./Ship3_Latin-square/2019-09-14_13h36m_Subject 47640.txt","47640",2019-09-14,"13:36",24,62,44,12,6,18,93,15,13,121,37,20,3,60,133,4,33,170,1784,924.5,2127.20454545455,2126.35135135135,79,30,109,84.4444444444444
"./Ship3_Latin-square/2019-09-14_13h36m_Subject 47754.txt","47754",2019-09-14,"13:36",0,57,40,4,13,17,49,26,7,82,48,2,56,106,295,28,83,406,2549.75,247.6,2999.9,2518.27027027027,12,134,146,95.1219512195122
"./Ship3_Latin-square/2019-09-14_13h36m_Subject 47800.txt","47800",2019-09-14,"13:36",2,81,60,9,12,21,94,11,23,128,117,17,23,157,505,80,112,697,486.716666666667,284.8,2884.67796610169,1599.08474576271,58,100,158,100
"./Ship3_Latin-square/2019-09-14_13h38m_Subject 46880.txt","46880",2019-09-14,"13:38",4,79,60,8,11,19,23,3,3,29,54,25,11,90,709,88,172,969,174.15,231.566666666667,2776.22033898305,1910.64814814815,57,243,300,91.8032786885246
"./Ship3_Latin-square/2019-09-14_13h38m_Subject 46882.txt","46882",2019-09-14,"13:38",24,84,60,14,10,24,72,13,9,94,26,81,6,113,323,6,185,514,429.533333333333,175.316666666667,1983.03389830508,1420.06976744186,36,85,121,81.9672131147541
"./Ship3_Latin-square/2019-09-14_13h38m_Subject 46883.txt","46883",2019-09-14,"13:38",16,80,57,14,9,23,89,15,18,122,64,27,35,126,239,33,39,311,852.929824561404,346.070175438596,2326.28070175439,1984.07142857143,67,36,103,98.2758620689655
"./Ship3_Latin-square/2019-09-14_13h38m_Subject 46894.txt","46894",2019-09-14,"13:38",0,79,60,5,14,19,59,3,11,73,27,1,6,34,522,40,99,661,1035.76666666667,152.95,2999.91525423729,1475.61016949153,46,23,69,100
"./Ship3_Latin-square/2019-09-14_13h38m_Subject 46896.txt","46896",2019-09-14,"13:38",2,78,60,7,11,18,34,3,2,39,46,13,7,66,764,100,175,1039,222.65,278.283333333333,2888.1186440678,1189.6724137931,18,34,52,98.3606557377049
"./Ship3_Latin-square/2019-09-14_13h38m_Subject 47088.txt","47088",2019-09-14,"13:38",24,81,60,11,10,21,86,14,24,124,80,22,23,125,269,0,76,345,490.283333333333,296.1,1901.66101694915,1153,75,70,145,85.2459016393443
"./Ship3_Latin-square/2019-09-14_13h38m_Subject 47228.txt","47228",2019-09-14,"13:38",0,80,60,9,11,20,34,3,6,43,30,6,7,43,568,66,97,731,372.483333333333,118.583333333333,2999.89830508475,1384.58928571429,24,72,96,96.7213114754098
"./Ship3_Latin-square/2019-09-14_13h38m_Subject 47243.txt","47243",2019-09-14,"13:38",0,82,60,10,12,22,60,5,4,69,19,24,6,49,820,149,150,1119,370.766666666667,151.35,2999.86440677966,1338.66101694915,124,57,181,100
"./Ship3_Latin-square/2019-09-14_13h38m_Subject 47249.txt","47249",2019-09-14,"13:38",24,41,30,9,2,11,37,12,10,59,45,100,5,150,123,11,14,148,660.2,365.9,2359.93333333333,1726.42857142857,65,17,82,93.5483870967742
"./Ship3_Latin-square/2019-09-14_13h38m_Subject 47639.txt","47639",2019-09-14,"13:38",0,83,60,8,15,23,18,2,0,20,9,0,14,23,900,118,216,1234,136.533333333333,128.516666666667,2999.91525423729,1550.06779661017,34,100,134,100
"./Ship3_Latin-square/2019-09-14_13h38m_Subject 47649.txt","47649",2019-09-14,"13:38",8,75,57,8,10,18,84,18,9,111,25,6,19,50,250,36,56,342,1429.28571428571,261.910714285714,2571.375,3230.66666666667,85,117,202,82.4561403508772
"./Ship3_Latin-square/2019-09-14_13h38m_Subject 47758.txt","47758",2019-09-14,"13:38",24,80,60,12,8,20,129,2,23,154,65,19,5,89,298,1,73,372,761.133333333333,436.1,1901.66101694915,1325.76785714286,46,56,102,96.7213114754098
"./Ship3_Latin-square/2019-09-14_13h38m_Subject 47759.txt","47759",2019-09-14,"13:38",24,77,60,8,9,17,50,6,10,66,33,10,9,52,235,1,84,320,368.783333333333,161.216666666667,1820.32203389831,1228.82352941176,39,46,85,90.1639344262295
"./Ship3_Latin-square/2019-09-14_13h38m_Subject 47776.txt","47776",2019-09-14,"13:38",0,78,60,6,12,18,18,2,3,23,64,11,17,92,1162,133,184,1479,94.2166666666667,174.433333333333,2999.89830508475,1454.71186440678,49,93,142,100
"./Ship3_Latin-square/2019-09-14_13h38m_Subject 47799.txt","47799",2019-09-14,"13:38",24,83,60,14,9,23,83,13,16,112,49,34,8,91,237,0,71,308,597.216666666667,247.566666666667,1983.01694915254,1379.05357142857,47,23,70,95.0819672131148
"./Ship3_Latin-square/2019-09-14_14h53m_Subject 46888.txt","46888",2019-09-14,"14:53",2,74,60,4,10,14,17,0,4,21,115,6,13,134,638,29,136,803,129.166666666667,277.35,2881.33898305085,1905.03571428571,67,77,144,96.7213114754098
"./Ship3_Latin-square/2019-09-14_14h53m_Subject 46889.txt","46889",2019-09-14,"14:53",16,76,60,11,5,16,28,13,5,46,15,3,0,18,696,81,103,880,166.633333333333,127.55,2294.91525423729,1261.10638297872,66,129,195,83.6065573770492
"./Ship3_Latin-square/2019-09-14_14h53m_Subject 46890.txt","46890",2019-09-14,"14:53",4,82,60,9,13,22,45,8,7,60,6,2,15,23,252,36,63,351,927.916666666667,170.166666666667,2776.18644067797,2350.93181818182,48,123,171,80.327868852459
"./Ship3_Latin-square/2019-09-14_14h53m_Subject 46892.txt","46892",2019-09-14,"14:53",24,86,60,16,10,26,27,6,7,40,52,16,5,73,386,15,99,500,169.783333333333,275.466666666667,1982.98305084746,1441.61904761905,46,103,149,80.327868852459
"./Ship3_Latin-square/2019-09-14_14h53m_Subject 46898.txt","46898",2019-09-14,"14:53",8,79,60,10,9,19,21,5,6,32,14,4,2,20,503,55,81,639,193.95,149.716666666667,2593.16949152542,1822.25925925926,52,121,173,95.0819672131148
"./Ship3_Latin-square/2019-09-14_14h53m_Subject 47097.txt","47097",2019-09-14,"14:53",24,84,60,13,11,24,98,26,46,170,105,32,22,159,279,0,131,410,728.95,296.316666666667,1860.94915254237,1326.53448275862,66,63,129,100
"./Ship3_Latin-square/2019-09-14_14h53m_Subject 47099.txt","47099",2019-09-14,"14:53",24,82,60,12,10,22,16,1,9,26,26,8,6,40,505,3,114,622,139.466666666667,157.466666666667,1901.66101694915,1131.325,42,64,106,73.7704918032787
"./Ship3_Latin-square/2019-09-14_14h53m_Subject 47798.txt","47798",2019-09-14,"14:53",16,49,35,8,6,14,77,10,10,97,53,12,10,75,83,15,27,125,3392.23529411765,1055.64705882353,2246.97058823529,3485.48148148148,23,65,88,85.7142857142857
"./Ship3_Latin-square/2019-09-14_14h56m_Subject 46876.txt","46876",2019-09-14,"14:56",4,62,45,9,8,17,112,30,6,148,8,8,1,17,405,59,116,580,573.727272727273,107.568181818182,2809,1262.09523809524,24,47,71,100
"./Ship3_Latin-square/2019-09-14_14h56m_Subject 46877.txt","46877",2019-09-14,"14:56",24,85,60,14,11,25,44,2,20,66,69,179,96,344,618,13,175,806,204.733333333333,259.7,1942.30508474576,870.357142857143,43,123,166,78.6885245901639
"./Ship3_Latin-square/2019-09-14_14h56m_Subject 46893.txt","46893",2019-09-14,"14:56",0,74,60,6,8,14,3,0,1,4,30,7,3,40,1187,126,155,1468,59.7833333333333,155.316666666667,2999.94915254237,1550.57627118644,69,98,167,100
"./Ship3_Latin-square/2019-09-14_14h56m_Subject 46895.txt","46895",2019-09-14,"14:56",8,78,55,10,13,23,57,6,8,71,63,6,36,105,263,37,83,383,1161.05454545455,380.836363636364,2570.35185185185,2073.51923076923,39,76,115,96.4285714285714
"./Ship3_Latin-square/2019-09-14_14h56m_Subject 47638.txt","47638",2019-09-14,"14:56",0,80,58,12,10,22,63,10,13,86,39,23,63,125,253,73,42,368,868.465517241379,185.034482758621,2999.9649122807,2537.82692307692,55,45,100,91.5254237288136
"./Ship3_Latin-square/2019-09-14_14h56m_Subject 47757.txt","47757",2019-09-14,"14:56",24,63,45,16,2,18,108,41,2,151,43,73,3,119,189,23,7,219,1622.02222222222,284.755555555556,2413.26666666667,1298.60526315789,64,59,123,84.7826086956522
"./Ship3_Latin-square/2019-09-14_14h56m_Subject 47769.txt","47769",2019-09-14,"14:56",0,82,60,11,11,22,47,9,6,62,32,7,17,56,455,73,115,643,564.516666666667,143.55,2999.8813559322,1731.05172413793,56,62,118,100
"./Ship3_Latin-square/2019-09-14_14h56m_Subject 47771.txt","47771",2019-09-14,"14:56",2,82,60,8,14,22,19,7,2,28,33,35,6,74,729,58,161,948,243.883333333333,165.316666666667,2881.33898305085,1745.64912280702,26,153,179,96.7213114754098
"./Ship3_Latin-square/2019-09-14_14h56m_Subject 47775.txt","47775",2019-09-14,"14:56",2,76,60,6,10,16,52,0,19,71,15,19,3,37,551,51,98,700,362.133333333333,116.95,2884.66101694915,1469.18644067797,35,66,101,98.3606557377049
"./Ship3_Latin-square/2019-09-14_14h56m_Subject 47781.txt","47781",2019-09-14,"14:56",24,80,60,10,10,20,26,2,5,33,80,11,20,111,382,3,118,503,274.65,284.45,1860.94915254237,1077.84,44,72,116,85.2459016393443
"./Ship3_Latin-square/2019-09-14_14h56m_Subject 47782.txt","47782",2019-09-14,"14:56",24,82,60,9,13,22,66,4,23,93,15,11,14,40,240,2,94,336,402.683333333333,102.1,1657.59322033898,1057.71794871795,16,81,97,72.1311475409836
"./Ship3_Latin-square/2019-09-14_14h56m_Subject 47783.txt","47783",2019-09-14,"14:56",24,76,59,12,5,17,102,14,16,132,66,1,3,70,328,10,80,418,1387.13793103448,230.98275862069,2006.8275862069,1982.48148148148,71,44,115,94.9152542372881
"./Ship3_Latin-square/2019-09-14_14h56m_Subject 47785.txt","47785",2019-09-14,"14:56",24,84,60,13,11,24,72,6,20,98,61,16,19,96,299,3,142,444,340.433333333333,244.55,1860.98305084746,1546.55102040816,76,68,144,83.6065573770492
"./Ship3_Latin-square/2019-09-14_14h56m_Subject 47786.txt","47786",2019-09-14,"14:56",0,79,57,6,16,22,76,6,21,103,21,12,12,45,391,53,76,520,1152.26315789474,121,2999.89473684211,2483.71929824561,29,36,65,100
"./Ship3_Latin-square/2019-09-14_14h56m_Subject 47788.txt","47788",2019-09-14,"14:56",24,80,59,15,6,21,101,14,17,132,75,28,9,112,283,0,29,312,947.389830508475,341.64406779661,2145.72881355932,1234,47,76,123,86.6666666666667
"./Ship3_Latin-square/2019-09-16_09h40m_Subject 46878.txt","46878",2019-09-16,"09:40",16,82,60,12,10,22,42,1,33,76,22,5,58,85,522,49,171,742,227.383333333333,174.033333333333,2213.49152542373,1684.10344827586,93,102,195,96.7213114754098
"./Ship3_Latin-square/2019-09-16_09h40m_Subject 46885.txt","46885",2019-09-16,"09:40",16,74,53,14,7,21,89,21,6,116,19,8,2,29,230,33,33,296,1839.54716981132,185.490566037736,2353.80769230769,2260.85416666667,80,44,124,92.5925925925926
"./Ship3_Latin-square/2019-09-16_09h40m_Subject 46899.txt","46899",2019-09-16,"09:40",8,80,60,12,8,20,35,8,9,52,35,9,12,56,658,88,119,865,285.633333333333,155.816666666667,2620.33898305085,1117.10344827586,46,42,88,100
"./Ship3_Latin-square/2019-09-16_09h40m_Subject 47081.txt","47081",2019-09-16,"09:40",0,75,60,4,11,15,31,0,2,33,35,7,22,64,490,28,72,590,208.716666666667,209.483333333333,2999.8813559322,1756.12280701754,41,74,115,96.7213114754098
"./Ship3_Latin-square/2019-09-16_09h40m_Subject 47091.txt","47091",2019-09-16,"09:40",8,81,60,11,10,21,42,13,2,57,70,17,33,120,271,47,60,378,640.833333333333,250.1,2579.62711864407,2004.22807017544,68,100,168,98.3606557377049
"./Ship3_Latin-square/2019-09-16_09h40m_Subject 47231.txt","47231",2019-09-16,"09:40",8,80,57,10,13,23,115,11,12,138,88,20,17,125,226,29,75,330,1070.14035087719,249.684210526316,2550.82456140351,1709.1914893617,24,87,111,91.3793103448276
"./Ship3_Latin-square/2019-09-16_09h40m_Subject 47238.txt","47238",2019-09-16,"09:40",24,80,60,12,8,20,45,1,6,52,44,24,15,83,345,11,65,421,309.083333333333,199.766666666667,2023.69491525424,850.651162790698,71,79,150,77.0491803278689
"./Ship3_Latin-square/2019-09-16_09h40m_Subject 47242.txt","47242",2019-09-16,"09:40",24,79,60,9,10,19,91,5,11,107,64,14,48,126,349,10,115,474,395.283333333333,198.016666666667,1738.89830508475,1014.34,33,111,144,85.2459016393443
"./Ship3_Latin-square/2019-09-16_09h40m_Subject 47244.txt","47244",2019-09-16,"09:40",16,83,60,14,9,23,22,5,1,28,79,25,20,124,447,59,76,582,314.666666666667,297.716666666667,2321.98305084746,1553.34545454545,106,83,189,95.0819672131148
"./Ship3_Latin-square/2019-09-16_09h40m_Subject 47633.txt","47633",2019-09-16,"09:40",16,80,60,10,10,20,57,8,18,83,67,20,16,103,239,33,70,342,755.016666666667,207.733333333333,2213.42372881356,1828.4,66,73,139,93.4426229508197
"./Ship3_Latin-square/2019-09-16_09h40m_Subject 47636.txt","47636",2019-09-16,"09:40",24,48,35,12,1,13,90,22,0,112,126,31,3,160,151,12,1,164,1950.34285714286,734.735294117647,2505.85294117647,2374.5,104,16,120,100
"./Ship3_Latin-square/2019-09-16_09h40m_Subject 47752.txt","47752",2019-09-16,"09:40",8,77,60,7,10,17,69,7,7,83,30,11,8,49,493,29,105,627,686.766666666667,127.033333333333,2566.05084745763,1718.12068965517,61,72,133,98.3606557377049
"./Ship3_Latin-square/2019-09-16_09h40m_Subject 47767.txt","47767",2019-09-16,"09:40",24,74,58,13,3,16,105,12,6,123,31,17,4,52,148,7,6,161,1593.6724137931,238.51724137931,2213.70689655172,2144.86274509804,55,38,93,89.8305084745763
"./Ship3_Latin-square/2019-09-16_09h40m_Subject 47768.txt","47768",2019-09-16,"09:40",24,72,52,13,7,20,75,8,16,99,33,5,8,46,258,5,19,282,1463.82692307692,182.403846153846,2105.72549019608,1852.97674418605,84,47,131,84.9056603773585
"./Ship3_Latin-square/2019-09-16_09h40m_Subject 47780.txt","47780",2019-09-16,"09:40",8,84,60,10,14,24,59,10,10,79,68,10,16,94,343,41,96,480,600.35,345.283333333333,2552.50847457627,2137.03389830508,57,75,132,98.3606557377049
"./Ship3_Latin-square/2019-09-16_09h43m_Subject 46884.txt","46884",2019-09-16,"09:43",4,76,56,11,9,20,105,5,8,118,49,1,84,134,191,47,41,279,1148.80357142857,413.857142857143,2825.4,3462.86046511628,85,106,191,84.2105263157895
"./Ship3_Latin-square/2019-09-16_09h43m_Subject 47083.txt","47083",2019-09-16,"09:43",16,80,58,11,11,22,87,7,10,104,48,8,19,75,288,27,92,407,1080.89655172414,227.051724137931,2185.91228070175,2292.53191489362,129,94,223,86.2068965517241
"./Ship3_Latin-square/2019-09-16_09h43m_Subject 47086.txt","47086",2019-09-16,"09:43",0,79,60,8,11,19,17,4,4,25,41,13,3,57,406,64,71,541,279.666666666667,206.666666666667,2999.94915254237,1690.89090909091,52,73,125,95.0819672131148
"./Ship3_Latin-square/2019-09-16_09h43m_Subject 47246.txt","47246",2019-09-16,"09:43",4,86,60,9,17,26,57,9,2,68,25,7,23,55,404,59,120,583,449.133333333333,222.316666666667,2749.06779661017,1934.66037735849,57,114,171,95.0819672131148
"./Ship3_Latin-square/2019-09-16_09h43m_Subject 47635.txt","47635",2019-09-16,"09:43",16,83,60,11,12,23,49,5,8,62,50,12,15,77,387,51,128,566,343.683333333333,198.283333333333,2186.38983050847,1325.62068965517,39,47,86,100
"./Ship3_Latin-square/2019-09-16_09h43m_Subject 47779.txt","47779",2019-09-16,"09:43",16,49,35,9,5,14,30,6,9,45,61,22,15,98,82,12,13,107,2083.58823529412,431.235294117647,2341.08823529412,5905.04545454545,79,39,118,68.5714285714286
"./Ship3_Latin-square/2019-09-16_09h43m_Subject 47797.txt","47797",2019-09-16,"09:43",8,51,38,8,5,13,44,2,6,52,27,14,5,46,154,41,28,223,3203.51351351351,242,2654,2531.45714285714,14,41,55,97.3684210526316
"./Ship3_Latin-square/2019-09-16_10h57m_Subject 46900.txt","46900",2019-09-16,"10:57",4,80,60,9,11,20,20,7,4,31,106,57,12,175,763,129,181,1073,188.016666666667,302.333333333333,2789.79661016949,1158.38983050847,22,90,112,100
"./Ship3_Latin-square/2019-09-16_10h57m_Subject 46986.txt","46986",2019-09-16,"10:57",4,80,60,12,8,20,51,10,9,70,15,14,5,34,351,64,52,467,618.1,133.466666666667,2823.69491525424,2038.6,110,44,154,95.0819672131148
"./Ship3_Latin-square/2019-09-16_10h57m_Subject 47076.txt","47076",2019-09-16,"10:57",24,83,60,16,7,23,28,2,5,35,59,35,11,105,365,17,76,458,181.633333333333,257.8,2105.06779661017,1345.44897959184,79,79,158,85.2459016393443
"./Ship3_Latin-square/2019-09-16_10h57m_Subject 47079.txt","47079",2019-09-16,"10:57",16,80,60,9,11,20,41,5,7,53,53,12,15,80,200,33,50,283,462.4,209.716666666667,2186.38983050847,1778.25,54,49,103,93.4426229508197
"./Ship3_Latin-square/2019-09-16_10h57m_Subject 47082.txt","47082",2019-09-16,"10:57",24,78,60,12,6,18,62,17,20,99,57,6,3,66,285,9,31,325,1270.11666666667,200.15,2064.30508474576,2465.26,89,67,156,85.2459016393443
"./Ship3_Latin-square/2019-09-16_10h57m_Subject 47092.txt","47092",2019-09-16,"10:57",16,80,60,10,10,20,16,4,4,24,28,7,1,36,538,53,110,701,124.766666666667,146.516666666667,2159.23728813559,1225.40740740741,63,99,162,95.0819672131148
"./Ship3_Latin-square/2019-09-16_10h57m_Subject 47098.txt","47098",2019-09-16,"10:57",8,78,60,10,8,18,19,1,0,20,26,3,5,34,301,41,38,380,265.25,174.466666666667,2620.30508474576,1590.35185185185,87,37,124,96.7213114754098
"./Ship3_Latin-square/2019-09-16_10h57m_Subject 47226.txt","47226",2019-09-16,"10:57",24,81,60,11,10,21,41,3,10,54,38,14,12,64,512,7,88,607,290.216666666667,170.933333333333,1820.25423728814,945.875,42,66,108,85.2459016393443
"./Ship3_Latin-square/2019-09-16_10h57m_Subject 47227.txt","47227",2019-09-16,"10:57",24,79,60,14,5,19,79,30,11,120,19,27,17,63,292,13,30,335,833.35,143.2,2145.66101694915,935.87037037037,53,41,94,91.8032786885246
"./Ship3_Latin-square/2019-09-16_10h57m_Subject 47250.txt","47250",2019-09-16,"10:57",2,79,60,6,13,19,21,2,4,27,16,2,13,31,852,106,197,1155,144.666666666667,122.95,2877.96610169492,1081.16949152542,21,45,66,100
"./Ship3_Latin-square/2019-09-16_10h57m_Subject 47645.txt","47645",2019-09-16,"10:57",4,72,53,9,10,19,59,16,9,84,25,6,8,39,336,67,57,460,1590.34615384615,219.403846153846,2784.61538461538,2521.38636363636,99,90,189,90.5660377358491
"./Ship3_Latin-square/2019-09-16_10h57m_Subject 47646.txt","47646",2019-09-16,"10:57",24,77,60,6,11,17,51,0,22,73,66,16,6,88,485,3,238,726,265.083333333333,173.966666666667,1616.94915254237,871.755555555556,14,73,87,80.327868852459
"./Ship3_Latin-square/2019-09-16_10h57m_Subject 47755.txt","47755",2019-09-16,"10:57",8,80,60,10,10,20,29,6,6,41,18,5,7,30,638,97,139,874,172.166666666667,191.133333333333,2606.71186440678,1541.06896551724,73,161,234,98.3606557377049
"./Ship3_Latin-square/2019-09-16_10h57m_Subject 47760.txt","47760",2019-09-16,"10:57",16,78,60,10,8,18,52,8,8,68,65,15,8,88,557,33,106,696,232.016666666667,224.383333333333,2240.61016949153,1002.72881355932,17,13,30,100
"./Ship3_Latin-square/2019-09-16_10h57m_Subject 47770.txt","47770",2019-09-16,"10:57",16,53,39,10,4,14,76,9,5,90,43,19,7,69,125,19,12,156,3173.5641025641,443.333333333333,2425.61538461538,4220.55882352941,78,49,127,87.5
"./Ship3_Latin-square/2019-09-16_10h57m_Subject 47795.txt","47795",2019-09-16,"10:57",24,69,51,16,2,18,112,35,3,150,49,33,1,83,237,3,9,249,973.06,241.56,2423.92,1900.53191489362,70,19,89,94.1176470588235
"./Ship3_Latin-square/2019-09-16_11h00m_Subject 47229.txt","47229",2019-09-16,"11:00",2,85,60,9,16,25,13,2,4,19,51,20,30,101,760,139,191,1090,148.566666666667,204.716666666667,2877.91525423729,1444.33898305085,58,62,120,100
"./Ship3_Latin-square/2019-09-16_11h00m_Subject 47233.txt","47233",2019-09-16,"11:00",4,81,60,6,15,21,31,2,4,37,20,11,4,35,397,38,115,550,147.6,132.966666666667,2749.13559322034,1509.96226415094,40,102,142,95.0819672131148
"./Ship3_Latin-square/2019-09-16_11h00m_Subject 47234.txt","47234",2019-09-16,"11:00",0,83,60,9,14,23,49,7,20,76,60,21,17,98,680,92,202,974,308.333333333333,273.833333333333,2999.93220338983,1504.94915254237,24,116,140,100
"./Ship3_Latin-square/2019-09-16_11h00m_Subject 47237.txt","47237",2019-09-16,"11:00",16,78,60,9,9,18,26,1,2,29,37,14,10,61,422,28,79,529,191.116666666667,166.833333333333,2240.64406779661,904.706896551724,12,32,44,98.3606557377049
"./Ship3_Latin-square/2019-09-16_11h00m_Subject 47241.txt","47241",2019-09-16,"11:00",8,80,60,7,13,20,16,0,10,26,2,3,1,6,753,68,185,1006,93.9833333333333,127.1,2525.40677966102,1614.2962962963,48,133,181,95.0819672131148
"./Ship3_Latin-square/2019-09-16_11h00m_Subject 47247.txt","47247",2019-09-16,"11:00",16,72,60,9,3,12,29,10,0,39,41,9,4,54,255,25,28,308,303.416666666667,200.533333333333,2321.98305084746,1861.31818181818,64,103,167,75.4098360655738
"./Ship3_Latin-square/2019-09-16_11h00m_Subject 47777.txt","47777",2019-09-16,"11:00",24,73,60,9,4,13,145,15,10,170,22,3,1,26,178,4,14,196,945.55,199.483333333333,1942.37288135593,1888.33898305085,65,36,101,100
"./Ship3_Latin-square/2019-09-16_11h00m_Subject 47784.txt","47784",2019-09-16,"11:00",16,78,60,10,8,18,97,13,15,125,85,17,15,117,581,62,80,723,622,306.616666666667,2240.5593220339,1273.03389830508,96,116,212,100
"./Ship3_Latin-square/2019-09-16_12h05m_Subject 46880.txt","46880",2019-09-16,"12:05",24,85,60,14,11,25,73,5,22,100,13,2,11,26,296,9,75,380,531.733333333333,112,1982.98305084746,2430,122,76,198,73.7704918032787
"./Ship3_Latin-square/2019-09-16_12h05m_Subject 46882.txt","46882",2019-09-16,"12:05",2,77,60,7,10,17,33,0,2,35,58,2,26,86,659,107,92,858,257.316666666667,273.2,2888.01694915254,1788.35294117647,32,129,161,93.4426229508197
"./Ship3_Latin-square/2019-09-16_12h05m_Subject 46883.txt","46883",2019-09-16,"12:05",8,72,53,10,9,19,111,8,12,131,90,35,10,135,207,29,33,269,1555,257.461538461538,2615.34615384615,2290.64583333333,51,52,103,92.4528301886792
"./Ship3_Latin-square/2019-09-16_12h05m_Subject 46894.txt","46894",2019-09-16,"12:05",24,74,54,12,8,20,91,16,14,121,26,16,2,44,215,9,66,290,1289.22222222222,169.5,1977.7037037037,1849.10638297872,69,34,103,92.7272727272727
"./Ship3_Latin-square/2019-09-16_12h05m_Subject 46896.txt","46896",2019-09-16,"12:05",16,77,60,10,7,17,48,3,4,55,40,7,8,55,491,26,76,593,325.216666666667,155.233333333333,2267.72881355932,1330.5593220339,44,34,78,100
"./Ship3_Latin-square/2019-09-16_12h05m_Subject 47088.txt","47088",2019-09-16,"12:05",0,82,60,7,15,22,37,1,1,39,51,4,11,66,1171,153,285,1609,121.45,198.683333333333,2999.84745762712,1312.30508474576,52,108,160,100
"./Ship3_Latin-square/2019-09-16_12h05m_Subject 47228.txt","47228",2019-09-16,"12:05",24,82,60,10,12,22,49,2,9,60,10,11,10,31,234,19,83,336,453.816666666667,82.6166666666667,1738.89830508475,1646.11904761905,46,86,132,80.327868852459
"./Ship3_Latin-square/2019-09-16_12h05m_Subject 47243.txt","47243",2019-09-16,"12:05",24,79,60,11,8,19,130,15,20,165,27,28,2,57,384,14,78,476,608.203389830509,159.220338983051,1860.93220338983,1366.8813559322,107,40,147,100
"./Ship3_Latin-square/2019-09-16_12h05m_Subject 47249.txt","47249",2019-09-16,"12:05",0,80,60,7,13,20,26,17,12,55,84,16,26,126,429,52,91,572,236.116666666667,197.033333333333,2999.91525423729,1650.98275862069,58,71,129,98.3606557377049
"./Ship3_Latin-square/2019-09-16_12h05m_Subject 47639.txt","47639",2019-09-16,"12:05",24,81,60,14,7,21,57,5,11,73,89,34,12,135,310,5,39,354,479.883333333333,664.7,2064.33898305085,1627.30434782609,73,92,165,81.6666666666667
"./Ship3_Latin-square/2019-09-16_12h05m_Subject 47649.txt","47649",2019-09-16,"12:05",16,68,51,12,5,17,48,7,7,62,17,5,0,22,141,23,19,183,1744.86,163.38,2327.98,3137.34285714286,69,62,131,74.5098039215686
"./Ship3_Latin-square/2019-09-16_12h05m_Subject 47758.txt","47758",2019-09-16,"12:05",0,78,60,7,11,18,8,1,1,10,16,3,1,20,930,120,200,1250,98.0833333333333,122.5,2999.89830508475,1468.62711864407,58,62,120,98.3606557377049
"./Ship3_Latin-square/2019-09-16_12h05m_Subject 47759.txt","47759",2019-09-16,"12:05",0,80,60,8,12,20,8,5,3,16,19,3,5,27,661,85,157,903,92.7833333333333,133.083333333333,2999.8813559322,1399.34482758621,40,52,92,98.3606557377049
"./Ship3_Latin-square/2019-09-16_12h05m_Subject 47776.txt","47776",2019-09-16,"12:05",24,78,60,14,4,18,78,14,4,96,37,24,2,63,426,11,62,499,382.733333333333,137.883333333333,2104.98305084746,1062.06896551724,62,19,81,98.3606557377049
"./Ship3_Latin-square/2019-09-16_12h05m_Subject 47799.txt","47799",2019-09-16,"12:05",0,76,60,6,10,16,39,4,4,47,57,8,9,74,591,59,125,775,314.383333333333,201.15,2999.86440677966,1596.87931034483,30,47,77,98.3606557377049
"./Ship3_Latin-square/2019-09-16_12h12m_Subject 46881.txt","46881",2019-09-16,"12:12",2,77,60,8,9,17,76,8,6,90,56,5,1,62,449,63,70,582,1139.43333333333,218.416666666667,2898.23728813559,2045.53703703704,36,126,162,91.8032786885246
"./Ship3_Latin-square/2019-09-16_12h12m_Subject 47087.txt","47087",2019-09-16,"12:12",2,79,60,7,12,19,59,3,6,68,56,8,13,77,354,46,65,465,341.366666666667,163.966666666667,2894.91525423729,2047.20689655172,80,62,142,98.3606557377049
"./Ship3_Latin-square/2019-09-16_12h12m_Subject 47626.txt","47626",2019-09-16,"12:12",24,62,49,9,4,13,53,7,9,69,38,8,4,50,165,4,18,187,2714.69387755102,262.489795918367,1949.89583333333,2037.02777777778,86,55,141,78
"./Ship3_Latin-square/2019-09-16_12h12m_Subject 47632.txt","47632",2019-09-16,"12:12",24,70,51,15,4,19,99,16,13,128,76,31,6,113,364,14,37,415,1170.98,357.18,2279.92,1394.4375,67,78,145,96.078431372549
"./Ship3_Latin-square/2019-09-16_12h12m_Subject 47634.txt","47634",2019-09-16,"12:12",2,83,60,10,13,23,54,6,10,70,44,40,7,91,331,53,74,458,580.783333333333,292.116666666667,2888.08474576271,2066.23636363636,97,61,158,95.0819672131148
"./Ship3_Latin-square/2019-09-16_12h12m_Subject 47640.txt","47640",2019-09-16,"12:12",2,77,60,7,10,17,47,3,3,53,44,7,15,66,557,61,120,738,670.833333333333,216.366666666667,2898.25423728814,1574.15254237288,43,55,98,100
"./Ship3_Latin-square/2019-09-16_12h12m_Subject 47754.txt","47754",2019-09-16,"12:12",24,64,49,9,6,15,54,8,14,76,35,6,12,53,165,4,32,201,2465.02083333333,190.833333333333,1949.97916666667,1854.16216216216,25,59,84,81.6326530612245
"./Ship3_Latin-square/2019-09-16_12h12m_Subject 47800.txt","47800",2019-09-16,"12:12",0,81,60,9,12,21,63,9,17,89,69,13,21,103,351,52,82,485,373.983333333333,191.916666666667,2999.93220338983,1893.50847457627,44,71,115,100
"./Ship3_Latin-square/2019-09-16_13h11m_Subject 46876.txt","46876",2019-09-16,"13:11",24,39,29,7,3,10,85,6,7,98,14,7,4,25,130,0,12,142,7718.39285714286,147.321428571429,2142.75,2568.57692307692,36,26,62,93.1034482758621
"./Ship3_Latin-square/2019-09-16_13h11m_Subject 46877.txt","46877",2019-09-16,"13:11",16,83,60,15,8,23,34,22,8,64,30,61,66,157,738,95,177,1010,144.716666666667,140.633333333333,2322,1111.54545454545,50,149,199,93.4426229508197
"./Ship3_Latin-square/2019-09-16_13h11m_Subject 46893.txt","46893",2019-09-16,"13:11",24,78,60,10,8,18,39,5,10,54,35,7,7,49,543,24,104,671,137.866666666667,143.066666666667,1860.98305084746,855.035087719298,33,36,69,98.3606557377049
"./Ship3_Latin-square/2019-09-16_13h11m_Subject 46895.txt","46895",2019-09-16,"13:11",16,71,50,12,9,21,67,15,11,93,30,7,9,46,169,24,41,234,1631.08,180.4,2327.94,1903.6,49,41,90,96.078431372549
"./Ship3_Latin-square/2019-09-16_13h11m_Subject 47638.txt","47638",2019-09-16,"13:11",24,79,60,13,6,19,106,9,7,122,41,20,7,68,214,9,33,256,972.133333333333,171.8,2104.98305084746,1218.45762711864,79,19,98,100
"./Ship3_Latin-square/2019-09-16_13h11m_Subject 47757.txt","47757",2019-09-16,"13:11",0,73,53,8,12,20,81,19,18,118,36,16,8,60,358,53,71,482,1361.88679245283,231.698113207547,2999.92307692308,1739.75,50,126,176,100
"./Ship3_Latin-square/2019-09-16_13h11m_Subject 47769.txt","47769",2019-09-16,"13:11",24,68,51,12,5,17,116,8,22,146,63,19,12,94,227,14,21,262,1690.6862745098,534.941176470588,2039.98,1938.28,59,60,119,100
"./Ship3_Latin-square/2019-09-16_13h11m_Subject 47771.txt","47771",2019-09-16,"13:11",0,79,60,9,10,19,21,1,1,23,7,11,4,22,751,123,145,1019,104.066666666667,109.616666666667,2999.93220338983,1679.06896551724,39,111,150,98.3606557377049
"./Ship3_Latin-square/2019-09-16_13h11m_Subject 47775.txt","47775",2019-09-16,"13:11",0,78,60,5,13,18,41,5,10,56,9,0,4,13,493,54,110,657,234.066666666667,97.9666666666667,2999.94915254237,1545.86206896552,29,58,87,100
"./Ship3_Latin-square/2019-09-16_13h11m_Subject 47781.txt","47781",2019-09-16,"13:11",2,79,60,8,11,19,22,2,5,29,58,11,14,83,834,108,159,1101,174.216666666667,234.65,2894.84745762712,1560.94827586207,45,105,150,98.3606557377049
"./Ship3_Latin-square/2019-09-16_13h11m_Subject 47782.txt","47782",2019-09-16,"13:11",0,78,60,6,12,18,10,0,3,13,15,5,5,25,787,126,129,1042,95.7833333333333,104.316666666667,2999.91525423729,1417.60344827586,22,60,82,98.3606557377049
"./Ship3_Latin-square/2019-09-16_13h11m_Subject 47783.txt","47783",2019-09-16,"13:11",2,80,60,10,10,20,72,6,9,87,41,8,41,90,559,126,121,806,602.683333333333,228.966666666667,2901.66101694915,1937.81034482759,56,61,117,98.3606557377049
"./Ship3_Latin-square/2019-09-16_13h11m_Subject 47785.txt","47785",2019-09-16,"13:11",2,81,60,11,10,21,13,3,0,16,44,9,13,66,1025,263,163,1451,153.516666666667,162.383333333333,2898.25423728814,1499.94915254237,43,69,112,98.3606557377049
"./Ship3_Latin-square/2019-09-16_13h11m_Subject 47786.txt","47786",2019-09-16,"13:11",8,79,60,11,8,19,46,7,9,62,32,12,5,49,399,43,76,518,348.466666666667,143.85,2633.86440677966,2071.10344827586,58,35,93,98.3606557377049
"./Ship3_Latin-square/2019-09-16_13h11m_Subject 47788.txt","47788",2019-09-16,"13:11",0,79,60,6,13,19,40,3,6,49,85,12,15,112,680,73,141,894,480.983333333333,231.35,2999.89830508475,1535.76271186441,23,57,80,100
"./Ship3_Latin-square/2019-09-16_13h19m_Subject 46888.txt","46888",2019-09-16,"13:19",0,80,60,10,10,20,11,0,0,11,48,8,24,80,1042,162,203,1407,60.0833333333333,188.8,2999.93220338983,1612.18965517241,48,131,179,98.3606557377049
"./Ship3_Latin-square/2019-09-16_13h19m_Subject 46889.txt","46889",2019-09-16,"13:19",4,80,60,10,10,20,16,3,1,20,25,5,38,68,895,178,191,1264,113.166666666667,165,2796.54237288136,1725.96226415094,74,236,310,91.8032786885246
"./Ship3_Latin-square/2019-09-16_13h19m_Subject 46890.txt","46890",2019-09-16,"13:19",8,84,59,13,12,25,22,1,5,28,6,14,4,24,212,51,57,320,1094.03389830508,126.813559322034,2593.18644067797,2324.97222222222,82,93,175,75
"./Ship3_Latin-square/2019-09-16_13h19m_Subject 46892.txt","46892",2019-09-16,"13:19",0,80,60,7,13,20,18,4,4,26,16,4,3,23,1004,137,210,1351,168.433333333333,122.566666666667,2999.93220338983,1398.38983050847,53,110,163,100
"./Ship3_Latin-square/2019-09-16_13h19m_Subject 46898.txt","46898",2019-09-16,"13:19",24,75,60,11,4,15,101,6,6,113,25,2,2,29,295,17,26,338,991.733333333333,136.7,2145.67796610169,1920.69811320755,69,81,150,90.1639344262295
"./Ship3_Latin-square/2019-09-16_13h19m_Subject 47097.txt","47097",2019-09-16,"13:19",2,76,60,5,11,16,34,3,3,40,76,12,17,105,795,92,117,1004,617.133333333333,243.583333333333,2881.27118644068,1358.58620689655,72,64,136,98.3606557377049
"./Ship3_Latin-square/2019-09-16_13h19m_Subject 47099.txt","47099",2019-09-16,"13:19",0,81,60,7,14,21,11,2,2,15,26,11,6,43,1379,136,267,1782,95.9166666666667,142.233333333333,2999.94915254237,1333.25423728814,36,64,100,98.3606557377049
"./Ship3_Latin-square/2019-09-16_13h19m_Subject 47798.txt","47798",2019-09-16,"13:19",8,71,52,5,14,19,54,0,13,67,33,7,28,68,133,6,48,187,1549.57692307692,419.057692307692,2482.27450980392,3064.32432432432,22,134,156,83.0188679245283
"./Ship3_Latin-square/2019-09-16_14h30m_Subject 47080.txt","47080",2019-09-16,"14:30",0,79,60,5,14,19,12,1,1,14,16,2,3,21,875,70,162,1107,103.433333333333,128.266666666667,2999.96610169492,1748.42857142857,37,132,169,96.7213114754098
"./Ship3_Latin-square/2019-09-16_14h30m_Subject 47089.txt","47089",2019-09-16,"14:30",2,83,59,10,14,24,72,9,13,94,134,36,37,207,362,53,95,510,879.28813559322,316.491525423729,2891.52542372881,1650.39655172414,74,54,128,100
"./Ship3_Latin-square/2019-09-16_14h30m_Subject 47762.txt","47762",2019-09-16,"14:30",8,67,50,11,6,17,74,6,13,93,41,4,5,50,214,39,21,274,1937.24,345.66,2673.38775510204,2128.69047619048,59,80,139,88.2352941176471
"./Ship3_Latin-square/2019-09-16_14h30m_Subject 47791.txt","47791",2019-09-16,"14:30",4,81,60,12,9,21,25,3,3,31,22,10,11,43,538,124,88,750,235.266666666667,128.2,2803.30508474576,1613.66071428571,47,37,84,95.0819672131148
"./Ship3_Latin-square/2019-09-17_09h58m_Subject 46878.txt","46878",2019-09-17,"09:58",8,77,60,9,8,17,20,5,4,29,25,24,1,50,771,99,105,975,123.466666666667,192.216666666667,2579.66101694915,1600.66101694915,73,89,162,98.3606557377049
"./Ship3_Latin-square/2019-09-17_09h58m_Subject 46885.txt","46885",2019-09-17,"09:58",4,78,60,8,10,18,32,10,8,50,7,4,11,22,392,48,73,513,410.283333333333,102.75,2796.54237288136,1675.43859649123,65,82,147,96.7213114754098
"./Ship3_Latin-square/2019-09-17_09h58m_Subject 46899.txt","46899",2019-09-17,"09:58",16,80,60,13,7,20,75,5,12,92,40,12,3,55,516,50,86,652,469.3,161.066666666667,2349.13559322034,1024.38983050847,54,34,88,100
"./Ship3_Latin-square/2019-09-17_09h58m_Subject 47081.txt","47081",2019-09-17,"09:58",8,81,60,11,10,21,38,4,7,49,12,0,6,18,551,59,117,727,247.616666666667,102.066666666667,2606.69491525424,1203.10169491525,32,31,63,100
"./Ship3_Latin-square/2019-09-17_09h58m_Subject 47091.txt","47091",2019-09-17,"09:58",16,79,60,7,12,19,35,5,7,47,59,11,12,82,181,24,56,261,413.083333333333,285.216666666667,2077.93220338983,2131.29824561404,49,68,117,96.7213114754098
"./Ship3_Latin-square/2019-09-17_09h58m_Subject 47231.txt","47231",2019-09-17,"09:58",16,79,60,11,8,19,43,8,7,58,11,19,6,36,507,40,116,663,469.7,117.733333333333,2294.89830508475,938.48275862069,26,51,77,98.3606557377049
"./Ship3_Latin-square/2019-09-17_09h58m_Subject 47238.txt","47238",2019-09-17,"09:58",2,81,60,8,13,21,13,3,4,20,56,14,19,89,598,62,129,789,140.15,340.7,2888.10169491525,1104.69491525424,42,41,83,100
"./Ship3_Latin-square/2019-09-17_09h58m_Subject 47242.txt","47242",2019-09-17,"09:58",2,79,60,8,11,19,35,2,7,44,68,35,16,119,665,108,135,908,228.233333333333,241.933333333333,2891.49152542373,1167.16949152542,46,53,99,100
"./Ship3_Latin-square/2019-09-17_09h58m_Subject 47244.txt","47244",2019-09-17,"09:58",4,78,60,9,9,18,40,15,1,56,70,6,55,131,648,122,91,861,258.9,267.033333333333,2796.57627118644,1820.30508474576,81,142,223,100
"./Ship3_Latin-square/2019-09-17_09h58m_Subject 47633.txt","47633",2019-09-17,"09:58",8,80,60,10,10,20,43,6,6,55,63,18,16,97,418,51,114,583,379.383333333333,223.7,2606.74576271186,1559.69491525424,65,83,148,100
"./Ship3_Latin-square/2019-09-17_09h58m_Subject 47636.txt","47636",2019-09-17,"09:58",16,69,50,10,9,19,98,12,15,125,237,88,35,360,276,38,42,356,888.96,974.42,2231.88,2025.71428571429,77,101,178,100
"./Ship3_Latin-square/2019-09-17_09h58m_Subject 47752.txt","47752",2019-09-17,"09:58",16,82,60,11,11,22,74,10,11,95,37,18,14,69,446,42,172,660,343.6,129.8,2213.42372881356,1196.77586206897,59,63,122,98.3606557377049
"./Ship3_Latin-square/2019-09-17_09h58m_Subject 47767.txt","47767",2019-09-17,"09:58",2,81,60,11,10,21,28,8,1,37,89,35,7,131,504,70,81,655,203.583333333333,513.066666666667,2901.61016949153,1524.42372881356,77,42,119,100
"./Ship3_Latin-square/2019-09-17_09h58m_Subject 47768.txt","47768",2019-09-17,"09:58",16,66,46,12,8,20,89,14,9,112,37,14,60,111,246,23,50,319,1868.76086956522,207.369565217391,2288.86666666667,2878.65789473684,64,155,219,87.2340425531915
"./Ship3_Latin-square/2019-09-17_09h58m_Subject 47780.txt","47780",2019-09-17,"09:58",24,82,60,14,8,22,46,8,2,56,14,7,6,27,209,0,34,243,770.8,271.866666666667,2064.28813559322,1839.57894736842,331,12,343,34.4262295081967
"./Ship3_Latin-square/2019-09-17_10h03m_Subject 46884.txt","46884",2019-09-17,"10:03",24,79,58,13,8,21,90,3,14,107,37,9,7,53,170,5,42,217,1130.36206896552,407.964912280702,2031.56140350877,2404.74468085106,89,56,145,82.7586206896552
"./Ship3_Latin-square/2019-09-17_10h03m_Subject 47083.txt","47083",2019-09-17,"10:03",4,77,59,8,10,18,54,11,15,80,62,15,36,113,360,60,48,468,837.203389830509,464.338983050847,2786.15517241379,2283.56603773585,106,106,212,95
"./Ship3_Latin-square/2019-09-17_10h03m_Subject 47086.txt","47086",2019-09-17,"10:03",8,80,60,12,8,20,14,2,2,18,30,9,4,43,391,59,68,518,172.3,173.733333333333,2633.86440677966,1482.45283018868,45,68,113,95.0819672131148
"./Ship3_Latin-square/2019-09-17_10h03m_Subject 47246.txt","47246",2019-09-17,"10:03",24,81,60,12,9,21,87,4,14,105,18,7,10,35,220,1,58,279,486.416666666667,166.15,1820.20338983051,1098.55102040816,13,63,76,85.2459016393443
"./Ship3_Latin-square/2019-09-17_10h03m_Subject 47635.txt","47635",2019-09-17,"10:03",8,82,60,11,11,22,27,7,6,40,52,16,9,77,504,93,89,686,189.466666666667,192.8,2593.13559322034,1586.4406779661,52,56,108,100
"./Ship3_Latin-square/2019-09-17_10h03m_Subject 47779.txt","47779",2019-09-17,"10:03",8,80,60,12,8,20,52,12,9,73,53,12,3,68,141,27,20,188,902.083333333333,196.933333333333,2647.37288135593,2941.51162790698,88,84,172,73.7704918032787
"./Ship3_Latin-square/2019-09-17_10h03m_Subject 47797.txt","47797",2019-09-17,"10:03",24,53,37,10,6,16,49,8,22,79,49,13,14,76,87,5,17,109,2190.55555555556,804.722222222222,2066.63888888889,3258.28571428571,28,79,107,86.4864864864865
"./Ship3_Latin-square/2019-09-17_11h19m_Subject 46900.txt","46900",2019-09-17,"11:19",24,77,60,9,8,17,40,2,9,51,43,45,10,98,487,4,82,573,289.666666666667,236.083333333333,1861,914.6875,33,65,98,85.2459016393443
"./Ship3_Latin-square/2019-09-17_11h19m_Subject 46986.txt","46986",2019-09-17,"11:19",0,83,60,10,13,23,48,9,8,65,15,8,21,44,380,64,83,527,591.216666666667,169.216666666667,2999.91525423729,2062.58490566038,62,93,155,93.4426229508197
"./Ship3_Latin-square/2019-09-17_11h19m_Subject 47076.txt","47076",2019-09-17,"11:19",2,76,60,9,7,16,6,1,0,7,10,23,6,39,516,64,83,663,170.75,157.85,2905,1336.61290322581,13,396,409,54.0983606557377
"./Ship3_Latin-square/2019-09-17_11h19m_Subject 47079.txt","47079",2019-09-17,"11:19",4,80,60,9,11,20,23,1,0,24,56,16,10,82,375,69,86,530,280.366666666667,254.016666666667,2796.59322033898,1691.50877192982,72,83,155,98.3606557377049
"./Ship3_Latin-square/2019-09-17_11h19m_Subject 47082.txt","47082",2019-09-17,"11:19",2,77,60,9,8,17,31,0,3,34,116,10,4,130,472,65,59,596,184,287.716666666667,2894.8813559322,1657.46428571429,52,115,167,95.0819672131148
"./Ship3_Latin-square/2019-09-17_11h19m_Subject 47092.txt","47092",2019-09-17,"11:19",4,82,60,12,10,22,21,2,5,28,42,12,0,54,720,159,122,1001,108.85,181.75,2810.06779661017,1472.64406779661,66,68,134,100
"./Ship3_Latin-square/2019-09-17_11h19m_Subject 47098.txt","47098",2019-09-17,"11:19",2,83,60,8,15,23,12,1,2,15,25,2,27,54,294,30,66,390,307.716666666667,167.766666666667,2881.30508474576,1859.04444444444,73,107,180,83.6065573770492
"./Ship3_Latin-square/2019-09-17_11h19m_Subject 47226.txt","47226",2019-09-17,"11:19",2,79,60,5,14,19,26,1,5,32,27,4,20,51,969,125,188,1282,334.45,146.783333333333,2871.18644067797,1390.85714285714,21,51,72,100
"./Ship3_Latin-square/2019-09-17_11h19m_Subject 47227.txt","47227",2019-09-17,"11:19",2,83,60,10,13,23,32,1,1,34,20,19,5,44,761,113,200,1074,151.2,166.95,2888.01694915254,1294.01694915254,26,80,106,100
"./Ship3_Latin-square/2019-09-17_11h19m_Subject 47250.txt","47250",2019-09-17,"11:19",0,82,60,8,14,22,26,2,11,39,12,4,15,31,963,134,217,1314,150.366666666667,106.8,2999.91525423729,1315.57627118644,39,36,75,100
"./Ship3_Latin-square/2019-09-17_11h19m_Subject 47645.txt","47645",2019-09-17,"11:19",0,79,57,10,12,22,75,17,14,106,31,9,31,71,497,88,86,671,1081.94642857143,203.767857142857,2999.94642857143,1960.4,87,96,183,100
"./Ship3_Latin-square/2019-09-17_11h19m_Subject 47646.txt","47646",2019-09-17,"11:19",2,78,60,6,12,18,14,0,0,14,93,18,44,155,1547,146,298,1991,98.3166666666667,194.283333333333,2877.96610169492,1351.22807017544,22,134,156,96.7213114754098
"./Ship3_Latin-square/2019-09-17_11h19m_Subject 47755.txt","47755",2019-09-17,"11:19",16,75,60,7,8,15,58,7,11,76,33,7,3,43,546,53,115,714,389.25,214.3,2159.32203389831,1431.54545454545,71,170,241,93.4426229508197
"./Ship3_Latin-square/2019-09-17_11h19m_Subject 47760.txt","47760",2019-09-17,"11:19",4,80,60,8,12,20,38,5,6,49,45,6,12,63,885,81,191,1157,236.983333333333,176.283333333333,2769.38983050847,1200.94915254237,33,38,71,100
"./Ship3_Latin-square/2019-09-17_11h19m_Subject 47770.txt","47770",2019-09-17,"11:19",8,44,33,5,6,11,44,5,3,52,53,16,9,78,105,37,21,163,3608.40625,621.125,2599.96875,5779.08333333333,61,58,119,81.8181818181818
"./Ship3_Latin-square/2019-09-17_11h19m_Subject 47795.txt","47795",2019-09-17,"11:19",2,84,60,5,19,24,37,1,12,50,39,11,25,75,645,43,179,867,276.5,208.733333333333,2857.5593220339,1284.58620689655,13,24,37,100
"./Ship3_Latin-square/2019-09-17_11h23m_Subject 47229.txt","47229",2019-09-17,"11:23",0,81,60,10,11,21,15,5,0,20,44,17,10,71,753,119,129,1001,125.2,203.2,2999.94915254237,1488.08474576271,39,57,96,100
"./Ship3_Latin-square/2019-09-17_11h23m_Subject 47233.txt","47233",2019-09-17,"11:23",24,81,60,11,10,21,48,7,16,71,55,17,19,91,258,5,86,349,262.466666666667,194.233333333333,1942.32203389831,1181.9387755102,56,83,139,90.1639344262295
"./Ship3_Latin-square/2019-09-17_11h23m_Subject 47234.txt","47234",2019-09-17,"11:23",8,83,60,12,11,23,61,12,10,83,164,17,15,196,589,101,133,823,177.566666666667,318.333333333333,2620.28813559322,1389.94827586207,72,59,131,98.3606557377049
"./Ship3_Latin-square/2019-09-17_11h23m_Subject 47237.txt","47237",2019-09-17,"11:23",0,79,60,9,10,19,29,4,2,35,10,5,29,44,784,97,187,1068,196.266666666667,109.133333333333,2999.93220338983,1118.24137931034,28,53,81,98.3606557377049
"./Ship3_Latin-square/2019-09-17_11h23m_Subject 47241.txt","47241",2019-09-17,"11:23",24,79,60,11,8,19,26,3,10,39,13,9,5,27,576,9,146,731,131.416666666667,133.816666666667,1942.33898305085,952.825,42,78,120,77.0491803278689
"./Ship3_Latin-square/2019-09-17_11h23m_Subject 47247.txt","47247",2019-09-17,"11:23",4,73,60,5,8,13,21,0,3,24,39,5,5,49,414,53,70,537,271.083333333333,206.633333333333,2776.22033898305,1951.61538461538,53,127,180,90.1639344262295
"./Ship3_Latin-square/2019-09-17_11h23m_Subject 47777.txt","47777",2019-09-17,"11:23",2,81,60,7,14,21,33,11,4,48,14,3,17,34,518,73,121,712,380.616666666667,192.583333333333,2874.52542372881,1662.96551724138,62,60,122,100
"./Ship3_Latin-square/2019-09-17_11h23m_Subject 47784.txt","47784",2019-09-17,"11:23",4,78,60,8,10,18,39,8,3,50,48,19,24,91,1057,171,172,1400,149.35,263.516666666667,2789.77966101695,1201.4406779661,69,122,191,100
"./Ship3_Latin-square/2019-09-17_12h31m_Subject 46880.txt","46880",2019-09-17,"12:31",2,74,60,7,7,14,10,0,1,11,54,10,3,67,714,71,110,895,151.533333333333,152.433333333333,2894.8813559322,2012.66,104,235,339,88.5245901639344
"./Ship3_Latin-square/2019-09-17_12h31m_Subject 46882.txt","46882",2019-09-17,"12:31",0,82,60,7,15,22,13,0,6,19,49,5,16,70,791,85,124,1000,215.416666666667,197.716666666667,2999.86440677966,1947.01923076923,106,97,203,93.4426229508197
"./Ship3_Latin-square/2019-09-17_12h31m_Subject 46883.txt","46883",2019-09-17,"12:31",16,80,60,12,8,20,75,7,12,94,37,16,20,73,233,29,28,290,757.866666666667,157.766666666667,2294.86440677966,2340.54166666667,75,94,169,81.9672131147541
"./Ship3_Latin-square/2019-09-17_12h31m_Subject 46894.txt","46894",2019-09-17,"12:31",0,80,60,2,18,20,36,0,7,43,19,1,15,35,798,50,202,1050,294.65,114.65,2999.91525423729,1415.15254237288,17,102,119,100
"./Ship3_Latin-square/2019-09-17_12h31m_Subject 46896.txt","46896",2019-09-17,"12:31",0,80,60,6,14,20,16,0,0,16,27,8,9,44,848,112,176,1136,137.183333333333,136.65,2999.93220338983,1257.62711864407,13,32,45,100
"./Ship3_Latin-square/2019-09-17_12h31m_Subject 47088.txt","47088",2019-09-17,"12:31",16,83,60,12,11,23,34,3,7,44,38,10,16,64,605,44,124,773,218.266666666667,171.683333333333,2213.54237288136,1257.89473684211,90,76,166,96.7213114754098
"./Ship3_Latin-square/2019-09-17_12h31m_Subject 47228.txt","47228",2019-09-17,"12:31",0,81,60,9,12,21,20,4,3,27,24,6,17,47,594,74,124,792,250.433333333333,102.916666666667,2999.93220338983,1645.26785714286,32,88,120,96.7213114754098
"./Ship3_Latin-square/2019-09-17_12h31m_Subject 47243.txt","47243",2019-09-17,"12:31",0,83,60,9,14,23,23,10,5,38,8,5,1,14,917,154,220,1291,156.35,126.766666666667,2999.96610169492,1354.34482758621,101,95,196,98.3606557377049
"./Ship3_Latin-square/2019-09-17_12h31m_Subject 47249.txt","47249",2019-09-17,"12:31",16,79,57,14,8,22,57,18,12,87,76,64,8,148,266,58,40,364,832.80701754386,256.982456140351,2354.36842105263,2027.125,78,62,140,100
"./Ship3_Latin-square/2019-09-17_12h31m_Subject 47639.txt","47639",2019-09-17,"12:31",0,83,60,4,19,23,16,0,3,19,12,1,5,18,891,48,248,1187,101.9,137.4,2999.91525423729,1700.84482758621,22,109,131,100
"./Ship3_Latin-square/2019-09-17_12h31m_Subject 47649.txt","47649",2019-09-17,"12:31",4,80,60,7,13,20,53,3,2,58,53,8,82,143,273,39,76,388,743.05,199.033333333333,2755.91525423729,2395.75609756098,45,227,272,81.9672131147541
"./Ship3_Latin-square/2019-09-17_12h31m_Subject 47758.txt","47758",2019-09-17,"12:31",16,79,60,10,9,19,9,0,2,11,2,0,0,2,286,18,90,394,199.583333333333,112.433333333333,2213.54237288136,1395.46153846154,322,8,330,45.9016393442623
"./Ship3_Latin-square/2019-09-17_12h31m_Subject 47759.txt","47759",2019-09-17,"12:31",16,82,60,13,9,22,21,4,3,28,29,7,11,47,349,34,68,451,257.816666666667,140.916666666667,2294.86440677966,1299.81132075472,41,55,96,91.8032786885246
"./Ship3_Latin-square/2019-09-17_12h31m_Subject 47776.txt","47776",2019-09-17,"12:31",0,82,60,9,13,22,14,4,4,22,54,21,7,82,1065,162,180,1407,78.7333333333333,153.75,2999.91525423729,1241.4406779661,42,36,78,100
"./Ship3_Latin-square/2019-09-17_12h31m_Subject 47799.txt","47799",2019-09-17,"12:31",16,81,60,12,9,21,41,6,4,51,54,24,11,89,191,27,28,246,591.65,293.8,2240.62711864407,1750.42,65,45,110,88.5245901639344
"./Ship3_Latin-square/2019-09-17_12h36m_Subject 46881.txt","46881",2019-09-17,"12:36",0,79,60,7,12,19,24,1,4,29,13,4,5,22,417,49,102,568,274.85,136.533333333333,2999.91525423729,2063.25581395349,45,203,248,85.2459016393443
"./Ship3_Latin-square/2019-09-17_12h36m_Subject 47087.txt","47087",2019-09-17,"12:36",0,79,60,9,10,19,25,3,0,28,37,8,11,56,365,43,73,481,255.65,135.716666666667,2999.96610169492,2055.86440677966,67,40,107,100
"./Ship3_Latin-square/2019-09-17_12h36m_Subject 47626.txt","47626",2019-09-17,"12:36",2,79,60,9,10,19,32,7,4,43,86,8,10,104,311,50,57,418,409.2,261.35,2898.22033898305,2638.83333333333,100,94,194,93.4426229508197
"./Ship3_Latin-square/2019-09-17_12h36m_Subject 47632.txt","47632",2019-09-17,"12:36",2,79,60,8,11,19,63,5,3,71,12,4,8,24,891,111,202,1204,244.05,128.516666666667,2891.49152542373,1241.59322033898,24,104,128,100
"./Ship3_Latin-square/2019-09-17_12h36m_Subject 47634.txt","47634",2019-09-17,"12:36",0,80,60,9,11,20,34,12,11,57,22,6,8,36,487,96,115,698,381,166.516666666667,2999.93220338983,1234,86,44,130,96.7213114754098
"./Ship3_Latin-square/2019-09-17_12h36m_Subject 47640.txt","47640",2019-09-17,"12:36",0,82,60,9,13,22,57,12,5,74,28,1,26,55,708,127,209,1044,662.783333333333,162.916666666667,2999.8813559322,1709.80701754386,37,79,116,98.3606557377049
"./Ship3_Latin-square/2019-09-17_12h36m_Subject 47754.txt","47754",2019-09-17,"12:36",0,81,60,7,14,21,23,7,12,42,50,3,20,73,658,79,149,886,578.166666666667,190.883333333333,2999.89830508475,2055.14545454545,65,154,219,95.0819672131148
"./Ship3_Latin-square/2019-09-17_12h36m_Subject 47800.txt","47800",2019-09-17,"12:36",24,76,60,10,6,16,63,2,8,73,63,18,16,97,308,4,53,365,317.233333333333,210.85,1942.35593220339,1027.86274509804,47,75,122,86.8852459016393
"./Ship3_Latin-square/2019-09-17_13h45m_Subject 46876.txt","46876",2019-09-17,"13:45",2,78,60,8,10,18,44,18,5,67,52,10,33,95,397,49,88,534,540.133333333333,256.983333333333,2898.23728813559,1885.87272727273,69,83,152,98.3606557377049
"./Ship3_Latin-square/2019-09-17_13h45m_Subject 46877.txt","46877",2019-09-17,"13:45",8,76,60,9,7,16,17,1,0,18,141,31,49,221,919,138,121,1178,123.166666666667,389.383333333333,2633.83050847458,1202.44642857143,37,158,195,95.0819672131148
"./Ship3_Latin-square/2019-09-17_13h45m_Subject 46893.txt","46893",2019-09-17,"13:45",0,78,60,6,12,18,18,3,2,23,46,7,8,61,1204,111,287,1602,112.9,171.383333333333,2999.89830508475,1372.01694915254,38,70,108,100
"./Ship3_Latin-square/2019-09-17_13h45m_Subject 46895.txt","46895",2019-09-17,"13:45",4,83,60,11,12,23,81,27,8,116,21,8,6,35,422,84,86,592,966.95,207.6,2810.1186440678,1494.2037037037,49,56,105,93.4426229508197
"./Ship3_Latin-square/2019-09-17_13h45m_Subject 47638.txt","47638",2019-09-17,"13:45",0,82,60,11,11,22,125,15,13,153,23,8,29,60,422,102,92,616,609.716666666667,146.233333333333,2999.86440677966,1478.94915254237,46,29,75,100
"./Ship3_Latin-square/2019-09-17_13h45m_Subject 47757.txt","47757",2019-09-17,"13:45",16,71,51,14,6,20,106,30,25,161,22,13,4,39,266,61,43,370,1657.05882352941,244.490196078431,2435.23529411765,1846.21276595745,73,92,165,92.3076923076923
"./Ship3_Latin-square/2019-09-17_13h45m_Subject 47769.txt","47769",2019-09-17,"13:45",0,86,60,14,12,26,30,2,6,38,40,10,16,66,904,169,197,1270,156.466666666667,167.366666666667,2999.89830508475,1442.30508474576,50,127,177,100
"./Ship3_Latin-square/2019-09-17_13h45m_Subject 47771.txt","47771",2019-09-17,"13:45",24,84,60,13,11,24,81,7,15,103,15,14,10,39,275,7,59,341,580.5,118.566666666667,1860.98305084746,1689.70731707317,35,92,127,77.0491803278689
"./Ship3_Latin-square/2019-09-17_13h45m_Subject 47775.txt","47775",2019-09-17,"13:45",24,79,60,13,6,19,103,11,21,135,23,11,4,38,305,3,59,367,437.4,110.033333333333,1982.94915254237,1060.43636363636,52,54,106,93.4426229508197
"./Ship3_Latin-square/2019-09-17_13h45m_Subject 47781.txt","47781",2019-09-17,"13:45",0,81,60,8,13,21,10,0,3,13,55,10,6,71,1122,170,236,1528,85.4666666666667,207.283333333333,2999.8813559322,1531.57627118644,44,91,135,100
"./Ship3_Latin-square/2019-09-17_13h45m_Subject 47782.txt","47782",2019-09-17,"13:45",16,79,60,9,10,19,31,3,9,43,13,6,8,27,497,39,87,623,251,101.866666666667,2186.35593220339,1137.23636363636,26,80,106,95.0819672131148
"./Ship3_Latin-square/2019-09-17_13h45m_Subject 47783.txt","47783",2019-09-17,"13:45",0,83,60,9,14,23,39,3,7,49,49,8,19,76,738,72,197,1007,560.4,298.066666666667,2999.91525423729,1808.14285714286,46,104,150,95.0819672131148
"./Ship3_Latin-square/2019-09-17_13h45m_Subject 47785.txt","47785",2019-09-17,"13:45",0,77,60,6,11,17,9,0,1,10,50,15,8,73,1278,197,260,1735,178.766666666667,162.066666666667,2999.89830508475,1618.57692307692,17,1201,1218,44.2622950819672
"./Ship3_Latin-square/2019-09-17_13h45m_Subject 47786.txt","47786",2019-09-17,"13:45",24,66,48,12,6,18,68,12,9,89,51,12,15,78,146,2,40,188,1132.9375,806.291666666667,2049.9375,2270.36585365854,54,49,103,87.7551020408163
"./Ship3_Latin-square/2019-09-17_13h45m_Subject 47788.txt","47788",2019-09-17,"13:45",16,79,60,11,8,19,48,2,7,57,79,28,10,117,364,28,80,472,320.516666666667,273.783333333333,2267.69491525424,1483.84615384615,42,86,128,90.1639344262295
"./Ship3_Latin-square/2019-09-17_13h50m_Subject 46888.txt","46888",2019-09-17,"13:50",24,85,60,15,10,25,22,7,6,35,51,34,13,98,316,27,127,470,180.016666666667,184.333333333333,1982.96610169492,1322.9387755102,58,70,128,83.6065573770492
"./Ship3_Latin-square/2019-09-17_13h50m_Subject 46889.txt","46889",2019-09-17,"13:50",24,80,60,10,10,20,47,0,16,63,39,4,13,56,499,14,121,634,261.7,216.683333333333,1779.64406779661,1074.41304347826,47,96,143,81.9672131147541
"./Ship3_Latin-square/2019-09-17_13h50m_Subject 46890.txt","46890",2019-09-17,"13:50",2,83,60,10,13,23,16,3,3,22,3,0,25,28,141,34,49,224,904.45,106.3,2894.89830508475,3603.04347826087,82,104,186,57.3770491803279
"./Ship3_Latin-square/2019-09-17_13h50m_Subject 46892.txt","46892",2019-09-17,"13:50",16,81,60,12,9,21,24,2,3,29,6,3,1,10,482,77,93,652,166.833333333333,117.533333333333,2267.74576271186,1432.35416666667,52,126,178,86.8852459016393
"./Ship3_Latin-square/2019-09-17_13h50m_Subject 46898.txt","46898",2019-09-17,"13:50",16,82,60,14,8,22,48,5,6,59,19,11,9,39,500,75,77,652,348.95,141.733333333333,2349.13559322034,1386.41071428571,53,80,133,98.3606557377049
"./Ship3_Latin-square/2019-09-17_13h50m_Subject 47097.txt","47097",2019-09-17,"13:50",0,80,60,7,13,20,14,1,2,17,73,9,18,100,863,72,191,1126,108.366666666667,231.666666666667,2999.93220338983,1518.74576271186,67,102,169,100
"./Ship3_Latin-square/2019-09-17_13h50m_Subject 47099.txt","47099",2019-09-17,"13:50",16,79,60,11,8,19,18,5,2,25,27,6,12,45,667,71,96,834,139.533333333333,165.483333333333,2294.84745762712,1111.98181818182,52,102,154,93.4426229508197
"./Ship3_Latin-square/2019-09-17_13h50m_Subject 47798.txt","47798",2019-09-17,"13:50",16,75,55,11,9,20,45,8,9,62,27,19,5,51,148,13,32,193,1259.52727272727,242.509090909091,2199.96296296296,3152.69230769231,44,80,124,83.6363636363636
"./Ship3_Latin-square/2019-09-17_14h56m_Subject 47080.txt","47080",2019-09-17,"14:56",24,87,60,15,12,27,33,1,8,42,21,7,10,38,525,14,170,709,192.716666666667,128.7,1942.32203389831,1128.41463414634,41,87,128,78.6885245901639
"./Ship3_Latin-square/2019-09-17_14h56m_Subject 47089.txt","47089",2019-09-17,"14:56",0,82,60,10,12,22,57,13,29,99,77,20,42,139,382,45,100,527,431.616666666667,237.4,2999.84745762712,1724.72881355932,87,43,130,100
"./Ship3_Latin-square/2019-09-17_14h56m_Subject 47762.txt","47762",2019-09-17,"14:56",16,81,60,11,10,21,74,10,10,94,51,10,10,71,188,24,43,255,901.933333333333,393.066666666667,2267.76271186441,2495.38775510204,81,105,186,88.5245901639344
"./Ship3_Latin-square/2019-09-17_14h56m_Subject 47791.txt","47791",2019-09-17,"14:56",24,87,60,16,11,27,25,3,1,29,42,21,8,71,329,16,112,457,245.15,212.033333333333,2023.66101694915,1171.875,22,58,80,85.2459016393443
"./Ship3_Latin-square/2019-09-18_09h56m_Subject 46878.txt","46878",2019-09-18,"09:56",16,85,60,15,10,25,40,8,4,52,37,40,66,143,542,105,123,770,228.316666666667,249.866666666667,2294.84745762712,1649.48275862069,102,92,194,98.3606557377049
"./Ship3_Latin-square/2019-09-18_09h56m_Subject 46885.txt","46885",2019-09-18,"09:56",24,78,57,11,10,21,79,14,15,108,48,6,14,68,155,7,51,213,798.175438596491,294,1885.67857142857,2054.76744186047,86,54,140,78.9473684210526
"./Ship3_Latin-square/2019-09-18_09h56m_Subject 46899.txt","46899",2019-09-18,"09:56",4,82,60,12,10,22,27,3,4,34,24,5,5,34,919,140,139,1198,222.45,138.266666666667,2816.89830508475,1022.94915254237,28,25,53,100
"./Ship3_Latin-square/2019-09-18_09h56m_Subject 47081.txt","47081",2019-09-18,"09:56",24,85,60,14,11,25,58,3,14,75,34,9,31,74,278,2,83,363,322.733333333333,205.733333333333,1901.62711864407,1137.78260869565,45,70,115,83.6065573770492
"./Ship3_Latin-square/2019-09-18_09h56m_Subject 47091.txt","47091",2019-09-18,"09:56",4,82,60,14,8,22,38,7,2,47,53,20,46,119,319,74,66,459,533.683333333333,187.083333333333,2830.4406779661,1760.08771929825,83,61,144,96.7213114754098
"./Ship3_Latin-square/2019-09-18_09h56m_Subject 47231.txt","47231",2019-09-18,"09:56",4,81,59,8,14,22,63,16,20,99,93,11,14,118,253,29,70,352,960.915254237288,279.389830508475,2751.70689655172,1922.2,37,62,99,96.6666666666667
"./Ship3_Latin-square/2019-09-18_09h56m_Subject 47238.txt","47238",2019-09-18,"09:56",0,74,60,6,8,14,15,1,2,18,54,13,4,71,559,51,77,687,198.05,283.583333333333,2999.93220338983,1330.86440677966,24,50,74,100
"./Ship3_Latin-square/2019-09-18_09h56m_Subject 47242.txt","47242",2019-09-18,"09:56",0,78,60,6,12,18,27,1,6,34,56,4,9,69,697,90,153,940,180.733333333333,177.183333333333,2999.91525423729,1257.8275862069,63,41,104,98.3606557377049
"./Ship3_Latin-square/2019-09-18_09h56m_Subject 47244.txt","47244",2019-09-18,"09:56",24,82,60,11,11,22,41,1,3,45,73,13,15,101,323,13,72,408,439.783333333333,355.716666666667,1820.27118644068,1411.95918367347,81,79,160,83.6065573770492
"./Ship3_Latin-square/2019-09-18_09h56m_Subject 47633.txt","47633",2019-09-18,"09:56",16,80,60,11,9,20,44,17,6,67,57,21,12,90,371,48,88,507,393.95,198.983333333333,2267.72881355932,1300.09259259259,77,74,151,93.4426229508197
"./Ship3_Latin-square/2019-09-18_09h56m_Subject 47636.txt","47636",2019-09-18,"09:56",8,79,60,9,10,19,83,11,5,99,154,8,11,173,320,45,37,402,907.45,357.95,2593.20338983051,2487.72727272727,152,105,257,93.4426229508197
"./Ship3_Latin-square/2019-09-18_09h56m_Subject 47752.txt","47752",2019-09-18,"09:56",4,84,60,9,15,24,50,5,2,57,28,13,20,61,757,58,209,1024,307.116666666667,118.133333333333,2769.45762711864,1231.16949152542,37,61,98,100
"./Ship3_Latin-square/2019-09-18_09h56m_Subject 47767.txt","47767",2019-09-18,"09:56",0,82,60,11,11,22,39,6,6,51,55,25,23,103,340,70,57,467,366.4,295.816666666667,2999.86440677966,1580.71929824561,50,39,89,98.3606557377049
"./Ship3_Latin-square/2019-09-18_09h56m_Subject 47768.txt","47768",2019-09-18,"09:56",8,74,53,12,9,21,55,7,11,73,30,10,33,73,374,62,99,535,1119.07547169811,373.660377358491,2646.13461538462,2384.26,79,78,157,96.2264150943396
"./Ship3_Latin-square/2019-09-18_09h56m_Subject 47780.txt","47780",2019-09-18,"09:56",16,82,60,13,9,22,63,10,14,87,60,13,9,82,333,33,75,441,590.65,369.183333333333,2294.83050847458,1283.62962962963,52,52,104,95.0819672131148
"./Ship3_Latin-square/2019-09-18_10h00m_Subject 46884.txt","46884",2019-09-18,"10:00",2,80,60,9,11,20,34,8,10,52,44,1,5,50,292,50,26,368,422.4,269.183333333333,2891.45762711864,2967.23076923077,120,155,275,68.8524590163934
"./Ship3_Latin-square/2019-09-18_10h00m_Subject 47083.txt","47083",2019-09-18,"10:00",24,70,48,12,10,22,65,11,20,96,39,20,18,77,114,12,55,181,1571.58333333333,270.270833333333,1876.48936170213,3427.33333333333,135,60,195,65.3061224489796
"./Ship3_Latin-square/2019-09-18_10h00m_Subject 47086.txt","47086",2019-09-18,"10:00",24,56,42,11,3,14,53,6,7,66,29,54,9,92,137,5,6,148,867.634146341463,379.439024390244,2239,1685.35294117647,50,49,99,85.7142857142857
"./Ship3_Latin-square/2019-09-18_10h00m_Subject 47246.txt","47246",2019-09-18,"10:00",2,80,60,7,13,20,34,5,1,40,23,4,18,45,485,68,93,646,258.716666666667,187.15,2881.25423728814,1619.69642857143,14,141,155,95.0819672131148
"./Ship3_Latin-square/2019-09-18_10h00m_Subject 47635.txt","47635",2019-09-18,"10:00",16,76,60,10,6,16,21,6,1,28,41,8,4,53,513,56,74,643,184.833333333333,180.716666666667,2294.84745762712,1256.61403508772,63,56,119,96.7213114754098
"./Ship3_Latin-square/2019-09-18_10h00m_Subject 47779.txt","47779",2019-09-18,"10:00",16,59,42,12,5,17,25,5,2,32,21,10,4,35,73,13,10,96,2549.09523809524,170.166666666667,2390.35714285714,4977.82608695652,74,47,121,65.1162790697674
"./Ship3_Latin-square/2019-09-18_10h00m_Subject 47797.txt","47797",2019-09-18,"10:00",16,38,28,6,4,10,53,9,5,67,27,8,4,39,43,10,6,59,4306.33333333333,400.851851851852,2348.11111111111,4349.2,5,23,28,96.4285714285714
"./Ship3_Latin-square/2019-09-18_11h19m_Subject 46900.txt","46900",2019-09-18,"11:19",2,79,60,9,10,19,15,0,0,15,79,31,21,131,1022,147,160,1329,103,241.266666666667,2894.84745762712,1294.25423728814,51,84,135,100
"./Ship3_Latin-square/2019-09-18_11h19m_Subject 46986.txt","46986",2019-09-18,"11:19",8,78,59,11,8,19,53,10,5,68,11,0,1,12,215,38,42,295,1111.84482758621,125.448275862069,2627.53448275862,3154.43902439024,112,59,171,81.3559322033898
"./Ship3_Latin-square/2019-09-18_11h19m_Subject 47076.txt","47076",2019-09-18,"11:19",0,76,60,7,9,16,19,3,0,22,22,3,10,35,926,85,166,1177,135.166666666667,148.8,2999.94915254237,1616.94545454545,79,177,256,93.4426229508197
"./Ship3_Latin-square/2019-09-18_11h19m_Subject 47079.txt","47079",2019-09-18,"11:19",24,78,60,11,7,18,56,11,12,79,68,13,7,88,209,7,29,245,461.9,288.6,1942.30508474576,1618.69811320755,93,58,151,91.8032786885246
"./Ship3_Latin-square/2019-09-18_11h19m_Subject 47082.txt","47082",2019-09-18,"11:19",0,84,60,10,14,24,14,1,6,21,67,22,8,97,425,90,102,617,487.216666666667,211.833333333333,2999.8813559322,1681.43636363636,58,62,120,96.7213114754098
"./Ship3_Latin-square/2019-09-18_11h19m_Subject 47092.txt","47092",2019-09-18,"11:19",24,71,60,8,3,11,44,4,7,55,46,7,2,55,444,6,39,489,197.85,201.483333333333,1942.28813559322,993.264150943396,65,58,123,90.1639344262295
"./Ship3_Latin-square/2019-09-18_11h19m_Subject 47098.txt","47098",2019-09-18,"11:19",16,78,60,9,9,18,18,0,1,19,17,0,9,26,157,14,31,202,308.633333333333,265.316666666667,2213.49152542373,1773.35483870968,75,76,151,67.2131147540984
"./Ship3_Latin-square/2019-09-18_11h19m_Subject 47226.txt","47226",2019-09-18,"11:19",0,78,60,4,14,18,17,1,2,20,58,5,21,84,1618,92,261,1971,153.216666666667,167.816666666667,2999.93220338983,1512.61016949153,16,100,116,100
"./Ship3_Latin-square/2019-09-18_11h19m_Subject 47227.txt","47227",2019-09-18,"11:19",0,80,60,7,13,20,15,1,1,17,17,8,7,32,854,114,201,1169,119.466666666667,128.2,2999.8813559322,1445.08474576271,12,107,119,100
"./Ship3_Latin-square/2019-09-18_11h19m_Subject 47250.txt","47250",2019-09-18,"11:19",24,77,60,9,8,17,49,5,10,64,16,7,8,31,333,4,80,417,232.516666666667,101.033333333333,1860.93220338983,1022.59574468085,38,53,91,86.8852459016393
"./Ship3_Latin-square/2019-09-18_11h19m_Subject 47645.txt","47645",2019-09-18,"11:19",8,79,58,14,7,21,94,21,11,126,22,7,1,30,290,53,59,402,1291.84482758621,164.035087719298,2691.15789473684,2219.51785714286,90,70,160,98.2758620689655
"./Ship3_Latin-square/2019-09-18_11h19m_Subject 47646.txt","47646",2019-09-18,"11:19",0,82,60,8,14,22,9,3,2,14,101,10,44,155,1586,185,428,2199,123.766666666667,139.916666666667,2999.89830508475,1673.76,49,205,254,90.1639344262295
"./Ship3_Latin-square/2019-09-18_11h19m_Subject 47755.txt","47755",2019-09-18,"11:19",4,78,60,8,10,18,40,3,4,47,22,14,3,39,675,100,118,893,268.666666666667,199.866666666667,2789.76271186441,1571.54385964912,65,158,223,98.3606557377049
"./Ship3_Latin-square/2019-09-18_11h19m_Subject 47760.txt","47760",2019-09-18,"11:19",24,84,60,14,10,24,55,8,12,75,52,11,9,72,465,6,139,610,299.433333333333,218.916666666667,1983.01694915254,1042.16071428571,37,25,62,96.7213114754098
"./Ship3_Latin-square/2019-09-18_11h19m_Subject 47770.txt","47770",2019-09-18,"11:19",16,44,33,6,5,11,53,8,3,64,29,17,5,51,96,20,17,133,4633.0625,702.375,2249.90625,5552.16,44,55,99,84.8484848484848
"./Ship3_Latin-square/2019-09-18_11h19m_Subject 47795.txt","47795",2019-09-18,"11:19",0,81,60,3,18,21,24,3,3,30,28,2,17,47,624,35,152,811,185.9,194.883333333333,2999.93220338983,1783.63793103448,26,52,78,98.3606557377049
"./Ship3_Latin-square/2019-09-18_11h22m_Subject 47229.txt","47229",2019-09-18,"11:22",24,81,60,14,7,21,59,0,14,73,47,21,6,74,359,7,65,431,256.016666666667,173.016666666667,1982.98305084746,1015.2,65,81,146,86.8852459016393
"./Ship3_Latin-square/2019-09-18_11h22m_Subject 47233.txt","47233",2019-09-18,"11:22",2,76,60,4,12,16,19,0,3,22,55,5,3,63,374,23,116,513,143.8,211.65,2877.91525423729,1817.89655172414,50,71,121,96.7213114754098
"./Ship3_Latin-square/2019-09-18_11h22m_Subject 47234.txt","47234",2019-09-18,"11:22",24,82,60,14,8,22,51,3,8,62,44,7,11,62,334,22,88,444,199.433333333333,170.233333333333,1983,1460.01923076923,91,61,152,88.5245901639344
"./Ship3_Latin-square/2019-09-18_11h22m_Subject 47237.txt","47237",2019-09-18,"11:22",24,86,60,17,9,26,44,1,6,51,28,12,4,44,367,12,76,455,422.2,225.483333333333,2064.35593220339,1102.3829787234,53,46,99,88.5245901639344
"./Ship3_Latin-square/2019-09-18_11h22m_Subject 47241.txt","47241",2019-09-18,"11:22",16,79,60,9,10,19,18,0,3,21,7,1,2,10,811,60,201,1072,93.6833333333333,126.733333333333,2159.27118644068,1079.48275862069,34,73,107,100
"./Ship3_Latin-square/2019-09-18_11h22m_Subject 47247.txt","47247",2019-09-18,"11:22",24,75,60,7,8,15,51,4,7,62,46,8,5,59,163,3,44,210,363.333333333333,240.1,1738.94915254237,1915.72972972973,44,94,138,72.1311475409836
"./Ship3_Latin-square/2019-09-18_11h22m_Subject 47777.txt","47777",2019-09-18,"11:22",0,82,60,4,18,22,37,3,10,50,14,2,15,31,472,44,130,646,377.783333333333,182.133333333333,2999.8813559322,2084.91379310345,40,86,126,100
"./Ship3_Latin-square/2019-09-18_11h22m_Subject 47784.txt","47784",2019-09-18,"11:22",24,74,60,8,6,14,155,10,38,203,61,9,11,81,472,7,41,520,556.6,192.75,1901.69491525424,991.610169491525,47,77,124,100
"./Ship3_Latin-square/2019-09-18_12h27m_Subject 46881.txt","46881",2019-09-18,"12:27",24,75,60,9,6,15,72,5,16,93,49,2,5,56,242,7,28,277,519.633333333333,172.633333333333,1901.59322033898,1478.22641509434,45,84,129,91.8032786885246
"./Ship3_Latin-square/2019-09-18_12h27m_Subject 47087.txt","47087",2019-09-18,"12:27",24,63,46,12,5,17,74,5,8,87,29,12,8,49,163,8,23,194,1060.71111111111,187.711111111111,2146.57777777778,2232.68181818182,77,28,105,97.8260869565217
"./Ship3_Latin-square/2019-09-18_12h27m_Subject 47626.txt","47626",2019-09-18,"12:27",0,79,60,7,12,19,64,4,1,69,34,5,11,50,256,42,50,348,550.95,170.766666666667,2999.8813559322,2501.02325581395,71,114,185,86.8852459016393
"./Ship3_Latin-square/2019-09-18_12h27m_Subject 47632.txt","47632",2019-09-18,"12:27",4,79,60,10,9,19,16,4,0,20,31,23,10,64,1063,155,169,1387,95.8666666666667,194.833333333333,2803.30508474576,1193.79661016949,38,93,131,100
"./Ship3_Latin-square/2019-09-18_12h27m_Subject 47634.txt","47634",2019-09-18,"12:27",24,81,60,14,7,21,53,6,8,67,33,6,6,45,217,11,43,271,460.083333333333,176.866666666667,2023.66101694915,1535.32,96,35,131,85.2459016393443
"./Ship3_Latin-square/2019-09-18_12h27m_Subject 47640.txt","47640",2019-09-18,"12:27",24,79,60,11,8,19,49,16,12,77,52,13,11,76,252,3,77,332,509.433333333333,238.133333333333,1942.33898305085,1058.82222222222,48,59,107,80.327868852459
"./Ship3_Latin-square/2019-09-18_12h27m_Subject 47754.txt","47754",2019-09-18,"12:27",16,64,48,12,4,16,45,9,3,57,30,10,4,44,108,27,15,150,2311.3829787234,261.872340425532,2421.23404255319,3044.35,34,57,91,87.5
"./Ship3_Latin-square/2019-09-18_12h27m_Subject 47800.txt","47800",2019-09-18,"12:27",0,82,60,9,13,22,37,5,7,49,70,11,23,104,652,82,150,884,271.116666666667,204.866666666667,2999.84745762712,1283.79661016949,39,107,146,100
"./Ship3_Latin-square/2019-09-18_12h29m_Subject 46880.txt","46880",2019-09-18,"12:29",0,81,60,9,12,21,10,5,2,17,40,19,4,63,926,102,233,1261,69.0333333333333,154.1,2999.94915254237,2044.51020408163,79,340,419,88.5245901639344
"./Ship3_Latin-square/2019-09-18_12h29m_Subject 46882.txt","46882",2019-09-18,"12:29",24,83,60,14,9,23,62,3,12,77,35,47,19,101,332,11,68,411,615.15,310.216666666667,2023.67796610169,1958,59,112,171,72.1311475409836
"./Ship3_Latin-square/2019-09-18_12h29m_Subject 46883.txt","46883",2019-09-18,"12:29",4,79,60,8,11,19,23,2,7,32,166,45,5,216,359,42,93,494,276.016666666667,445.4,2783,1769.82456140351,44,87,131,96.7213114754098
"./Ship3_Latin-square/2019-09-18_12h29m_Subject 46894.txt","46894",2019-09-18,"12:29",16,82,60,10,12,22,41,6,8,55,44,6,2,52,370,44,90,504,785.9,187.633333333333,2132.16949152542,957.905660377358,79,31,110,96.7213114754098
"./Ship3_Latin-square/2019-09-18_12h29m_Subject 46896.txt","46896",2019-09-18,"12:29",24,83,60,14,9,23,39,6,8,53,35,5,6,46,349,24,77,450,319.383333333333,309.083333333333,1942.28813559322,1297.08695652174,28,75,103,81.9672131147541
"./Ship3_Latin-square/2019-09-18_12h29m_Subject 47088.txt","47088",2019-09-18,"12:29",2,81,60,7,14,21,20,2,2,24,48,2,13,63,1161,154,297,1612,117.733333333333,177.833333333333,2874.52542372881,1148.4406779661,51,94,145,100
"./Ship3_Latin-square/2019-09-18_12h29m_Subject 47228.txt","47228",2019-09-18,"12:29",16,79,60,11,8,19,12,6,0,18,23,4,5,32,470,59,107,636,151.4,115.516666666667,2213.52542372881,1267.41509433962,25,74,99,93.4426229508197
"./Ship3_Latin-square/2019-09-18_12h29m_Subject 47243.txt","47243",2019-09-18,"12:29",16,81,60,13,8,21,80,5,10,95,18,3,1,22,470,70,57,597,484.8,135.05,2321.93220338983,1401.72413793103,127,45,172,98.3606557377049
"./Ship3_Latin-square/2019-09-18_12h29m_Subject 47249.txt","47249",2019-09-18,"12:29",2,76,60,8,8,16,26,4,8,38,75,12,23,110,412,49,62,523,201.383333333333,249.45,2901.66101694915,1301.68965517241,66,56,122,98.3606557377049
"./Ship3_Latin-square/2019-09-18_12h29m_Subject 47639.txt","47639",2019-09-18,"12:29",16,80,60,12,8,20,43,1,5,49,27,9,3,39,380,49,59,488,323.233333333333,179.633333333333,2267.67796610169,1468.63043478261,54,74,128,85.2459016393443
"./Ship3_Latin-square/2019-09-18_12h29m_Subject 47649.txt","47649",2019-09-18,"12:29",24,65,48,12,5,17,59,6,6,71,11,1,1,13,150,11,13,174,2147.60416666667,330.541666666667,2149.91666666667,2487.61290322581,49,63,112,71.4285714285714
"./Ship3_Latin-square/2019-09-18_12h29m_Subject 47758.txt","47758",2019-09-18,"12:29",2,79,60,8,11,19,14,1,6,21,23,6,21,50,810,104,148,1062,153.083333333333,112.516666666667,2881.30508474576,1495.08620689655,44,85,129,100
"./Ship3_Latin-square/2019-09-18_12h29m_Subject 47759.txt","47759",2019-09-18,"12:29",2,82,60,8,14,22,21,2,0,23,17,6,10,33,576,72,155,803,158.85,143.2,2888.1186440678,1562.98214285714,37,79,116,98.3606557377049
"./Ship3_Latin-square/2019-09-18_12h29m_Subject 47776.txt","47776",2019-09-18,"12:29",16,81,60,12,9,21,12,0,3,15,56,24,14,94,735,88,132,955,89.7833333333333,157.683333333333,2267.72881355932,1066.79661016949,41,16,57,100
"./Ship3_Latin-square/2019-09-18_12h29m_Subject 47799.txt","47799",2019-09-18,"12:29",2,82,60,11,11,22,25,3,1,29,58,26,17,101,619,107,176,902,232.1,193.9,2898.27118644068,1518.21052631579,63,29,92,98.3606557377049
"./Ship3_Latin-square/2019-09-18_13h38m_Subject 46888.txt","46888",2019-09-18,"13:38",0,81,60,6,15,21,2,0,2,4,55,13,10,78,995,111,231,1337,42.9833333333333,210.5,2999.84745762712,1767.59322033898,43,96,139,100
"./Ship3_Latin-square/2019-09-18_13h38m_Subject 46889.txt","46889",2019-09-18,"13:38",2,79,60,7,12,19,8,1,0,9,22,7,10,39,1208,160,224,1592,51.7666666666667,185.183333333333,2877.94915254237,1553.21568627451,50,339,389,90.1639344262295
"./Ship3_Latin-square/2019-09-18_13h38m_Subject 46890.txt","46890",2019-09-18,"13:38",16,82,60,13,9,22,16,7,1,24,12,9,1,22,185,34,40,259,472.55,139.316666666667,2294.79661016949,2363.55172413793,129,67,196,65.5737704918033
"./Ship3_Latin-square/2019-09-18_13h38m_Subject 46892.txt","46892",2019-09-18,"13:38",2,84,60,10,14,24,8,3,1,12,22,1,11,34,1027,177,237,1441,83.7333333333333,137.4,2888.10169491525,1342.86440677966,63,87,150,100
"./Ship3_Latin-square/2019-09-18_13h38m_Subject 46898.txt","46898",2019-09-18,"13:38",8,71,60,5,6,11,22,1,2,25,18,0,2,20,537,54,51,642,121.9,228.3,2606.62711864407,1762.0350877193,34,98,132,96.7213114754098
"./Ship3_Latin-square/2019-09-18_13h38m_Subject 47097.txt","47097",2019-09-18,"13:38",24,79,60,12,7,19,71,3,11,85,82,20,6,108,365,2,55,422,276.116666666667,251.033333333333,2023.64406779661,1282.53448275862,101,34,135,100
"./Ship3_Latin-square/2019-09-18_13h38m_Subject 47099.txt","47099",2019-09-18,"13:38",2,78,60,7,11,18,4,0,0,4,48,8,12,68,1536,178,291,2005,55.25,162.716666666667,2888.10169491525,1262.20689655172,53,157,210,100
"./Ship3_Latin-square/2019-09-18_13h38m_Subject 47798.txt","47798",2019-09-18,"13:38",4,82,60,7,15,22,30,2,5,37,29,0,4,33,259,30,68,357,497.15,333.9,2749.15254237288,2239.63829787234,42,95,137,91.8032786885246
"./Ship3_Latin-square/2019-09-18_13h40m_Subject 46876.txt","46876",2019-09-18,"13:40",0,79,60,8,11,19,29,6,5,40,4,0,1,5,599,88,171,858,202.866666666667,74.7333333333333,2999.84745762712,1620.95918367347,67,148,215,95.0819672131148
"./Ship3_Latin-square/2019-09-18_13h40m_Subject 46877.txt","46877",2019-09-18,"13:40",16,84,60,14,10,24,25,2,8,35,43,49,123,215,785,104,205,1094,98.9833333333333,165.666666666667,2321.96610169492,1421.03921568627,62,268,330,88.5245901639344
"./Ship3_Latin-square/2019-09-18_13h40m_Subject 46893.txt","46893",2019-09-18,"13:40",16,79,60,12,7,19,18,1,2,21,44,6,3,53,899,144,134,1177,78.9166666666667,175.733333333333,2267.77966101695,965.423728813559,56,54,110,98.3606557377049
"./Ship3_Latin-square/2019-09-18_13h40m_Subject 46895.txt","46895",2019-09-18,"13:40",24,76,53,14,9,23,52,15,17,84,47,10,11,68,141,4,54,199,912.452830188679,277.150943396226,2030.73076923077,1953.725,41,53,94,77.7777777777778
"./Ship3_Latin-square/2019-09-18_13h40m_Subject 47638.txt","47638",2019-09-18,"13:40",16,78,60,12,6,18,63,11,10,84,33,4,9,46,249,32,21,302,569.116666666667,174.85,2349.06779661017,1959.09090909091,87,28,115,93.4426229508197
"./Ship3_Latin-square/2019-09-18_13h40m_Subject 47757.txt","47757",2019-09-18,"13:40",2,80,58,8,14,22,78,8,16,102,32,5,16,53,308,40,75,423,1026.65517241379,218.258620689655,2882.74137931034,2168.67924528302,55,125,180,91.5254237288136
"./Ship3_Latin-square/2019-09-18_13h40m_Subject 47769.txt","47769",2019-09-18,"13:40",16,84,60,14,10,24,43,6,20,69,36,13,11,60,445,57,94,596,236.916666666667,167.5,2294.89830508475,1461.47368421053,85,78,163,98.3606557377049
"./Ship3_Latin-square/2019-09-18_13h40m_Subject 47771.txt","47771",2019-09-18,"13:40",0,80,60,7,13,20,20,1,3,24,11,12,1,24,776,87,143,1006,124.866666666667,115.183333333333,2999.93220338983,1471.76785714286,17,127,144,96.7213114754098
"./Ship3_Latin-square/2019-09-18_13h40m_Subject 47775.txt","47775",2019-09-18,"13:40",0,83,60,9,14,23,36,1,11,48,9,4,1,14,504,96,121,721,246.016666666667,108.4,2999.93220338983,1307.05172413793,24,31,55,98.3606557377049
"./Ship3_Latin-square/2019-09-18_13h40m_Subject 47781.txt","47781",2019-09-18,"13:40",24,82,60,13,9,22,27,0,3,30,46,19,12,77,525,17,122,664,186.016666666667,187.116666666667,1982.96610169492,1171.5652173913,44,66,110,80.327868852459
"./Ship3_Latin-square/2019-09-18_13h40m_Subject 47782.txt","47782",2019-09-18,"13:40",2,84,60,11,13,24,14,1,1,16,12,1,7,20,883,165,202,1250,62.4166666666667,115.116666666667,2891.50847457627,1270.84482758621,54,48,102,96.7213114754098
"./Ship3_Latin-square/2019-09-18_13h40m_Subject 47783.txt","47783",2019-09-18,"13:40",24,71,54,10,7,17,97,10,17,124,34,7,3,44,244,6,57,307,1458.52830188679,199.056603773585,1958.37735849057,2054.42857142857,54,45,99,94.4444444444444
"./Ship3_Latin-square/2019-09-18_13h40m_Subject 47785.txt","47785",2019-09-18,"13:40",24,85,60,15,10,25,38,2,15,55,34,27,11,72,488,9,168,665,248.766666666667,165.033333333333,1942.32203389831,1669.92682926829,120,75,195,77.0491803278689
"./Ship3_Latin-square/2019-09-18_13h40m_Subject 47786.txt","47786",2019-09-18,"13:40",16,61,45,8,8,16,58,5,7,70,32,3,12,47,175,14,54,243,1715.53333333333,937.977272727273,2236.29545454545,2713.11904761905,46,28,74,97.7777777777778
"./Ship3_Latin-square/2019-09-18_13h40m_Subject 47788.txt","47788",2019-09-18,"13:40",2,84,60,9,15,24,38,6,9,53,93,23,78,194,739,112,195,1046,182.266666666667,256.5,2884.72881355932,1561.8275862069,40,79,119,98.3606557377049
"./Ship3_Latin-square/2019-09-18_14h42m_Subject 47080.txt","47080",2019-09-18,"14:42",0,75,60,4,11,15,6,0,3,9,68,2,17,87,1396,62,194,1652,70.9,173.8,2999.89830508475,1435.8275862069,43,175,218,98.3606557377049
"./Ship3_Latin-square/2019-09-18_14h42m_Subject 47089.txt","47089",2019-09-18,"14:42",24,72,52,17,3,20,81,12,6,99,63,25,3,91,214,2,16,232,1662.36538461538,271.607843137255,2529.41176470588,3093.17647058824,122,21,143,100
"./Ship3_Latin-square/2019-09-18_14h42m_Subject 47762.txt","47762",2019-09-18,"14:42",4,80,60,10,10,20,62,10,6,78,24,10,12,46,259,40,72,371,844.55,381.733333333333,2803.37288135593,2438.04,79,100,179,88.5245901639344
"./Ship3_Latin-square/2019-09-18_14h42m_Subject 47791.txt","47791",2019-09-18,"14:42",2,77,60,7,10,17,13,1,1,15,20,10,5,35,711,86,125,922,151.666666666667,157.216666666667,2884.72881355932,1176.20338983051,17,34,51,100
"./Ship3_Latin-square/2019-09-19_10h01m_Subject 46884.txt","46884",2019-09-19,"10:01",0,78,60,11,7,18,29,4,2,35,20,4,9,33,262,60,25,347,412.766666666667,163.566666666667,2999.89830508475,2829.0625,118,126,244,66.6666666666667
"./Ship3_Latin-square/2019-09-19_10h01m_Subject 47083.txt","47083",2019-09-19,"10:01",2,71,50,5,16,21,64,8,6,78,57,5,30,92,275,21,88,384,1742.94,391.52,2855.96,2531.70454545455,62,95,157,90.1960784313726
"./Ship3_Latin-square/2019-09-19_10h01m_Subject 47086.txt","47086",2019-09-19,"10:01",16,77,60,9,8,17,34,1,3,38,29,5,4,38,328,37,45,410,311.95,219.816666666667,2213.50847457627,1419.01754385965,39,71,110,96.7213114754098
"./Ship3_Latin-square/2019-09-19_10h01m_Subject 47246.txt","47246",2019-09-19,"10:01",0,82,60,8,14,22,33,8,2,43,9,6,5,20,342,59,87,488,273.516666666667,155.666666666667,2999.86440677966,2320.20754716981,37,129,166,93.4426229508197
"./Ship3_Latin-square/2019-09-19_10h01m_Subject 47635.txt","47635",2019-09-19,"10:01",4,79,60,7,12,19,24,4,5,33,52,7,4,63,590,83,109,782,271.683333333333,193.633333333333,2776.23728813559,1565.27118644068,66,77,143,100
"./Ship3_Latin-square/2019-09-19_10h01m_Subject 47779.txt","47779",2019-09-19,"10:01",4,82,60,10,12,22,58,15,4,77,71,50,31,152,178,28,39,245,757.783333333333,217.883333333333,2783,3413.71794871795,101,86,187,72.1311475409836
"./Ship3_Latin-square/2019-09-19_10h01m_Subject 47790.txt","47790",2019-09-19,"10:01",4,83,60,12,11,23,58,33,33,124,43,23,19,85,267,73,70,410,748.583333333333,219.65,2789.72881355932,2428.78723404255,49,130,179,85.2459016393443
"./Ship3_Latin-square/2019-09-19_10h01m_Subject 47797.txt","47797",2019-09-19,"10:01",8,50,39,6,5,11,43,5,4,52,84,23,4,111,103,27,14,144,3702.5,918.368421052632,2620.97368421053,3048.38235294118,14,69,83,92.3076923076923
"./Ship3_Latin-square/2019-09-19_10h07m_Subject 46878.txt","46878",2019-09-19,"10:07",4,79,60,8,11,19,22,0,2,24,27,3,1,31,997,136,131,1264,126.166666666667,211.416666666667,2782.98305084746,1576.91525423729,78,90,168,100
"./Ship3_Latin-square/2019-09-19_10h07m_Subject 46885.txt","46885",2019-09-19,"10:07",2,81,60,12,9,21,43,15,9,67,11,5,4,20,353,77,35,465,432.383333333333,124.05,2905.06779661017,2050.03571428571,84,59,143,96.7213114754098
"./Ship3_Latin-square/2019-09-19_10h07m_Subject 46899.txt","46899",2019-09-19,"10:07",24,79,60,14,5,19,117,4,21,142,29,5,12,46,436,10,46,492,655.316666666667,151.25,2145.76271186441,971.28813559322,58,25,83,100
"./Ship3_Latin-square/2019-09-19_10h07m_Subject 47081.txt","47081",2019-09-19,"10:07",16,84,60,12,12,24,72,7,1,80,9,5,8,22,349,42,101,492,339.933333333333,116.6,2186.42372881356,1386.96363636364,51,114,165,93.4426229508197
"./Ship3_Latin-square/2019-09-19_10h07m_Subject 47091.txt","47091",2019-09-19,"10:07",24,78,60,8,10,18,53,7,5,65,70,12,32,114,214,6,62,282,421.416666666667,240.633333333333,1738.93220338983,1129.03703703704,57,80,137,91.8032786885246
"./Ship3_Latin-square/2019-09-19_10h07m_Subject 47231.txt","47231",2019-09-19,"10:07",24,81,59,15,7,22,64,27,7,98,22,25,3,50,186,23,26,235,907.864406779661,143.271186440678,2048.22413793103,1891.78431372549,55,39,94,91.6666666666667
"./Ship3_Latin-square/2019-09-19_10h07m_Subject 47238.txt","47238",2019-09-19,"10:07",24,79,60,13,6,19,41,1,5,47,35,36,8,79,333,18,54,405,281.816666666667,175.383333333333,2064.37288135593,751.688888888889,31,70,101,78.6885245901639
"./Ship3_Latin-square/2019-09-19_10h07m_Subject 47242.txt","47242",2019-09-19,"10:07",24,80,60,11,9,20,149,3,12,164,154,13,29,196,320,0,87,407,513.2,390.016666666667,1901.64406779661,1258.06382978723,48,104,152,83.6065573770492
"./Ship3_Latin-square/2019-09-19_10h07m_Subject 47244.txt","47244",2019-09-19,"10:07",2,80,60,9,11,20,21,7,1,29,82,12,21,115,835,143,149,1127,207.033333333333,269.533333333333,2894.86440677966,1604.57627118644,88,103,191,100
"./Ship3_Latin-square/2019-09-19_10h07m_Subject 47633.txt","47633",2019-09-19,"10:07",4,81,60,9,12,21,27,2,10,39,72,16,16,104,500,73,94,667,313.15,265.4,2789.72881355932,1699.86440677966,71,119,190,100
"./Ship3_Latin-square/2019-09-19_10h07m_Subject 47636.txt","47636",2019-09-19,"10:07",16,83,59,16,8,24,74,9,6,89,65,31,9,105,296,60,37,393,1017.54237288136,259.949152542373,2403.30508474576,2357.9649122807,145,75,220,98.3333333333333
"./Ship3_Latin-square/2019-09-19_10h07m_Subject 47752.txt","47752",2019-09-19,"10:07",24,85,60,17,8,25,74,20,14,108,41,34,8,83,316,27,65,408,570.666666666667,155.466666666667,2186.37288135593,1576.50943396226,76,48,124,93.4426229508197
"./Ship3_Latin-square/2019-09-19_10h07m_Subject 47767.txt","47767",2019-09-19,"10:07",24,67,52,10,5,15,121,9,14,144,40,25,5,70,161,7,13,181,2187.5,285.5,2030.71153846154,2313.77272727273,63,50,113,88.6792452830189
"./Ship3_Latin-square/2019-09-19_10h07m_Subject 47768.txt","47768",2019-09-19,"10:07",16,49,36,11,2,13,51,19,2,72,31,15,3,49,135,18,11,164,1977.11428571429,193.028571428571,2542.8,4747.61290322581,52,24,76,91.6666666666667
"./Ship3_Latin-square/2019-09-19_10h07m_Subject 47780.txt","47780",2019-09-19,"10:07",8,81,60,10,11,21,50,7,5,62,55,8,18,81,368,55,79,502,319.45,245.95,2579.62711864407,1611.10169491525,73,49,122,100
"./Ship3_Latin-square/2019-09-19_11h21m_Subject 47229.txt","47229",2019-09-19,"11:21",0,78,60,6,12,18,9,5,3,17,44,11,9,64,982,92,223,1297,72.5,170.75,2999.8813559322,1377.30508474576,49,76,125,100
"./Ship3_Latin-square/2019-09-19_11h21m_Subject 47233.txt","47233",2019-09-19,"11:21",0,85,60,5,20,25,37,1,12,50,29,15,26,70,439,25,180,644,222.416666666667,151.966666666667,2999.86440677966,1816.63636363636,29,132,161,95
"./Ship3_Latin-square/2019-09-19_11h21m_Subject 47234.txt","47234",2019-09-19,"11:21",16,82,60,13,9,22,48,4,8,60,176,15,19,210,352,86,101,539,606.9,435.216666666667,2294.77966101695,1225.96428571429,26,78,104,95.0819672131148
"./Ship3_Latin-square/2019-09-19_11h21m_Subject 47237.txt","47237",2019-09-19,"11:21",2,79,60,10,9,19,28,2,2,32,17,17,28,62,781,87,177,1045,145.15,125.966666666667,2901.67796610169,1190.72413793103,28,72,100,98.3606557377049
"./Ship3_Latin-square/2019-09-19_11h21m_Subject 47241.txt","47241",2019-09-19,"11:21",8,79,60,6,13,19,16,0,2,18,6,4,2,12,917,77,269,1263,83.6166666666667,137.616666666667,2511.79661016949,1409.91525423729,30,100,130,100
"./Ship3_Latin-square/2019-09-19_11h21m_Subject 47247.txt","47247",2019-09-19,"11:21",2,75,60,5,10,15,9,1,0,10,25,1,3,29,542,60,60,662,120.1,181.75,2884.69491525424,1766.0701754386,95,71,166,96.7213114754098
"./Ship3_Latin-square/2019-09-19_11h21m_Subject 47777.txt","47777",2019-09-19,"11:21",24,72,53,11,8,19,117,14,19,150,34,10,9,53,132,7,19,158,1850.71153846154,207.153846153846,1938.46153846154,2654.22448979592,34,48,82,96.2264150943396
"./Ship3_Latin-square/2019-09-19_11h21m_Subject 47784.txt","47784",2019-09-19,"11:21",2,81,60,6,15,21,23,2,6,31,60,18,24,102,1089,110,256,1455,128.25,252.566666666667,2871.1186440678,1498.94915254237,53,126,179,100
"./Ship3_Latin-square/2019-09-19_11h25m_Subject 46900.txt","46900",2019-09-19,"11:25",0,80,60,8,12,20,19,1,46,66,80,16,5,101,1156,188,255,1599,101.95,232.05,2999.8813559322,1019.10526315789,38,153,191,98.3606557377049
"./Ship3_Latin-square/2019-09-19_11h25m_Subject 46986.txt","46986",2019-09-19,"11:25",24,61,45,12,4,16,75,8,8,91,29,28,5,62,155,11,25,191,1352.79545454545,278.113636363636,2290.84090909091,3218.60526315789,115,29,144,88.8888888888889
"./Ship3_Latin-square/2019-09-19_11h25m_Subject 47076.txt","47076",2019-09-19,"11:25",24,77,60,13,4,17,63,3,7,73,49,16,4,69,460,8,45,513,301.133333333333,217.366666666667,2064.37288135593,842.466666666667,50,101,151,80.327868852459
"./Ship3_Latin-square/2019-09-19_11h25m_Subject 47079.txt","47079",2019-09-19,"11:25",2,76,60,7,9,16,18,0,4,22,71,7,10,88,372,57,71,500,240.95,271.283333333333,2898.25423728814,1513.06779661017,38,53,91,100
"./Ship3_Latin-square/2019-09-19_11h25m_Subject 47082.txt","47082",2019-09-19,"11:25",24,73,54,11,8,19,73,10,5,88,63,17,7,87,217,13,38,268,1842.22222222222,276.074074074074,1913.16981132075,2941.59523809524,89,65,154,81.8181818181818
"./Ship3_Latin-square/2019-09-19_11h25m_Subject 47092.txt","47092",2019-09-19,"11:25",2,76,60,6,10,16,15,3,3,21,39,13,4,56,894,101,123,1118,77.4666666666667,188.7,2888.06779661017,1512.5593220339,80,68,148,100
"./Ship3_Latin-square/2019-09-19_11h25m_Subject 47098.txt","47098",2019-09-19,"11:25",0,84,60,10,14,24,17,0,1,18,10,0,21,31,310,37,79,426,160.35,107.216666666667,2999.93220338983,1870.47058823529,54,106,160,86.8852459016393
"./Ship3_Latin-square/2019-09-19_11h25m_Subject 47226.txt","47226",2019-09-19,"11:25",24,80,60,9,11,20,56,3,22,81,64,27,12,103,558,45,220,823,466.7,148.133333333333,1738.93220338983,884.744680851064,71,64,135,83.6065573770492
"./Ship3_Latin-square/2019-09-19_11h25m_Subject 47227.txt","47227",2019-09-19,"11:25",24,84,60,14,10,24,77,26,8,111,28,16,29,73,318,8,103,429,475.25,143.566666666667,1982.93220338983,1050.54901960784,43,56,99,91.8032786885246
"./Ship3_Latin-square/2019-09-19_11h25m_Subject 47250.txt","47250",2019-09-19,"11:25",0,84,60,7,17,24,21,0,3,24,21,4,24,49,1004,110,257,1371,125.766666666667,121.766666666667,2999.91525423729,1220.41379310345,23,67,90,96.7213114754098
"./Ship3_Latin-square/2019-09-19_11h25m_Subject 47645.txt","47645",2019-09-19,"11:25",24,47,32,13,2,15,108,26,6,140,19,12,3,34,153,11,17,181,2783.28125,553.0625,2690.25806451613,5259.8064516129,83,15,98,100
"./Ship3_Latin-square/2019-09-19_11h25m_Subject 47646.txt","47646",2019-09-19,"11:25",24,82,60,12,10,22,39,3,16,58,69,29,11,109,735,10,232,977,345.783333333333,173.683333333333,1860.94915254237,1116.53846153846,33,93,126,77.0491803278689
"./Ship3_Latin-square/2019-09-19_11h25m_Subject 47755.txt","47755",2019-09-19,"11:25",24,84,60,13,11,24,119,11,28,158,34,3,9,46,362,20,120,502,580.55,260.05,1942.33898305085,1886.72727272727,76,130,206,81.9672131147541
"./Ship3_Latin-square/2019-09-19_11h25m_Subject 47760.txt","47760",2019-09-19,"11:25",2,80,60,10,10,20,45,7,9,61,38,11,12,61,902,173,143,1218,142.516666666667,231.983333333333,2894.86440677966,1256.59322033898,38,35,73,100
"./Ship3_Latin-square/2019-09-19_11h25m_Subject 47770.txt","47770",2019-09-19,"11:25",4,46,33,4,9,13,46,6,5,57,101,18,103,222,104,27,17,148,3848.87878787879,896.939393939394,2733.30303030303,5433.29166666667,32,101,133,79.4117647058823
"./Ship3_Latin-square/2019-09-19_11h25m_Subject 47795.txt","47795",2019-09-19,"11:25",24,75,54,14,7,21,124,21,12,157,53,33,26,112,157,6,31,194,1015.5,264.851851851852,2111.05555555556,1922.44,72,46,118,94.5454545454545
"./Ship3_Latin-square/2019-09-19_12h45m_Subject 46880.txt","46880",2019-09-19,"12:45",24,83,60,13,10,23,46,0,13,59,9,15,4,28,415,1,70,486,271.7,107.066666666667,1982.94915254237,1418.41025641026,87,71,158,73.7704918032787
"./Ship3_Latin-square/2019-09-19_12h45m_Subject 46882.txt","46882",2019-09-19,"12:45",0,81,60,9,12,21,12,3,4,19,62,11,18,91,832,160,199,1191,120.733333333333,172.316666666667,2999.84745762712,1683.5,24,72,96,96.7213114754098
"./Ship3_Latin-square/2019-09-19_12h45m_Subject 46883.txt","46883",2019-09-19,"12:45",24,79,60,11,8,19,72,6,15,93,52,16,8,76,191,0,32,223,554.133333333333,198.166666666667,1982.98305084746,1914.71111111111,56,66,122,78.6885245901639
"./Ship3_Latin-square/2019-09-19_12h45m_Subject 46894.txt","46894",2019-09-19,"12:45",2,75,60,4,11,15,52,2,5,59,39,5,3,47,493,43,78,614,599.433333333333,183.9,2877.8813559322,1516.93220338983,32,45,77,98.3606557377049
"./Ship3_Latin-square/2019-09-19_12h45m_Subject 46896.txt","46896",2019-09-19,"12:45",2,85,60,9,16,25,19,5,4,28,45,13,15,73,803,134,227,1164,207.483333333333,196.65,2881.30508474576,1439.48275862069,26,72,98,98.3606557377049
"./Ship3_Latin-square/2019-09-19_12h45m_Subject 47088.txt","47088",2019-09-19,"12:45",8,81,60,9,12,21,41,2,4,47,68,9,20,97,899,83,219,1201,177.716666666667,232.566666666667,2566.01694915254,1182.41071428571,55,156,211,95.0819672131148
"./Ship3_Latin-square/2019-09-19_12h45m_Subject 47228.txt","47228",2019-09-19,"12:45",2,77,60,5,12,17,12,2,0,14,16,5,10,31,684,58,146,888,277.716666666667,114.366666666667,2877.93220338983,1750.31034482759,41,75,116,98.3606557377049
"./Ship3_Latin-square/2019-09-19_12h45m_Subject 47243.txt","47243",2019-09-19,"12:45",2,81,60,14,7,21,39,11,7,57,35,14,3,52,668,115,90,873,620.55,178.566666666667,2918.59322033898,2105.14035087719,126,57,183,98.3606557377049
"./Ship3_Latin-square/2019-09-19_12h45m_Subject 47249.txt","47249",2019-09-19,"12:45",8,80,60,11,9,20,48,11,1,60,78,21,15,114,232,44,53,329,421.566666666667,216.166666666667,2647.45762711864,2148.41818181818,64,71,135,93.4426229508197
"./Ship3_Latin-square/2019-09-19_12h45m_Subject 47639.txt","47639",2019-09-19,"12:45",2,78,60,7,11,18,15,0,1,16,1,6,3,10,908,109,157,1174,134.083333333333,100.9,2894.84745762712,1646.98245614035,65,69,134,96.7213114754098
"./Ship3_Latin-square/2019-09-19_12h45m_Subject 47649.txt","47649",2019-09-19,"12:45",2,83,60,10,13,23,31,6,3,40,20,9,1,30,369,51,101,521,470.966666666667,153.366666666667,2888.08474576271,1803.57142857143,35,185,220,78.6885245901639
"./Ship3_Latin-square/2019-09-19_12h45m_Subject 47753.txt","47753",2019-09-19,"12:45",4,83,60,9,14,23,120,31,11,162,58,89,7,154,556,90,134,780,584.616666666667,205.616666666667,2776.25423728814,1718.70175438596,77,135,212,96.7213114754098
"./Ship3_Latin-square/2019-09-19_12h45m_Subject 47758.txt","47758",2019-09-19,"12:45",8,80,60,9,11,20,12,1,3,16,36,1,2,39,770,108,154,1032,97.2333333333333,128.366666666667,2579.61016949153,1282.47457627119,68,40,108,100
"./Ship3_Latin-square/2019-09-19_12h45m_Subject 47759.txt","47759",2019-09-19,"12:45",8,82,60,11,11,22,23,3,3,29,17,1,34,52,527,70,133,730,149.833333333333,111.566666666667,2579.59322033898,1367.23636363636,39,89,128,98.3606557377049
"./Ship3_Latin-square/2019-09-19_12h45m_Subject 47776.txt","47776",2019-09-19,"12:45",2,80,60,9,11,20,13,2,2,17,55,24,15,94,974,152,164,1290,88.7833333333333,171.65,2888.08474576271,1531.16949152542,43,69,112,100
"./Ship3_Latin-square/2019-09-19_12h45m_Subject 47799.txt","47799",2019-09-19,"12:45",8,82,60,12,10,22,12,2,3,17,96,80,11,187,548,102,106,756,148.466666666667,347.916666666667,2606.72881355932,1434.26785714286,89,41,130,95.0819672131148
"./Ship3_Latin-square/2019-09-19_12h48m_Subject 46881.txt","46881",2019-09-19,"12:48",0,84,60,11,13,24,39,2,2,43,22,6,0,28,529,61,150,740,291.783333333333,129.5,2999.86440677966,1842.07843137255,43,128,171,90.1639344262295
"./Ship3_Latin-square/2019-09-19_12h48m_Subject 47087.txt","47087",2019-09-19,"12:48",0,79,60,7,12,19,18,2,4,24,56,6,23,85,327,42,50,419,227.366666666667,135.7,2999.93220338983,1973.1186440678,47,35,82,100
"./Ship3_Latin-square/2019-09-19_12h48m_Subject 47626.txt","47626",2019-09-19,"12:48",24,57,42,11,4,15,80,8,11,99,25,7,2,34,158,1,24,183,3554.31707317073,194.926829268293,2180.39024390244,3011.75675675676,66,32,98,92.8571428571429
"./Ship3_Latin-square/2019-09-19_12h48m_Subject 47632.txt","47632",2019-09-19,"12:48",0,78,60,9,9,18,5,3,2,10,26,9,23,58,1228,157,198,1583,62.85,134.25,2999.93220338983,1129.76271186441,41,110,151,100
"./Ship3_Latin-square/2019-09-19_12h48m_Subject 47634.txt","47634",2019-09-19,"12:48",0,80,60,8,12,20,30,3,6,39,8,3,8,19,440,77,97,614,315.7,128.633333333333,2999.89830508475,1540.42857142857,90,56,146,95.0819672131148
"./Ship3_Latin-square/2019-09-19_12h48m_Subject 47640.txt","47640",2019-09-19,"12:48",0,78,60,10,8,18,31,9,5,45,25,3,5,33,750,163,122,1035,448.116666666667,135.266666666667,2999.91525423729,2215.78947368421,53,118,171,98.3606557377049
"./Ship3_Latin-square/2019-09-19_12h48m_Subject 47754.txt","47754",2019-09-19,"12:48",2,67,49,8,10,18,49,7,6,62,62,17,49,128,303,48,80,431,1552.79166666667,238.083333333333,2891.64583333333,2758.05882352941,30,191,221,75.5102040816327
"./Ship3_Latin-square/2019-09-19_12h48m_Subject 47800.txt","47800",2019-09-19,"12:48",16,81,60,9,12,21,21,8,8,37,44,10,6,60,441,53,104,598,189.916666666667,175.166666666667,2132.13559322034,1171.33898305085,31,56,87,100
"./Ship3_Latin-square/2019-09-19_13h57m_Subject 46888.txt","46888",2019-09-19,"13:57",16,82,60,12,10,22,11,3,3,17,34,22,8,64,693,99,139,931,126.966666666667,144.483333333333,2267.71186440678,1387.30909090909,67,83,150,93.4426229508197
"./Ship3_Latin-square/2019-09-19_13h57m_Subject 46889.txt","46889",2019-09-19,"13:57",0,81,60,5,16,21,6,0,0,6,9,1,7,17,1169,108,254,1531,83.8,152.916666666667,2999.94915254237,1562,37,410,447,86.8852459016393
"./Ship3_Latin-square/2019-09-19_13h57m_Subject 46890.txt","46890",2019-09-19,"13:57",0,79,60,7,12,19,30,1,4,35,6,6,10,22,423,66,74,563,399.8,99.1833333333333,2999.94915254237,2103.44444444444,79,140,219,85.2459016393443
"./Ship3_Latin-square/2019-09-19_13h57m_Subject 46892.txt","46892",2019-09-19,"13:57",8,77,60,7,10,17,8,1,2,11,16,3,4,23,755,101,115,971,83.5333333333333,106.133333333333,2566.08474576271,1412.30508474576,63,89,152,100
"./Ship3_Latin-square/2019-09-19_13h57m_Subject 46898.txt","46898",2019-09-19,"13:57",16,82,60,13,9,22,22,1,6,29,18,15,9,42,468,77,104,649,226.95,164.9,2240.62711864407,1610.80392156863,41,112,153,90.1639344262295
"./Ship3_Latin-square/2019-09-19_13h57m_Subject 47097.txt","47097",2019-09-19,"13:57",0,81,60,9,12,21,8,2,2,12,75,19,8,102,938,148,231,1317,74.95,201.016666666667,2999.91525423729,1628.30508474576,63,109,172,100
"./Ship3_Latin-square/2019-09-19_13h57m_Subject 47099.txt","47099",2019-09-19,"13:57",8,79,60,9,10,19,16,3,3,22,34,16,8,58,912,141,206,1259,90.4,161.533333333333,2579.62711864407,1157.94915254237,49,90,139,100
"./Ship3_Latin-square/2019-09-19_13h57m_Subject 47798.txt","47798",2019-09-19,"13:57",24,70,53,10,7,17,65,2,15,82,33,6,13,52,115,0,29,144,1361.05769230769,277.615384615385,1938.42307692308,3371.76923076923,66,67,133,79.2452830188679
"./Ship3_Latin-square/2019-09-19_14h00m_Subject 46876.txt","46876",2019-09-19,"14:00",24,46,36,10,0,10,32,3,0,35,7,1,0,8,219,1,0,220,488.428571428571,125.542857142857,2451.34285714286,1048,38,19,57,86.1111111111111
"./Ship3_Latin-square/2019-09-19_14h00m_Subject 46877.txt","46877",2019-09-19,"14:00",4,80,60,10,10,20,24,2,16,42,101,114,81,296,1206,181,234,1621,102.55,215.166666666667,2796.59322033898,1052.29310344828,39,146,185,100
"./Ship3_Latin-square/2019-09-19_14h00m_Subject 46893.txt","46893",2019-09-19,"14:00",2,74,60,4,10,14,4,0,0,4,34,1,7,42,1369,90,213,1672,50.9166666666667,158.116666666667,2877.94915254237,1393.23728813559,52,76,128,98.3606557377049
"./Ship3_Latin-square/2019-09-19_14h00m_Subject 46895.txt","46895",2019-09-19,"14:00",2,85,60,10,15,25,57,11,14,82,29,20,5,54,355,49,134,538,890.783333333333,151.383333333333,2884.69491525424,1836.76086956522,34,123,157,90.1639344262295
"./Ship3_Latin-square/2019-09-19_14h00m_Subject 47638.txt","47638",2019-09-19,"14:00",2,81,60,11,10,21,87,10,11,108,19,3,75,97,512,104,72,688,503.15,160.85,2905.08474576271,1499.38983050847,61,39,100,98.3606557377049
"./Ship3_Latin-square/2019-09-19_14h00m_Subject 47757.txt","47757",2019-09-19,"14:00",8,76,54,12,10,22,81,19,11,111,39,9,13,61,290,60,69,419,1411.62962962963,287.5,2629.51851851852,1949.76,61,108,169,92.7272727272727
"./Ship3_Latin-square/2019-09-19_14h00m_Subject 47769.txt","47769",2019-09-19,"14:00",2,84,60,13,11,24,31,1,14,46,38,27,16,81,536,148,127,811,224.35,162.316666666667,2911.83050847458,1766.39655172414,93,61,154,98.3606557377049
"./Ship3_Latin-square/2019-09-19_14h00m_Subject 47771.txt","47771",2019-09-19,"14:00",16,86,60,15,11,26,56,9,14,79,17,14,9,40,334,47,91,472,581.866666666667,126.65,2322,1796.57142857143,29,87,116,88.5245901639344
"./Ship3_Latin-square/2019-09-19_14h00m_Subject 47775.txt","47775",2019-09-19,"14:00",16,85,60,12,13,25,96,19,33,148,45,8,37,90,238,31,77,346,561.5,174.2,2159.27118644068,1765.03389830508,52,52,104,100
"./Ship3_Latin-square/2019-09-19_14h00m_Subject 47781.txt","47781",2019-09-19,"14:00",0,80,60,6,14,20,11,0,2,13,42,14,12,68,1228,178,257,1663,90.3666666666667,184.016666666667,2999.83050847458,1185.86206896552,35,92,127,98.3606557377049
"./Ship3_Latin-square/2019-09-19_14h00m_Subject 47782.txt","47782",2019-09-19,"14:00",8,75,60,7,8,15,26,1,1,28,4,3,2,9,763,79,122,964,215.5,91.7333333333333,2579.5593220339,1283.3275862069,46,48,94,96.7213114754098
"./Ship3_Latin-square/2019-09-19_14h00m_Subject 47783.txt","47783",2019-09-19,"14:00",0,79,60,8,11,19,36,2,3,41,48,8,14,70,873,135,154,1162,324.683333333333,176.783333333333,2999.8813559322,1732.26315789474,33,133,166,96.7213114754098
"./Ship3_Latin-square/2019-09-19_14h00m_Subject 47785.txt","47785",2019-09-19,"14:00",0,81,60,9,12,21,8,1,1,10,68,18,22,108,1628,201,337,2166,62.95,153.066666666667,2999.89830508475,1513.47457627119,45,132,177,100
"./Ship3_Latin-square/2019-09-19_14h00m_Subject 47786.txt","47786",2019-09-19,"14:00",8,78,60,11,7,18,44,6,9,59,40,6,42,88,344,47,35,426,588.933333333333,215.066666666667,2647.4406779661,2284.05454545455,71,40,111,93.4426229508197
"./Ship3_Latin-square/2019-09-19_14h00m_Subject 47788.txt","47788",2019-09-19,"14:00",8,77,60,7,10,17,44,3,7,54,83,29,13,125,550,52,127,729,449.183333333333,219.15,2552.52542372881,1742.15254237288,36,52,88,100
"./Ship3_Latin-square/2019-09-19_15h01m_Subject 47080.txt","47080",2019-09-19,"15:01",16,79,60,8,11,19,10,1,2,13,24,9,8,41,866,77,273,1216,76.95,133.183333333333,2105.05084745763,1211.45652173913,35,228,263,86.8852459016393
"./Ship3_Latin-square/2019-09-19_15h01m_Subject 47089.txt","47089",2019-09-19,"15:01",0,79,60,10,9,19,23,8,5,36,94,11,34,139,448,65,61,574,228.333333333333,252.55,2999.91525423729,1339.6724137931,68,24,92,98.3606557377049
"./Ship3_Latin-square/2019-09-19_15h01m_Subject 47762.txt","47762",2019-09-19,"15:01",24,84,59,14,11,25,47,13,9,69,26,10,10,46,140,9,62,211,788.327586206897,196.724137931034,2006.87931034483,2635.46341463415,70,72,142,77.9661016949153
"./Ship3_Latin-square/2019-09-19_15h01m_Subject 47791.txt","47791",2019-09-19,"15:01",0,75,60,3,12,15,15,0,2,17,22,1,3,26,691,50,120,861,98.6833333333333,141.016666666667,2999.94915254237,1448.08474576271,19,30,49,100
"./Ship3_Latin-square/2019-09-20_09h34m_Subject 46884.txt","46884",2019-09-20,"09:34",24,61,46,12,3,15,43,1,5,49,15,3,2,20,138,10,11,159,1300.68888888889,673.333333333333,2253.24444444444,5370.55555555556,76,55,131,69.5652173913043
"./Ship3_Latin-square/2019-09-20_09h34m_Subject 47083.txt","47083",2019-09-20,"09:34",0,73,52,9,12,21,56,8,12,76,46,24,19,89,338,46,84,468,1327.07692307692,250.192307692308,2999.92307692308,2902.58333333333,100,119,219,92.4528301886792
"./Ship3_Latin-square/2019-09-20_09h34m_Subject 47086.txt","47086",2019-09-20,"09:34",8,78,60,9,9,18,31,8,2,41,18,8,1,27,468,48,98,614,261.566666666667,145.3,2593.20338983051,1622.375,37,154,191,90.1639344262295
"./Ship3_Latin-square/2019-09-20_09h34m_Subject 47246.txt","47246",2019-09-20,"09:34",24,83,60,8,15,23,58,4,23,85,16,2,11,29,156,0,67,223,459.5,193.5,1535.5593220339,1145.82857142857,16,94,110,68.8524590163934
"./Ship3_Latin-square/2019-09-20_09h34m_Subject 47635.txt","47635",2019-09-20,"09:34",24,82,60,13,9,22,79,7,14,100,58,18,7,83,353,1,92,446,427.133333333333,223.666666666667,1983.03389830508,1160.81818181818,53,38,91,96.7213114754098
"./Ship3_Latin-square/2019-09-20_09h34m_Subject 47779.txt","47779",2019-09-20,"09:34",24,53,37,8,8,16,47,4,11,62,30,7,10,47,61,6,15,82,3539.13513513513,398.297297297297,1767.54054054054,4711.26666666667,60,31,91,84.2105263157895
"./Ship3_Latin-square/2019-09-20_09h34m_Subject 47790.txt","47790",2019-09-20,"09:34",8,84,60,9,15,24,19,0,5,24,19,1,13,33,499,55,151,705,241.466666666667,285.833333333333,2538.94915254237,1966.94871794872,140,189,329,80.327868852459
"./Ship3_Latin-square/2019-09-20_09h34m_Subject 47797.txt","47797",2019-09-20,"09:34",16,37,28,6,3,9,64,4,3,71,19,3,2,24,62,11,3,76,6204.10714285714,311.285714285714,2348.07407407407,4021.82608695652,12,29,41,92.8571428571429
"./Ship3_Latin-square/2019-09-20_09h37m_Subject 46878.txt","46878",2019-09-20,"09:37",24,80,60,12,8,20,119,6,25,150,72,18,9,99,356,11,83,450,484.85,277.316666666667,1901.57627118644,1340.64912280702,66,85,151,96.7213114754098
"./Ship3_Latin-square/2019-09-20_09h37m_Subject 46885.txt","46885",2019-09-20,"09:37",0,80,60,9,11,20,44,8,9,61,10,1,2,13,394,48,62,504,582.95,110.9,2999.77966101695,1998.15254237288,67,48,115,100
"./Ship3_Latin-square/2019-09-20_09h37m_Subject 46899.txt","46899",2019-09-20,"09:37",2,80,60,11,9,20,26,1,2,29,28,7,4,39,810,147,140,1097,165.516666666667,172.666666666667,2901.67796610169,1064.16949152542,27,31,58,100
"./Ship3_Latin-square/2019-09-20_09h37m_Subject 47081.txt","47081",2019-09-20,"09:37",8,79,60,10,9,19,24,5,3,32,7,16,18,41,677,88,127,892,110.45,91.4166666666667,2620.30508474576,1314.37288135593,45,76,121,100
"./Ship3_Latin-square/2019-09-20_09h37m_Subject 47091.txt","47091",2019-09-20,"09:37",2,79,60,5,14,19,17,2,4,23,57,4,12,73,286,25,70,381,317.016666666667,181.033333333333,2867.72881355932,1818.70909090909,38,90,128,98.3606557377049
"./Ship3_Latin-square/2019-09-20_09h37m_Subject 47095.txt","47095",2019-09-20,"09:37",4,81,60,12,9,21,46,23,5,74,10,17,17,44,446,99,57,602,510.683333333333,219.816666666667,2816.93220338983,1597.07843137255,65,90,155,88.5245901639344
"./Ship3_Latin-square/2019-09-20_09h37m_Subject 47231.txt","47231",2019-09-20,"09:37",2,80,60,6,14,20,66,8,13,87,60,15,10,85,284,16,48,348,1128.16666666667,223.5,2877.96610169492,1450.625,33,66,99,96.7213114754098
"./Ship3_Latin-square/2019-09-20_09h37m_Subject 47238.txt","47238",2019-09-20,"09:37",0,78,60,10,8,18,23,1,3,27,43,25,15,83,454,89,60,603,239.85,195.816666666667,2999.89830508475,1235.15517241379,19,46,65,100
"./Ship3_Latin-square/2019-09-20_09h37m_Subject 47242.txt","47242",2019-09-20,"09:37",0,85,60,9,16,25,71,2,20,93,21,6,50,77,885,129,223,1237,227.316666666667,129.166666666667,2999.8813559322,1150.71186440678,31,92,123,100
"./Ship3_Latin-square/2019-09-20_09h37m_Subject 47244.txt","47244",2019-09-20,"09:37",0,79,60,6,13,19,28,0,1,29,55,13,87,155,928,82,187,1197,173.666666666667,185.816666666667,2999.94915254237,1532.38983050847,51,109,160,100
"./Ship3_Latin-square/2019-09-20_09h37m_Subject 47633.txt","47633",2019-09-20,"09:37",24,78,60,12,6,18,67,9,12,88,64,25,5,94,296,11,40,347,646.316666666667,213.633333333333,2023.71186440678,1346.76363636364,79,65,144,93.4426229508197
"./Ship3_Latin-square/2019-09-20_09h37m_Subject 47636.txt","47636",2019-09-20,"09:37",4,78,60,12,6,18,194,81,9,284,149,116,4,269,418,106,55,579,989.05,259.816666666667,2837.25423728814,2493.93220338983,124,74,198,100
"./Ship3_Latin-square/2019-09-20_09h37m_Subject 47752.txt","47752",2019-09-20,"09:37",2,76,60,8,8,16,35,5,4,44,23,14,9,46,684,100,58,842,404.05,106.816666666667,2894.86440677966,1757.46551724138,48,60,108,96.7213114754098
"./Ship3_Latin-square/2019-09-20_09h37m_Subject 47767.txt","47767",2019-09-20,"09:37",0,82,60,11,11,22,37,6,2,45,24,13,1,38,424,74,72,570,540.933333333333,184.45,2999.89830508475,1413.01754385965,53,38,91,98.3606557377049
"./Ship3_Latin-square/2019-09-20_09h37m_Subject 47768.txt","47768",2019-09-20,"09:37",4,80,60,6,14,20,34,5,2,41,24,3,21,48,505,61,164,730,370.183333333333,200.416666666667,2762.67796610169,2085.87037037037,50,117,167,91.8032786885246
"./Ship3_Latin-square/2019-09-20_09h37m_Subject 47780.txt","47780",2019-09-20,"09:37",16,78,60,9,9,18,72,7,8,87,37,11,4,52,296,32,60,388,476.466666666667,185.533333333333,2213.54237288136,1465.25862068966,65,34,99,100
"./Ship3_Latin-square/2019-09-20_10h48m_Subject 47229.txt","47229",2019-09-20,"10:48",16,80,60,10,10,20,15,0,1,16,37,11,6,54,560,70,119,749,105.616666666667,161.066666666667,2213.54237288136,1153.01724137931,46,64,110,98.3606557377049
"./Ship3_Latin-square/2019-09-20_10h48m_Subject 47233.txt","47233",2019-09-20,"10:48",24,83,60,11,12,23,60,5,12,77,55,8,17,80,273,4,118,395,297.3,188.133333333333,1820.23728813559,962.469387755102,30,53,83,85.2459016393443
"./Ship3_Latin-square/2019-09-20_10h48m_Subject 47234.txt","47234",2019-09-20,"10:48",8,81,60,11,10,21,79,1,9,89,154,11,26,191,479,115,118,712,457.7,499.283333333333,2593.22033898305,1504.64912280702,60,66,126,96.7213114754098
"./Ship3_Latin-square/2019-09-20_10h48m_Subject 47237.txt","47237",2019-09-20,"10:48",4,78,60,10,8,18,16,5,0,21,8,2,17,27,494,74,70,638,205.35,104.383333333333,2803.33898305085,1350.20754716981,61,57,118,93.4426229508197
"./Ship3_Latin-square/2019-09-20_10h48m_Subject 47241.txt","47241",2019-09-20,"10:48",16,71,60,4,7,11,13,0,1,14,6,2,1,9,805,36,128,969,68.1,133.366666666667,2132.18644067797,1151.23728813559,36,65,101,100
"./Ship3_Latin-square/2019-09-20_10h48m_Subject 47247.txt","47247",2019-09-20,"10:48",0,76,60,5,11,16,15,0,0,15,17,0,3,20,450,34,63,547,181.916666666667,189.8,2999.96610169492,2007.14,105,72,177,85.2459016393443
"./Ship3_Latin-square/2019-09-20_10h48m_Subject 47777.txt","47777",2019-09-20,"10:48",0,72,55,4,13,17,32,8,0,40,24,2,7,33,480,41,114,635,353.509090909091,182.145454545455,2999.83333333333,1810.33333333333,43,63,106,100
"./Ship3_Latin-square/2019-09-20_10h48m_Subject 47784.txt","47784",2019-09-20,"10:48",0,80,60,3,17,20,23,1,6,30,42,0,20,62,1370,96,296,1762,139.4,172.35,2999.93220338983,1097.91525423729,27,126,153,100
"./Ship3_Latin-square/2019-09-20_10h51m_Subject 46900.txt","46900",2019-09-20,"10:51",24,82,60,11,11,22,28,0,11,39,51,26,13,90,564,8,123,695,174.35,186.233333333333,1779.59322033898,981.219512195122,44,93,137,80.327868852459
"./Ship3_Latin-square/2019-09-20_10h51m_Subject 46986.txt","46986",2019-09-20,"10:51",16,58,41,13,4,17,48,16,5,69,15,13,2,30,143,40,14,197,2501.675,144.525,2559.875,3629.37837837838,100,21,121,92.6829268292683
"./Ship3_Latin-square/2019-09-20_10h51m_Subject 47076.txt","47076",2019-09-20,"10:51",0,78,60,6,12,18,16,1,2,19,11,4,5,20,935,106,207,1248,60.6333333333333,104.7,2999.91525423729,1505.64406779661,52,77,129,100
"./Ship3_Latin-square/2019-09-20_10h51m_Subject 47079.txt","47079",2019-09-20,"10:51",0,79,60,5,14,19,26,3,2,31,57,9,16,82,324,22,75,421,320.9,219.966666666667,2999.86440677966,1702.64285714286,33,68,101,95.0819672131148
"./Ship3_Latin-square/2019-09-20_10h51m_Subject 47082.txt","47082",2019-09-20,"10:51",0,76,60,4,12,16,22,0,3,25,33,5,2,40,511,41,83,635,194.916666666667,140.066666666667,2999.86440677966,1469.81355932203,46,61,107,100
"./Ship3_Latin-square/2019-09-20_10h51m_Subject 47092.txt","47092",2019-09-20,"10:51",0,84,60,12,12,24,5,2,1,8,53,18,4,75,833,211,169,1213,65.8833333333333,223.466666666667,2999.89830508475,1644.32203389831,80,84,164,100
"./Ship3_Latin-square/2019-09-20_10h51m_Subject 47098.txt","47098",2019-09-20,"10:51",24,81,60,11,10,21,51,2,14,67,15,5,22,42,127,1,28,156,812.266666666667,165.016666666667,1860.93220338983,2534.62790697674,62,59,121,75.4098360655738
"./Ship3_Latin-square/2019-09-20_10h51m_Subject 47226.txt","47226",2019-09-20,"10:51",0,76,60,4,12,16,13,3,1,17,91,6,15,112,2377,149,421,2947,82.0333333333333,143.466666666667,2999.8813559322,1394.25,22,198,220,96.7213114754098
"./Ship3_Latin-square/2019-09-20_10h51m_Subject 47227.txt","47227",2019-09-20,"10:51",0,77,60,7,10,17,19,2,1,22,24,8,2,34,690,99,138,927,186.816666666667,146.766666666667,2999.94915254237,1666.01785714286,33,107,140,93.4426229508197
"./Ship3_Latin-square/2019-09-20_10h51m_Subject 47250.txt","47250",2019-09-20,"10:51",16,79,60,11,8,19,25,2,4,31,16,5,6,27,602,48,102,752,182.816666666667,103.933333333333,2294.83050847458,981.913793103448,29,46,75,98.3606557377049
"./Ship3_Latin-square/2019-09-20_10h51m_Subject 47645.txt","47645",2019-09-20,"10:51",16,47,34,11,2,13,90,17,6,113,20,6,0,26,180,28,2,210,4028.91176470588,232.470588235294,2670.47058823529,4165.18181818182,88,22,110,100
"./Ship3_Latin-square/2019-09-20_10h51m_Subject 47646.txt","47646",2019-09-20,"10:51",0,85,60,4,21,25,9,1,5,15,82,6,38,126,1757,120,652,2529,143.066666666667,152.266666666667,2999.81355932203,1563.19298245614,48,125,173,96.7213114754098
"./Ship3_Latin-square/2019-09-20_10h51m_Subject 47755.txt","47755",2019-09-20,"10:51",2,77,60,7,10,17,30,3,4,37,38,11,4,53,767,102,107,976,225.95,194.933333333333,2891.49152542373,1805.29310344828,78,174,252,96.7213114754098
"./Ship3_Latin-square/2019-09-20_10h51m_Subject 47760.txt","47760",2019-09-20,"10:51",0,79,60,9,10,19,35,5,4,44,33,6,7,46,1107,167,151,1425,145.25,175.633333333333,2999.86440677966,1062.96610169492,14,36,50,100
"./Ship3_Latin-square/2019-09-20_10h51m_Subject 47770.txt","47770",2019-09-20,"10:51",24,43,31,10,2,12,70,17,4,91,32,45,4,81,91,8,9,108,4510.61290322581,537.8,2359.96666666667,4701.125,62,41,103,87.0967741935484
"./Ship3_Latin-square/2019-09-20_10h51m_Subject 47795.txt","47795",2019-09-20,"10:51",0,83,60,2,21,23,40,0,7,47,24,0,5,29,490,9,111,610,349.683333333333,146.4,2999.89830508475,2143.87272727273,24,46,70,95.0819672131148
"./Ship3_Latin-square/2019-09-20_12h01m_Subject 46880.txt","46880",2019-09-20,"12:01",0,81,60,7,14,21,6,0,1,7,15,0,6,21,1023,92,268,1383,100.266666666667,128.133333333333,2999.98305084746,2058,51,371,422,91.8032786885246
"./Ship3_Latin-square/2019-09-20_12h01m_Subject 46882.txt","46882",2019-09-20,"12:01",16,85,60,14,11,25,35,6,64,105,55,63,23,141,393,50,57,500,303.8,233.65,2267.72881355932,1678.01960784314,39,141,180,90.1639344262295
"./Ship3_Latin-square/2019-09-20_12h01m_Subject 46883.txt","46883",2019-09-20,"12:01",2,83,60,10,13,23,19,4,3,26,197,51,6,254,560,93,118,771,168.416666666667,400.583333333333,2891.52542372881,1572.13559322034,44,68,112,100
"./Ship3_Latin-square/2019-09-20_12h01m_Subject 46894.txt","46894",2019-09-20,"12:01",8,82,60,10,12,22,42,4,15,61,20,4,11,35,427,58,117,602,480.366666666667,138.15,2566.08474576271,1454.20689655172,58,40,98,95.0819672131148
"./Ship3_Latin-square/2019-09-20_12h01m_Subject 46896.txt","46896",2019-09-20,"12:01",4,76,60,6,10,16,21,0,2,23,41,5,4,50,882,87,169,1138,155.3,201.5,2769.45762711864,1132.79661016949,35,58,93,100
"./Ship3_Latin-square/2019-09-20_12h01m_Subject 47088.txt","47088",2019-09-20,"12:01",4,77,60,5,12,17,11,2,1,14,77,3,9,89,1040,81,230,1351,87.9833333333333,242.633333333333,2749.13559322034,1291.47457627119,42,89,131,100
"./Ship3_Latin-square/2019-09-20_12h01m_Subject 47228.txt","47228",2019-09-20,"12:01",8,78,60,9,9,18,18,3,3,24,20,5,9,34,600,74,73,747,183.916666666667,103.916666666667,2593.18644067797,1325.57894736842,34,77,111,96.7213114754098
"./Ship3_Latin-square/2019-09-20_12h01m_Subject 47243.txt","47243",2019-09-20,"12:01",8,77,60,9,8,17,43,9,3,55,10,11,16,37,756,89,138,983,192.433333333333,120.9,2633.81355932203,1256.01724137931,120,56,176,98.3606557377049
"./Ship3_Latin-square/2019-09-20_12h01m_Subject 47249.txt","47249",2019-09-20,"12:01",4,80,60,10,10,20,17,7,0,24,73,14,7,94,388,65,75,528,158.516666666667,225.516666666667,2803.30508474576,1555.18965517241,62,52,114,98.3606557377049
"./Ship3_Latin-square/2019-09-20_12h01m_Subject 47639.txt","47639",2019-09-20,"12:01",8,85,60,13,12,25,19,1,6,26,10,6,8,24,802,134,161,1097,105.416666666667,132.833333333333,2633.84745762712,1610.54237288136,97,62,159,100
"./Ship3_Latin-square/2019-09-20_12h01m_Subject 47649.txt","47649",2019-09-20,"12:01",0,84,60,10,14,24,26,10,4,40,12,4,13,29,615,88,157,860,185.55,116.35,2999.8813559322,2111.54166666667,139,387,526,63.9344262295082
"./Ship3_Latin-square/2019-09-20_12h01m_Subject 47753.txt","47753",2019-09-20,"12:01",8,85,60,12,13,25,51,13,11,75,38,46,28,112,530,71,173,774,324.416666666667,183.583333333333,2593.16949152542,1440.92307692308,61,113,174,91.8032786885246
"./Ship3_Latin-square/2019-09-20_12h01m_Subject 47758.txt","47758",2019-09-20,"12:01",4,81,60,9,12,21,6,0,0,6,60,0,8,68,808,115,181,1104,61.1333333333333,156.083333333333,2783.01694915254,1208.08474576271,37,43,80,100
"./Ship3_Latin-square/2019-09-20_12h01m_Subject 47759.txt","47759",2019-09-20,"12:01",4,81,60,11,10,21,11,1,2,14,44,3,6,53,766,103,146,1015,89.2,209.833333333333,2810.15254237288,1271.72413793103,22,54,76,98.3606557377049
"./Ship3_Latin-square/2019-09-20_12h01m_Subject 47776.txt","47776",2019-09-20,"12:01",8,81,60,8,13,21,8,0,2,10,52,17,9,78,1030,131,244,1405,89.6833333333333,168.216666666667,2538.94915254237,1312.81034482759,72,46,118,98.3606557377049
"./Ship3_Latin-square/2019-09-20_12h01m_Subject 47799.txt","47799",2019-09-20,"12:01",4,80,60,11,9,20,16,3,2,21,56,18,21,95,585,75,138,798,183.283333333333,193.85,2803.25423728814,1518.05454545455,75,49,124,95.0819672131148
"./Ship3_Latin-square/2019-09-20_12h04m_Subject 46881.txt","46881",2019-09-20,"12:04",16,75,60,6,9,15,30,2,4,36,18,2,5,25,423,26,144,593,198.15,114.483333333333,2159.28813559322,986.714285714286,21,57,78,98.3606557377049
"./Ship3_Latin-square/2019-09-20_12h04m_Subject 47087.txt","47087",2019-09-20,"12:04",16,83,60,12,11,23,38,2,9,49,76,83,8,167,205,42,62,309,315.683333333333,235.05,2186.40677966102,1821.5,75,38,113,100
"./Ship3_Latin-square/2019-09-20_12h04m_Subject 47626.txt","47626",2019-09-20,"12:04",0,81,60,7,14,21,17,2,5,24,15,2,7,24,344,43,76,463,316.233333333333,138.55,2999.89830508475,2317.88095238095,45,152,197,80.327868852459
"./Ship3_Latin-square/2019-09-20_12h04m_Subject 47632.txt","47632",2019-09-20,"12:04",8,82,60,12,10,22,24,3,2,29,36,13,5,54,1068,114,253,1435,496.766666666667,319.966666666667,2620.23728813559,1223.41379310345,43,90,133,98.3606557377049
"./Ship3_Latin-square/2019-09-20_12h04m_Subject 47634.txt","47634",2019-09-20,"12:04",16,86,60,11,15,26,66,8,14,88,22,5,17,44,253,40,107,400,636.633333333333,167.383333333333,2132.13559322034,1327.21153846154,51,85,136,88.5245901639344
"./Ship3_Latin-square/2019-09-20_12h04m_Subject 47640.txt","47640",2019-09-20,"12:04",16,81,60,12,9,21,56,10,1,67,26,8,6,40,311,23,109,443,1016.13333333333,148.183333333333,2294.83050847458,1895,54,70,124,91.8032786885246
"./Ship3_Latin-square/2019-09-20_12h04m_Subject 47754.txt","47754",2019-09-20,"12:04",8,65,46,7,12,19,36,4,11,51,27,5,19,51,199,47,81,327,2660.32608695652,198.782608695652,2519.97777777778,4155.87878787879,23,110,133,76.5957446808511
"./Ship3_Latin-square/2019-09-20_12h04m_Subject 47800.txt","47800",2019-09-20,"12:04",2,81,60,9,12,21,55,5,11,71,74,21,12,107,505,76,71,652,589.483333333333,234.716666666667,2894.81355932203,1458.76271186441,34,118,152,100
"./Ship3_Latin-square/2019-09-20_13h28m_Subject 46888.txt","46888",2019-09-20,"13:28",2,82,60,8,14,22,14,0,2,16,60,19,9,88,982,123,212,1317,88.15,197.9,2874.5593220339,1665.10169491525,36,88,124,100
"./Ship3_Latin-square/2019-09-20_13h28m_Subject 46889.txt","46889",2019-09-20,"13:28",24,76,60,9,7,16,14,5,6,25,25,5,4,34,617,14,134,765,93.8833333333333,143.366666666667,1860.98305084746,834.565217391304,37,78,115,83.6065573770492
"./Ship3_Latin-square/2019-09-20_13h28m_Subject 46890.txt","46890",2019-09-20,"13:28",24,64,47,11,6,17,32,7,5,44,9,6,5,20,109,2,23,134,1417.23404255319,191.765957446808,2080.72340425532,4890.61538461538,83,46,129,62.5
"./Ship3_Latin-square/2019-09-20_13h28m_Subject 46892.txt","46892",2019-09-20,"13:28",4,77,60,6,11,17,15,24,1,40,12,3,6,21,891,79,142,1112,106.1,116.7,2769.47457627119,1468.25423728814,65,97,162,100
"./Ship3_Latin-square/2019-09-20_13h28m_Subject 46898.txt","46898",2019-09-20,"13:28",4,76,60,7,9,16,27,2,5,34,29,2,16,47,717,98,103,918,133.933333333333,190.666666666667,2796.54237288136,1636.37288135593,53,87,140,100
"./Ship3_Latin-square/2019-09-20_13h28m_Subject 47097.txt","47097",2019-09-20,"13:28",16,81,60,13,8,21,31,5,6,42,59,20,22,101,624,90,124,838,163.516666666667,184.566666666667,2294.86440677966,1069.25423728814,71,58,129,100
"./Ship3_Latin-square/2019-09-20_13h28m_Subject 47099.txt","47099",2019-09-20,"13:28",4,80,60,9,11,20,5,2,3,10,27,1,30,58,1115,159,195,1469,62.5166666666667,166.183333333333,2783.01694915254,1116.38983050847,39,52,91,100
"./Ship3_Latin-square/2019-09-20_13h28m_Subject 47798.txt","47798",2019-09-20,"13:28",2,81,60,6,15,21,30,0,9,39,7,6,2,15,205,19,51,275,595.866666666667,112.716666666667,2874.54237288136,2295.5,43,101,144,78.6885245901639
"./Ship3_Latin-square/2019-09-20_13h30m_Subject 46876.txt","46876",2019-09-20,"13:30",0,81,60,10,11,21,21,2,3,26,5,0,3,8,745,69,169,983,216.583333333333,95.4666666666667,2999.91525423729,1461.96551724138,35,74,109,98.3606557377049
"./Ship3_Latin-square/2019-09-20_13h30m_Subject 46877.txt","46877",2019-09-20,"13:30",24,84,60,13,11,24,35,5,10,50,115,83,48,246,602,26,181,809,123.366666666667,308.583333333333,1901.62711864407,1086.26086956522,40,148,188,83.6065573770492
"./Ship3_Latin-square/2019-09-20_13h30m_Subject 46893.txt","46893",2019-09-20,"13:30",8,76,60,6,10,16,8,1,2,11,31,4,3,38,1242,141,209,1592,53.2833333333333,152.716666666667,2566.05084745763,1144.4406779661,57,65,122,100
"./Ship3_Latin-square/2019-09-20_13h30m_Subject 46895.txt","46895",2019-09-20,"13:30",0,84,60,9,15,24,19,9,7,35,12,21,19,52,286,45,97,428,647.683333333333,131.116666666667,2999.93220338983,2029.4693877551,28,69,97,91.8032786885246
"./Ship3_Latin-square/2019-09-20_13h30m_Subject 47638.txt","47638",2019-09-20,"13:30",8,82,60,11,11,22,45,10,12,67,36,7,11,54,338,66,76,480,757.2,185.166666666667,2606.74576271186,2257.91228070175,76,41,117,96.7213114754098
"./Ship3_Latin-square/2019-09-20_13h30m_Subject 47757.txt","47757",2019-09-20,"13:30",4,79,60,10,9,19,68,12,10,90,36,10,9,55,327,41,53,421,1038.31666666667,196.65,2810.10169491525,1982.82692307692,68,119,187,88.5245901639344
"./Ship3_Latin-square/2019-09-20_13h30m_Subject 47769.txt","47769",2019-09-20,"13:30",8,84,60,13,11,24,37,3,17,57,31,13,21,65,490,73,92,655,371.65,152.716666666667,2647.4406779661,1914.86440677966,64,58,122,100
"./Ship3_Latin-square/2019-09-20_13h30m_Subject 47771.txt","47771",2019-09-20,"13:30",2,83,60,11,12,23,19,0,3,22,15,3,2,20,816,139,141,1096,232.766666666667,146.05,2894.81355932203,1608.43859649123,28,104,132,98.3606557377049
"./Ship3_Latin-square/2019-09-20_13h30m_Subject 47775.txt","47775",2019-09-20,"13:30",2,75,60,6,9,15,49,6,2,57,17,15,2,34,465,48,67,580,313.05,121,2888.13559322034,1310.23728813559,27,35,62,100
"./Ship3_Latin-square/2019-09-20_13h30m_Subject 47781.txt","47781",2019-09-20,"13:30",16,81,60,11,10,21,15,3,2,20,20,8,5,33,847,104,177,1128,100.65,130.8,2267.76271186441,1271.58928571429,57,136,193,96.7213114754098
"./Ship3_Latin-square/2019-09-20_13h30m_Subject 47782.txt","47782",2019-09-20,"13:30",4,85,60,12,13,25,13,7,2,22,10,3,2,15,716,148,183,1047,143.883333333333,88.3666666666667,2789.72881355932,1188.12280701754,42,40,82,98.3606557377049
"./Ship3_Latin-square/2019-09-20_13h30m_Subject 47783.txt","47783",2019-09-20,"13:30",16,78,60,10,8,18,55,6,9,70,31,5,2,38,479,32,40,551,643.833333333333,160.416666666667,2267.74576271186,1842.34482758621,49,48,97,98.3606557377049
"./Ship3_Latin-square/2019-09-20_13h30m_Subject 47785.txt","47785",2019-09-20,"13:30",16,81,60,12,9,21,18,1,1,20,31,15,1,47,915,60,229,1204,136.966666666667,136.816666666667,2294.86440677966,1332.12068965517,79,54,133,98.3606557377049
"./Ship3_Latin-square/2019-09-20_13h30m_Subject 47786.txt","47786",2019-09-20,"13:30",16,60,45,10,5,15,59,14,8,81,25,9,4,38,101,8,11,120,2883.65909090909,221.613636363636,2345.38636363636,2304.94736842105,46,27,73,86.6666666666667
"./Ship3_Latin-square/2019-09-20_13h30m_Subject 47788.txt","47788",2019-09-20,"13:30",4,79,60,8,11,19,17,3,4,24,61,15,17,93,690,98,127,915,190.433333333333,194.716666666667,2776.16949152542,1563.10169491525,41,58,99,98.3606557377049
"./Ship3_Latin-square/2019-09-20_14h41m_Subject 47080.txt","47080",2019-09-20,"14:41",2,78,60,5,13,18,13,0,6,19,36,10,6,52,1251,90,323,1664,68.1,141.6,2877.91525423729,1674.11320754717,40,288,328,96.7213114754098
"./Ship3_Latin-square/2019-09-20_14h41m_Subject 47089.txt","47089",2019-09-20,"14:41",16,75,60,10,5,15,51,5,6,62,61,16,5,82,270,18,26,314,448.333333333333,190.666666666667,2349.06779661017,1253.45762711864,74,29,103,100
"./Ship3_Latin-square/2019-09-20_14h41m_Subject 47762.txt","47762",2019-09-20,"14:41",2,80,60,9,11,20,56,6,1,63,37,21,17,75,198,35,57,290,1050.15,238.7,2891.50847457627,2843.30769230769,84,109,193,77.0491803278689
"./Ship3_Latin-square/2019-09-20_14h41m_Subject 47791.txt","47791",2019-09-20,"14:41",24,81,60,11,10,21,31,1,6,38,47,16,24,87,267,16,55,338,264.45,276.533333333333,1820.30508474576,1376.24,30,67,97,85.2459016393443
"./Ship3_Latin-square/2019-09-21_09h36m_Subject 46884.txt","46884",2019-09-21,"09:36",0,79,60,8,11,19,22,5,6,33,14,3,4,21,357,64,61,482,340.783333333333,164.35,2999.8813559322,2683.26315789474,90,139,229,75.4098360655738
"./Ship3_Latin-square/2019-09-21_09h36m_Subject 47083.txt","47083",2019-09-21,"09:36",24,70,55,8,7,15,93,9,9,111,52,9,12,73,151,2,53,206,1367.22222222222,216.222222222222,1844.42592592593,2649.66666666667,113,60,173,89.0909090909091
"./Ship3_Latin-square/2019-09-21_09h36m_Subject 47086.txt","47086",2019-09-21,"09:36",16,80,60,10,10,20,29,3,3,35,24,3,11,38,365,38,85,488,222.316666666667,143.75,2186.37288135593,1287.44,40,90,130,88.5245901639344
"./Ship3_Latin-square/2019-09-21_09h36m_Subject 47246.txt","47246",2019-09-21,"09:36",0,83,60,4,19,23,24,1,3,28,9,2,15,26,455,38,99,592,235.85,142.133333333333,2999.86440677966,2419.73214285714,44,143,187,96.7213114754098
"./Ship3_Latin-square/2019-09-21_09h36m_Subject 47635.txt","47635",2019-09-21,"09:36",2,81,60,9,12,21,24,6,3,33,53,13,11,77,672,108,112,892,231.016666666667,175.55,2888.05084745763,1617.62068965517,55,84,139,100
"./Ship3_Latin-square/2019-09-21_09h36m_Subject 47779.txt","47779",2019-09-21,"09:36",2,79,60,7,12,19,7,3,0,10,96,18,16,130,206,16,57,279,385.783333333333,237.05,2888.1186440678,2879.17073170732,95,103,198,78.3333333333333
"./Ship3_Latin-square/2019-09-21_09h36m_Subject 47790.txt","47790",2019-09-21,"09:36",2,84,60,12,12,24,7,0,0,7,17,0,7,24,615,92,201,908,267.7,248.016666666667,2898.22033898305,2074.66666666667,124,222,346,80.327868852459
"./Ship3_Latin-square/2019-09-21_09h36m_Subject 47797.txt","47797",2019-09-21,"09:36",4,35,25,6,4,10,31,10,4,45,26,19,4,49,95,21,9,125,7050.16,389.28,2833.33333333333,5832.15789473684,15,54,69,80.7692307692308
"./Ship3_Latin-square/2019-09-21_09h39m_Subject 46878.txt","46878",2019-09-21,"09:39",2,75,60,5,10,15,23,2,4,29,15,7,10,32,905,79,146,1130,121.716666666667,164.433333333333,2888.06779661017,1711.57627118644,75,96,171,100
"./Ship3_Latin-square/2019-09-21_09h39m_Subject 46885.txt","46885",2019-09-21,"09:39",24,47,33,10,4,14,96,12,12,120,11,3,2,16,106,7,15,128,1837.15625,164.6875,2249.96875,2307.59375,49,15,64,100
"./Ship3_Latin-square/2019-09-21_09h39m_Subject 46899.txt","46899",2019-09-21,"09:39",0,76,60,8,8,16,54,4,11,69,24,5,8,37,738,117,107,962,326.65,120.266666666667,2999.91525423729,1060.78947368421,42,38,80,98.3606557377049
"./Ship3_Latin-square/2019-09-21_09h39m_Subject 47081.txt","47081",2019-09-21,"09:39",16,74,60,6,8,14,25,4,3,32,7,3,3,13,516,21,91,628,155.666666666667,96.0666666666667,2186.40677966102,1421.60377358491,39,124,163,91.8032786885246
"./Ship3_Latin-square/2019-09-21_09h39m_Subject 47091.txt","47091",2019-09-21,"09:39",0,81,60,7,14,21,24,4,3,31,59,6,15,80,293,34,77,404,347.65,215.983333333333,2999.91525423729,1740.10169491525,38,47,85,100
"./Ship3_Latin-square/2019-09-21_09h39m_Subject 47095.txt","47095",2019-09-21,"09:39",8,80,60,11,9,20,56,7,3,66,25,8,17,50,375,66,80,521,615.033333333333,172.7,2620.33898305085,1622.38181818182,46,70,116,93.4426229508197
"./Ship3_Latin-square/2019-09-21_09h39m_Subject 47231.txt","47231",2019-09-21,"09:39",0,85,60,5,20,25,60,2,23,85,26,9,4,39,338,17,68,423,789.2,129.016666666667,2999.89830508475,1417.125,21,53,74,98.3606557377049
"./Ship3_Latin-square/2019-09-21_09h39m_Subject 47238.txt","47238",2019-09-21,"09:39",16,81,60,10,11,21,22,0,4,26,53,16,15,84,409,56,108,573,303.033333333333,416.883333333333,2159.32203389831,927.122807017544,20,63,83,96.7213114754098
"./Ship3_Latin-square/2019-09-21_09h39m_Subject 47242.txt","47242",2019-09-21,"09:39",16,78,60,12,6,18,79,6,5,90,92,11,44,147,495,69,86,650,305.8,296.9,2349.10169491525,1121.46296296296,53,137,190,93.4426229508197
"./Ship3_Latin-square/2019-09-21_09h39m_Subject 47244.txt","47244",2019-09-21,"09:39",24,77,58,10,9,19,86,1,22,109,99,43,13,155,314,9,69,392,1303.08620689655,341.879310344828,1799.98275862069,1306.37931034483,60,60,120,100
"./Ship3_Latin-square/2019-09-21_09h39m_Subject 47633.txt","47633",2019-09-21,"09:39",2,79,60,6,13,19,41,2,0,43,70,21,11,102,630,87,113,830,431.516666666667,240.2,2884.72881355932,1639.35593220339,85,77,162,100
"./Ship3_Latin-square/2019-09-21_09h39m_Subject 47636.txt","47636",2019-09-21,"09:39",24,61,44,9,8,17,120,8,28,156,54,10,8,72,165,13,51,229,2941.02325581395,307.93023255814,1995.18604651163,2795.87804878049,91,70,161,97.7272727272727
"./Ship3_Latin-square/2019-09-21_09h39m_Subject 47752.txt","47752",2019-09-21,"09:39",0,81,60,7,14,21,39,2,6,47,31,9,8,48,757,78,167,1002,352.366666666667,133.55,2999.8813559322,1444.1186440678,47,80,127,100
"./Ship3_Latin-square/2019-09-21_09h39m_Subject 47767.txt","47767",2019-09-21,"09:39",16,82,60,11,11,22,75,4,18,97,74,10,13,97,228,24,67,319,735.083333333333,473.983333333333,2240.57627118644,1755.62711864407,45,61,106,100
"./Ship3_Latin-square/2019-09-21_09h39m_Subject 47768.txt","47768",2019-09-21,"09:39",24,79,55,14,10,24,66,8,11,85,29,8,17,54,254,15,76,345,590.111111111111,190.685185185185,1933.25925925926,1816.04545454545,50,62,112,81.8181818181818
"./Ship3_Latin-square/2019-09-21_09h39m_Subject 47780.txt","47780",2019-09-21,"09:39",4,82,57,9,16,25,73,14,12,99,54,16,42,112,295,47,103,445,823.857142857143,243.714285714286,2749.98214285714,1986.43636363636,54,74,128,98.2456140350877
"./Ship3_Latin-square/2019-09-21_10h47m_Subject 47229.txt","47229",2019-09-21,"10:47",2,80,60,7,13,20,14,1,1,16,42,5,5,52,964,145,235,1344,80.0666666666667,159.9,2881.28813559322,1475.03389830508,47,91,138,100
"./Ship3_Latin-square/2019-09-21_10h47m_Subject 47233.txt","47233",2019-09-21,"10:47",0,77,60,5,12,17,21,0,4,25,22,2,7,31,461,51,113,625,143.083333333333,132.533333333333,2999.86440677966,2026.06896551724,51,112,163,98.3606557377049
"./Ship3_Latin-square/2019-09-21_10h47m_Subject 47234.txt","47234",2019-09-21,"10:47",16,84,60,12,12,24,44,9,7,60,49,39,25,113,413,72,114,599,391.816666666667,203.083333333333,2267.72881355932,1549.47272727273,61,72,133,95.0819672131148
"./Ship3_Latin-square/2019-09-21_10h47m_Subject 47237.txt","47237",2019-09-21,"10:47",0,75,60,7,8,15,15,2,1,18,13,4,13,30,778,104,128,1010,164.35,155.166666666667,2999.93220338983,1331.44827586207,40,50,90,98.3606557377049
"./Ship3_Latin-square/2019-09-21_10h47m_Subject 47241.txt","47241",2019-09-21,"10:47",4,81,60,9,12,21,10,0,3,13,6,5,1,12,1046,167,227,1440,66.9166666666667,142.383333333333,2762.67796610169,1477.66101694915,31,67,98,100
"./Ship3_Latin-square/2019-09-21_10h47m_Subject 47247.txt","47247",2019-09-21,"10:47",24,70,60,5,5,10,56,3,13,72,32,4,7,43,200,0,28,228,634.5,184.75,1820.27118644068,1582.9756097561,42,82,124,72.1311475409836
"./Ship3_Latin-square/2019-09-21_10h47m_Subject 47777.txt","47777",2019-09-21,"10:47",16,79,60,8,11,19,36,8,15,59,46,13,6,65,381,27,88,496,328.35,214.716666666667,2132.16949152542,1575.6724137931,60,46,106,98.3606557377049
"./Ship3_Latin-square/2019-09-21_10h47m_Subject 47784.txt","47784",2019-09-21,"10:47",24,78,60,11,7,18,156,11,36,203,71,9,9,89,562,1,74,637,892.4,221.35,1901.64406779661,1404.47457627119,80,72,152,100
"./Ship3_Latin-square/2019-09-21_10h49m_Subject 46900.txt","46900",2019-09-21,"10:49",0,78,60,7,11,18,9,3,0,12,61,7,16,84,1016,138,151,1305,73.1833333333333,169.766666666667,2999.89830508475,1090.35593220339,14,50,64,100
"./Ship3_Latin-square/2019-09-21_10h49m_Subject 46986.txt","46986",2019-09-21,"10:49",8,67,49,12,6,18,51,29,9,89,34,12,15,61,310,57,43,410,853.416666666667,271.0625,2683.29166666667,2479.46808510638,77,40,117,97.9591836734694
"./Ship3_Latin-square/2019-09-21_10h49m_Subject 47076.txt","47076",2019-09-21,"10:49",16,85,60,14,11,25,18,1,5,24,71,8,33,112,456,47,127,630,247.9,764.533333333333,2213.54237288136,1646.88095238095,54,165,219,81.9672131147541
"./Ship3_Latin-square/2019-09-21_10h49m_Subject 47079.txt","47079",2019-09-21,"10:49",24,79,60,14,5,19,53,9,8,70,61,20,6,87,240,5,18,263,468.55,229.35,2145.69491525424,1336.43636363636,68,52,120,95.0819672131148
"./Ship3_Latin-square/2019-09-21_10h49m_Subject 47082.txt","47082",2019-09-21,"10:49",16,76,60,8,8,16,58,3,4,65,42,5,11,58,384,39,63,486,249,162.683333333333,2213.49152542373,1356,74,52,126,98.3606557377049
"./Ship3_Latin-square/2019-09-21_10h49m_Subject 47092.txt","47092",2019-09-21,"10:49",24,83,60,12,11,23,113,3,45,161,67,9,12,88,353,0,98,451,612.016666666667,235.466666666667,1779.61016949153,1330.15254237288,49,60,109,98.3606557377049
"./Ship3_Latin-square/2019-09-21_10h49m_Subject 47098.txt","47098",2019-09-21,"10:49",2,77,60,7,10,17,20,2,3,25,17,5,8,30,514,48,118,680,163.033333333333,162.15,2888.06779661017,1445.70175438596,45,45,90,98.3606557377049
"./Ship3_Latin-square/2019-09-21_10h49m_Subject 47226.txt","47226",2019-09-21,"10:49",16,82,60,11,11,22,27,9,3,39,86,29,23,138,1392,66,507,1965,444.916666666667,122.833333333333,2213.50847457627,1210.33333333333,49,52,101,96.7213114754098
"./Ship3_Latin-square/2019-09-21_10h49m_Subject 47227.txt","47227",2019-09-21,"10:49",16,79,60,10,9,19,35,4,4,43,48,5,4,57,347,40,43,430,405.383333333333,180.483333333333,2267.76271186441,1099.74545454545,21,81,102,90.1639344262295
"./Ship3_Latin-square/2019-09-21_10h49m_Subject 47250.txt","47250",2019-09-21,"10:49",2,81,60,9,12,21,18,3,3,24,10,6,12,28,855,120,202,1177,132.6,101.6,2894.8813559322,1268.30508474576,29,37,66,100
"./Ship3_Latin-square/2019-09-21_10h49m_Subject 47645.txt","47645",2019-09-21,"10:49",8,71,51,10,10,20,112,28,23,163,27,10,8,45,270,37,53,360,1780.37254901961,211.235294117647,2615.96,2364.44897959184,58,86,144,98.0392156862745
"./Ship3_Latin-square/2019-09-21_10h49m_Subject 47646.txt","47646",2019-09-21,"10:49",16,85,60,15,10,25,74,7,15,96,64,17,54,135,305,24,116,445,658.4,200.033333333333,2376.23728813559,2200.40384615385,39,87,126,88.5245901639344
"./Ship3_Latin-square/2019-09-21_10h49m_Subject 47755.txt","47755",2019-09-21,"10:49",0,83,60,10,13,23,34,2,8,44,35,5,10,50,708,140,119,967,194.05,182.85,2999.96610169492,1827.08771929825,68,180,248,96.7213114754098
"./Ship3_Latin-square/2019-09-21_10h49m_Subject 47760.txt","47760",2019-09-21,"10:49",24,81,60,12,9,21,65,9,13,87,56,14,10,80,432,11,104,547,419.6,232.166666666667,1942.32203389831,865.034482758621,17,13,30,98.3606557377049
"./Ship3_Latin-square/2019-09-21_10h49m_Subject 47770.txt","47770",2019-09-21,"10:49",2,38,26,10,2,12,103,59,0,162,39,37,4,80,133,47,6,186,5985.24,403.44,2959.92,4049.52173913043,63,28,91,92.3076923076923
"./Ship3_Latin-square/2019-09-21_10h49m_Subject 47795.txt","47795",2019-09-21,"10:49",16,67,52,12,3,15,106,24,4,134,36,16,6,58,186,17,16,219,1903.07843137255,194.843137254902,2466.62745098039,2811.60784313725,61,14,75,98.0769230769231
"./Ship3_Latin-square/2019-09-21_11h56m_Subject 46881.txt","46881",2019-09-21,"11:56",2,74,60,4,10,14,30,1,1,32,21,1,3,25,880,52,163,1095,126.25,120.833333333333,2881.33898305085,1315.63157894737,27,120,147,100
"./Ship3_Latin-square/2019-09-21_11h56m_Subject 47087.txt","47087",2019-09-21,"11:56",2,80,60,9,11,20,18,1,2,21,68,12,6,86,417,57,78,552,143.883333333333,173.25,2891.47457627119,1659.59322033898,60,42,102,100
"./Ship3_Latin-square/2019-09-21_11h56m_Subject 47626.txt","47626",2019-09-21,"11:56",16,64,47,9,8,17,42,4,8,54,45,7,5,57,151,25,28,204,1596.86956521739,316.891304347826,2269.5652173913,2901.675,67,66,133,89.3617021276596
"./Ship3_Latin-square/2019-09-21_11h56m_Subject 47632.txt","47632",2019-09-21,"11:56",24,83,60,15,8,23,70,11,5,86,87,51,13,151,513,3,151,667,558.216666666667,370.7,2105,1028.90196078431,66,61,127,85.2459016393443
"./Ship3_Latin-square/2019-09-21_11h56m_Subject 47634.txt","47634",2019-09-21,"11:56",2,81,60,10,11,21,53,3,10,66,26,9,3,38,249,57,60,366,607.6,190.216666666667,2894.89830508475,2316.17307692308,59,77,136,90.1639344262295
"./Ship3_Latin-square/2019-09-21_11h56m_Subject 47640.txt","47640",2019-09-21,"11:56",2,74,55,11,8,19,61,5,9,75,28,4,18,50,464,95,100,659,1345.07407407407,147.777777777778,2907.38888888889,2361.98148148148,37,55,92,100
"./Ship3_Latin-square/2019-09-21_11h56m_Subject 47754.txt","47754",2019-09-21,"11:56",4,52,39,5,8,13,35,2,4,41,19,1,28,48,145,20,40,205,3368.23684210526,187.421052631579,2789.36842105263,4190.21428571429,40,98,138,82.051282051282
"./Ship3_Latin-square/2019-09-21_11h56m_Subject 47800.txt","47800",2019-09-21,"11:56",8,82,60,10,12,22,63,8,16,87,53,13,18,84,349,54,68,471,591.883333333333,185.433333333333,2579.62711864407,2018.16949152542,37,105,142,100
"./Ship3_Latin-square/2019-09-21_11h59m_Subject 46880.txt","46880",2019-09-21,"11:59",16,81,60,11,10,21,18,0,5,23,20,9,8,37,452,44,94,590,225.183333333333,177.216666666667,2213.52542372881,1475.66666666667,83,123,206,77.0491803278689
"./Ship3_Latin-square/2019-09-21_11h59m_Subject 46882.txt","46882",2019-09-21,"11:59",2,79,60,10,9,19,30,2,1,33,50,10,16,76,604,72,121,797,166.316666666667,219.683333333333,2901.64406779661,1631.40350877193,25,62,87,98.3606557377049
"./Ship3_Latin-square/2019-09-21_11h59m_Subject 46883.txt","46883",2019-09-21,"11:59",0,80,60,6,14,20,15,0,3,18,38,14,53,105,453,54,126,633,148.166666666667,179.083333333333,2999.94915254237,1607.74137931034,43,59,102,98.3606557377049
"./Ship3_Latin-square/2019-09-21_11h59m_Subject 46894.txt","46894",2019-09-21,"11:59",4,78,60,6,12,18,46,2,16,64,23,2,7,32,505,79,78,662,419.683333333333,128.033333333333,2762.66101694915,1388.81355932203,36,22,58,98.3333333333333
"./Ship3_Latin-square/2019-09-21_11h59m_Subject 46896.txt","46896",2019-09-21,"11:59",0,82,60,4,18,22,16,0,7,23,27,6,9,42,956,46,319,1321,146.7,147.166666666667,2999.91525423729,1009.37288135593,19,61,80,100
"./Ship3_Latin-square/2019-09-21_11h59m_Subject 47088.txt","47088",2019-09-21,"11:59",16,86,60,12,14,26,39,4,9,52,64,23,9,96,606,73,231,910,151.383333333333,224.9,2186.40677966102,1232.45614035088,84,99,183,96.7213114754098
"./Ship3_Latin-square/2019-09-21_11h59m_Subject 47228.txt","47228",2019-09-21,"11:59",4,68,46,0,22,22,30,0,15,45,23,0,92,115,217,0,211,428,994.978260869565,116.086956521739,2617.39130434783,2352.14285714286,3,434,437,38.2978723404255
"./Ship3_Latin-square/2019-09-21_11h59m_Subject 47243.txt","47243",2019-09-21,"11:59",4,79,60,9,10,19,54,5,3,62,19,11,1,31,864,130,156,1150,155.916666666667,146.2,2789.77966101695,1278.08474576271,110,65,175,100
"./Ship3_Latin-square/2019-09-21_11h59m_Subject 47249.txt","47249",2019-09-21,"11:59",16,82,60,10,12,22,67,3,13,83,88,31,30,149,309,35,88,432,535.3,282.266666666667,2159.22033898305,1496.27586206897,61,92,153,98.3606557377049
"./Ship3_Latin-square/2019-09-21_11h59m_Subject 47639.txt","47639",2019-09-21,"11:59",4,80,60,8,12,20,28,5,1,34,12,7,7,26,675,113,130,918,124.6,129.583333333333,2769.38983050847,1740.15254237288,80,68,148,100
"./Ship3_Latin-square/2019-09-21_11h59m_Subject 47649.txt","47649",2019-09-21,"11:59",24,75,54,11,10,21,70,6,20,96,14,1,10,25,236,6,56,298,1314.31481481481,170.722222222222,1933.2962962963,3059.97142857143,78,93,171,74.5454545454545
"./Ship3_Latin-square/2019-09-21_11h59m_Subject 47753.txt","47753",2019-09-21,"11:59",2,81,60,8,13,21,27,3,7,37,36,28,35,99,689,92,181,962,248.483333333333,204.633333333333,2884.71186440678,1402.36363636364,86,115,201,93.4426229508197
"./Ship3_Latin-square/2019-09-21_11h59m_Subject 47758.txt","47758",2019-09-21,"11:59",16,80,60,12,8,20,15,1,0,16,11,1,3,15,576,50,105,731,91.9666666666667,115.916666666667,2294.8813559322,1175.96551724138,56,37,93,100
"./Ship3_Latin-square/2019-09-21_11h59m_Subject 47759.txt","47759",2019-09-21,"11:59",16,81,60,9,12,21,40,1,13,54,57,5,32,94,372,28,109,509,214.783333333333,227.533333333333,2159.28813559322,1293.08928571429,29,66,95,95.0819672131148
"./Ship3_Latin-square/2019-09-21_11h59m_Subject 47776.txt","47776",2019-09-21,"11:59",4,84,60,11,13,24,11,4,4,19,51,20,11,82,1193,179,301,1673,65.3833333333333,165.916666666667,2776.23728813559,1109.05084745763,28,89,117,100
"./Ship3_Latin-square/2019-09-21_11h59m_Subject 47799.txt","47799",2019-09-21,"11:59",16,81,60,11,10,21,31,2,4,37,78,26,16,120,229,19,57,305,438.383333333333,308.9,2240.64406779661,2269.4693877551,85,82,167,88.5245901639344
"./Ship3_Latin-square/2019-09-21_13h05m_Subject 46888.txt","46888",2019-09-21,"13:05",8,75,60,6,9,15,16,3,4,23,49,6,13,68,864,76,97,1037,218.616666666667,174.133333333333,2538.94915254237,1424.63793103448,42,69,111,98.3606557377049
"./Ship3_Latin-square/2019-09-21_13h05m_Subject 46889.txt","46889",2019-09-21,"13:05",0,75,60,5,10,15,6,0,1,7,20,5,5,30,1246,117,197,1560,50.6333333333333,138.333333333333,2999.98305084746,1568.56140350877,61,153,214,98.3606557377049
"./Ship3_Latin-square/2019-09-21_13h05m_Subject 46890.txt","46890",2019-09-21,"13:05",2,81,60,9,12,21,18,2,2,22,12,3,6,21,275,57,59,391,699.666666666667,231.166666666667,2894.79661016949,2782.55813953488,59,106,165,80.327868852459
"./Ship3_Latin-square/2019-09-21_13h05m_Subject 46892.txt","46892",2019-09-21,"13:05",16,80,60,10,10,20,16,2,2,20,18,2,3,23,691,78,140,909,96.2,128.916666666667,2213.47457627119,1191.35185185185,60,139,199,93.4426229508197
"./Ship3_Latin-square/2019-09-21_13h05m_Subject 46898.txt","46898",2019-09-21,"13:05",24,79,60,12,7,19,47,4,4,55,16,3,8,27,376,20,83,479,176,166.716666666667,1982.98305084746,1367.23913043478,38,93,131,83.6065573770492
"./Ship3_Latin-square/2019-09-21_13h05m_Subject 47097.txt","47097",2019-09-21,"13:05",2,81,60,10,11,21,108,3,1,112,66,15,13,94,940,193,196,1329,393.766666666667,229.05,2891.50847457627,1396.01694915254,46,115,161,100
"./Ship3_Latin-square/2019-09-21_13h05m_Subject 47099.txt","47099",2019-09-21,"13:05",16,73,60,9,4,13,9,2,2,13,36,12,0,48,747,53,63,863,75.4333333333333,182.333333333333,2322,889.235294117647,16,102,118,88.5245901639344
"./Ship3_Latin-square/2019-09-21_13h05m_Subject 47798.txt","47798",2019-09-21,"13:05",0,80,60,5,15,20,26,0,4,30,6,6,2,14,237,18,58,313,524.916666666667,105.7,2999.93220338983,2284.6,51,124,175,73.7704918032787
"./Ship3_Latin-square/2019-09-21_13h08m_Subject 46876.txt","46876",2019-09-21,"13:08",16,53,41,9,3,12,48,9,7,64,18,6,5,29,230,20,17,267,861.2,159.65,2399.925,1815.26315789474,49,45,94,95.1219512195122
"./Ship3_Latin-square/2019-09-21_13h08m_Subject 46877.txt","46877",2019-09-21,"13:08",2,83,60,11,12,23,69,20,5,94,69,27,252,348,1229,184,278,1691,151.033333333333,189.95,2894.86440677966,1164.86206896552,27,146,173,98.3606557377049
"./Ship3_Latin-square/2019-09-21_13h08m_Subject 46893.txt","46893",2019-09-21,"13:08",4,83,60,19,4,23,56,19,4,79,33,25,2,60,598,193,33,824,808.216666666667,159.316666666667,2898.27118644068,1921.9512195122,215,29,244,73.7704918032787
"./Ship3_Latin-square/2019-09-21_13h08m_Subject 46895.txt","46895",2019-09-21,"13:08",24,60,44,11,5,16,50,11,10,71,76,11,10,97,95,5,16,116,1205.74418604651,1524.58139534884,2106.93023255814,2537.97297297297,37,41,78,88.6363636363636
"./Ship3_Latin-square/2019-09-21_13h08m_Subject 47638.txt","47638",2019-09-21,"13:08",4,71,54,9,8,17,54,9,8,71,43,22,5,70,241,48,30,319,785.666666666667,519.12962962963,2814.74074074074,2841.40384615385,84,38,122,96.3636363636364
"./Ship3_Latin-square/2019-09-21_13h08m_Subject 47757.txt","47757",2019-09-21,"13:08",16,64,47,12,5,17,89,26,19,134,43,11,4,58,198,49,29,276,1837.53191489362,836.297872340426,2478.23913043478,1484.36363636364,58,71,129,93.75
"./Ship3_Latin-square/2019-09-21_13h08m_Subject 47769.txt","47769",2019-09-21,"13:08",4,83,60,11,12,23,62,6,8,76,46,15,15,76,520,69,153,742,341.383333333333,210.15,2796.57627118644,1976.61016949153,81,106,187,100
"./Ship3_Latin-square/2019-09-21_13h08m_Subject 47771.txt","47771",2019-09-21,"13:08",8,85,60,10,15,25,28,0,6,34,8,3,23,34,673,65,199,937,188.1,128.416666666667,2552.49152542373,1469.73684210526,41,91,132,100
"./Ship3_Latin-square/2019-09-21_13h08m_Subject 47775.txt","47775",2019-09-21,"13:08",8,81,60,9,12,21,75,11,13,99,27,5,17,49,371,51,82,504,332.366666666667,121.516666666667,2538.94915254237,1672.54237288136,66,65,131,100
"./Ship3_Latin-square/2019-09-21_13h08m_Subject 47781.txt","47781",2019-09-21,"13:08",2,77,60,8,9,17,17,3,1,21,39,14,10,63,1109,168,182,1459,101.833333333333,157.95,2898.23728813559,1229.61016949153,41,44,85,98.3606557377049
"./Ship3_Latin-square/2019-09-21_13h08m_Subject 47782.txt","47782",2019-09-21,"13:08",16,76,60,9,7,16,37,4,4,45,19,8,10,37,474,41,96,611,187.883333333333,114.333333333333,2213.52542372881,1007.64406779661,22,52,74,98.3333333333333
"./Ship3_Latin-square/2019-09-21_13h08m_Subject 47783.txt","47783",2019-09-21,"13:08",2,78,60,6,12,18,46,7,14,67,54,4,5,63,612,76,170,858,819.5,195.633333333333,2881.30508474576,1985.15254237288,44,77,121,100
"./Ship3_Latin-square/2019-09-21_13h08m_Subject 47785.txt","47785",2019-09-21,"13:08",2,83,60,10,13,23,13,0,2,15,46,16,15,77,1432,262,235,1929,93.2166666666667,150.583333333333,2891.45762711864,1674.71929824561,69,212,281,96.7213114754098
"./Ship3_Latin-square/2019-09-21_13h08m_Subject 47786.txt","47786",2019-09-21,"13:08",4,53,41,6,6,12,56,3,7,66,69,57,39,165,133,15,23,171,1455.975,1502.5,2809.975,2991.55263157895,42,34,76,100
"./Ship3_Latin-square/2019-09-21_13h08m_Subject 47788.txt","47788",2019-09-21,"13:08",16,78,60,8,10,18,61,6,8,75,68,11,9,88,338,34,107,479,463.383333333333,219.083333333333,2159.28813559322,1568.59322033898,44,50,94,98.3606557377049
"./Ship3_Latin-square/2019-09-21_14h14m_Subject 47080.txt","47080",2019-09-21,"14:14",8,74,60,4,10,14,11,0,1,12,31,2,6,39,1015,32,172,1219,78.3,127.45,2538.96610169492,1423.15384615385,45,187,232,95.0819672131148
"./Ship3_Latin-square/2019-09-21_14h14m_Subject 47089.txt","47089",2019-09-21,"14:14",2,78,60,8,10,18,25,5,1,31,126,8,16,150,380,49,73,502,550.133333333333,274.133333333333,2894.8813559322,1361.06896551724,53,47,100,98.3606557377049
"./Ship3_Latin-square/2019-09-21_14h14m_Subject 47762.txt","47762",2019-09-21,"14:14",0,80,60,8,12,20,56,2,7,65,27,5,7,39,230,33,41,304,665.35,239.5,2999.86440677966,2671.02272727273,75,95,170,80.327868852459
"./Ship3_Latin-square/2019-09-21_14h14m_Subject 47791.txt","47791",2019-09-21,"14:14",0,80,60,8,12,20,11,3,1,15,22,7,2,31,753,106,164,1023,181.066666666667,148.266666666667,2999.84745762712,1464.72413793103,33,21,54,98.3606557377049
"./Ship3_Latin-square/2019-09-22_09h53m_Subject 46878.txt","46878",2019-09-22,"09:53",0,78,60,6,12,18,27,1,6,34,27,3,17,47,964,97,200,1261,161.566666666667,205.066666666667,2999.86440677966,1830.73684210526,84,144,228,100
"./Ship3_Latin-square/2019-09-22_09h53m_Subject 46885.txt","46885",2019-09-22,"09:53",0,83,60,7,16,23,59,5,4,68,8,1,5,14,370,60,112,542,481.916666666667,108.516666666667,2999.8813559322,2295.12068965517,39,72,111,100
"./Ship3_Latin-square/2019-09-22_09h53m_Subject 46899.txt","46899",2019-09-22,"09:53",24,77,60,13,4,17,137,19,25,181,36,11,3,50,288,1,26,315,1001.41666666667,245.8,2105,1645.24137931034,61,35,96,98.3606557377049
"./Ship3_Latin-square/2019-09-22_09h53m_Subject 47081.txt","47081",2019-09-22,"09:53",4,84,60,7,17,24,18,19,5,42,33,5,61,99,626,79,170,875,118.8,207.316666666667,2749.10169491525,1470.77966101695,31,97,128,100
"./Ship3_Latin-square/2019-09-22_09h53m_Subject 47091.txt","47091",2019-09-22,"09:53",24,85,60,13,12,25,43,10,11,64,76,20,49,145,185,18,51,254,539,279.133333333333,1820.32203389831,1608.48214285714,60,64,124,95.0819672131148
"./Ship3_Latin-square/2019-09-22_09h53m_Subject 47095.txt","47095",2019-09-22,"09:53",2,76,60,5,11,16,24,1,2,27,43,9,10,62,564,46,66,676,303.1,253.15,2881.32203389831,1717.87037037037,85,94,179,93.4426229508197
"./Ship3_Latin-square/2019-09-22_09h53m_Subject 47231.txt","47231",2019-09-22,"09:53",24,65,47,11,7,18,59,14,11,84,53,23,34,110,130,14,19,163,1156.53191489362,704.617021276596,2029.70212765957,1598.88095238095,51,53,104,89.5833333333333
"./Ship3_Latin-square/2019-09-22_09h53m_Subject 47238.txt","47238",2019-09-22,"09:53",2,80,60,11,9,20,18,1,4,23,61,19,23,103,459,100,85,644,199.2,281,2905.03389830508,1476,32,101,133,93.4426229508197
"./Ship3_Latin-square/2019-09-22_09h53m_Subject 47242.txt","47242",2019-09-22,"09:53",2,82,60,5,17,22,42,3,9,54,69,0,177,246,716,76,245,1037,177.7,200.916666666667,2864.38983050847,1305.94915254237,33,72,105,100
"./Ship3_Latin-square/2019-09-22_09h53m_Subject 47244.txt","47244",2019-09-22,"09:53",0,85,60,8,17,25,69,4,9,82,93,60,30,183,717,96,246,1059,268.4,391.766666666667,2999.91525423729,1528.15254237288,30,160,190,100
"./Ship3_Latin-square/2019-09-22_09h53m_Subject 47633.txt","47633",2019-09-22,"09:53",0,83,60,9,14,23,61,3,11,75,64,16,24,104,398,80,90,568,424.8,217.8,2999.86440677966,2119.08620689655,85,106,191,98.3606557377049
"./Ship3_Latin-square/2019-09-22_09h53m_Subject 47636.txt","47636",2019-09-22,"09:53",2,81,60,10,11,21,114,13,11,138,142,28,54,224,399,88,71,558,996.516666666667,276.066666666667,2901.66101694915,2534.05084745763,122,91,213,100
"./Ship3_Latin-square/2019-09-22_09h53m_Subject 47752.txt","47752",2019-09-22,"09:53",24,84,59,13,12,25,111,20,16,147,54,28,42,124,182,13,58,253,1009.77966101695,170.203389830508,1820.25423728814,1770.34,63,101,164,85
"./Ship3_Latin-square/2019-09-22_09h53m_Subject 47767.txt","47767",2019-09-22,"09:53",2,85,60,12,13,25,28,1,13,42,23,18,13,54,339,69,72,480,304.333333333333,163.016666666667,2898.27118644068,2003.76,90,50,140,88.5245901639344
"./Ship3_Latin-square/2019-09-22_09h53m_Subject 47768.txt","47768",2019-09-22,"09:53",2,84,60,9,15,24,48,6,4,58,29,11,2,42,520,70,121,711,532.616666666667,185.7,2877.94915254237,2002.64285714286,50,98,148,95.0819672131148
"./Ship3_Latin-square/2019-09-22_09h53m_Subject 47780.txt","47780",2019-09-22,"09:53",24,79,60,11,8,19,75,8,13,96,50,16,10,76,243,3,50,296,493.766666666667,202.516666666667,1942.30508474576,1596.96226415094,90,37,127,90.1639344262295
"./Ship3_Latin-square/2019-09-22_10h59m_Subject 46900.txt","46900",2019-09-22,"10:59",16,80,60,11,9,20,22,1,2,25,28,24,7,59,478,43,76,597,201.65,141.8,2267.72881355932,1021.25,28,61,89,88.5245901639344
"./Ship3_Latin-square/2019-09-22_10h59m_Subject 46986.txt","46986",2019-09-22,"10:59",16,67,51,9,7,16,56,10,7,73,52,6,3,61,165,19,25,209,1436.88,340.88,2263.98,2585.45454545455,87,64,151,90.1960784313726
"./Ship3_Latin-square/2019-09-22_10h59m_Subject 47076.txt","47076",2019-09-22,"10:59",2,81,60,10,11,21,15,1,0,16,21,8,21,50,977,171,202,1350,68.8166666666667,142.283333333333,2891.47457627119,1667.77966101695,59,95,154,100
"./Ship3_Latin-square/2019-09-22_10h59m_Subject 47079.txt","47079",2019-09-22,"10:59",0,78,60,7,11,18,25,1,6,32,60,6,21,87,425,42,79,546,233.116666666667,210.183333333333,2999.89830508475,1814.63793103448,56,76,132,98.3606557377049
"./Ship3_Latin-square/2019-09-22_10h59m_Subject 47082.txt","47082",2019-09-22,"10:59",2,79,60,8,11,19,33,5,0,38,13,0,0,13,491,78,93,662,140.8,109.183333333333,2888.13559322034,1728.57407407407,56,133,189,91.8032786885246
"./Ship3_Latin-square/2019-09-22_10h59m_Subject 47092.txt","47092",2019-09-22,"10:59",0,82,60,9,13,22,12,1,2,15,24,6,5,35,901,137,252,1290,63.5666666666667,186.316666666667,2999.8813559322,1820.93220338983,70,124,194,100
"./Ship3_Latin-square/2019-09-22_10h59m_Subject 47098.txt","47098",2019-09-22,"10:59",4,80,60,10,10,20,15,2,0,17,4,6,71,81,332,55,73,460,151.466666666667,95.3333333333333,2810.10169491525,1692.13725490196,87,66,153,90.1639344262295
"./Ship3_Latin-square/2019-09-22_10h59m_Subject 47226.txt","47226",2019-09-22,"10:59",2,76,60,7,9,16,10,3,2,15,75,64,15,154,2882,369,316,3567,69.4333333333333,128.416666666667,2894.86440677966,1320.06779661017,29,113,142,100
"./Ship3_Latin-square/2019-09-22_10h59m_Subject 47227.txt","47227",2019-09-22,"10:59",2,81,60,6,15,21,44,1,11,56,32,9,32,73,493,61,114,668,376.266666666667,206.5,2874.54237288136,1736.6862745098,32,150,182,88.3333333333333
"./Ship3_Latin-square/2019-09-22_10h59m_Subject 47250.txt","47250",2019-09-22,"10:59",8,75,60,7,8,15,16,0,3,19,7,5,6,18,731,71,102,904,88.9833333333333,95.45,2593.20338983051,1230.75862068966,30,42,72,98.3606557377049
"./Ship3_Latin-square/2019-09-22_10h59m_Subject 47645.txt","47645",2019-09-22,"10:59",16,66,48,11,7,18,96,22,11,129,26,8,5,39,215,35,36,286,1974.83333333333,255.375,2319,2950.54347826087,73,66,139,97.9166666666667
"./Ship3_Latin-square/2019-09-22_10h59m_Subject 47646.txt","47646",2019-09-22,"10:59",2,82,60,5,17,22,19,2,3,24,103,8,23,134,1866,193,520,2579,121.45,135.683333333333,2860.98305084746,1729.625,34,163,197,96.7213114754098
"./Ship3_Latin-square/2019-09-22_10h59m_Subject 47755.txt","47755",2019-09-22,"10:59",24,83,60,12,11,23,100,5,21,126,25,30,10,65,283,12,96,391,377,165.65,1860.8813559322,1610.48780487805,59,124,183,75.4098360655738
"./Ship3_Latin-square/2019-09-22_10h59m_Subject 47760.txt","47760",2019-09-22,"10:59",0,81,60,11,10,21,40,10,11,61,24,13,5,42,918,175,141,1234,167.65,148.05,2999.89830508475,1059.22033898305,7,40,47,100
"./Ship3_Latin-square/2019-09-22_10h59m_Subject 47770.txt","47770",2019-09-22,"10:59",0,44,31,6,7,13,72,34,15,121,58,27,10,95,138,25,16,179,4570.58064516129,357.612903225806,2999.96774193548,4801.65517241379,54,58,112,96.875
"./Ship3_Latin-square/2019-09-22_10h59m_Subject 47795.txt","47795",2019-09-22,"10:59",2,82,60,4,18,22,41,5,5,51,27,12,8,47,409,18,109,536,365.533333333333,164.883333333333,2857.59322033898,2326.73214285714,52,42,94,95.0819672131148
"./Ship3_Latin-square/2019-09-22_12h06m_Subject 46880.txt","46880",2019-09-22,"12:06",2,82,60,7,15,22,6,0,3,9,11,6,7,24,745,78,206,1029,116.3,112.45,2874.54237288136,1942.31914893617,57,237,294,85.2459016393443
"./Ship3_Latin-square/2019-09-22_12h06m_Subject 46882.txt","46882",2019-09-22,"12:06",8,79,60,10,9,19,23,2,4,29,54,5,16,75,624,66,110,800,190.3,143.3,2593.1186440678,1814.64705882353,54,122,176,93.4426229508197
"./Ship3_Latin-square/2019-09-22_12h06m_Subject 46883.txt","46883",2019-09-22,"12:06",24,73,56,11,6,17,101,14,16,131,89,23,7,119,164,3,22,189,1515.85454545455,472.872727272727,1952.67272727273,2386.125,48,75,123,87.5
"./Ship3_Latin-square/2019-09-22_12h06m_Subject 46894.txt","46894",2019-09-22,"12:06",16,84,60,11,13,24,67,8,24,99,21,8,9,38,258,35,131,424,504.1,113.4,2132.16949152542,1969.84615384615,49,97,146,88.5245901639344
"./Ship3_Latin-square/2019-09-22_12h06m_Subject 46896.txt","46896",2019-09-22,"12:06",8,79,60,9,10,19,12,2,4,18,31,9,8,48,740,97,193,1030,91.5333333333333,155.566666666667,2593.15254237288,1344.22033898305,38,36,74,100
"./Ship3_Latin-square/2019-09-22_12h06m_Subject 47088.txt","47088",2019-09-22,"12:06",24,84,60,11,13,24,67,6,9,82,63,13,16,92,391,4,163,558,273.433333333333,210.916666666667,1820.28813559322,1214.4347826087,51,74,125,78.6885245901639
"./Ship3_Latin-square/2019-09-22_12h06m_Subject 47228.txt","47228",2019-09-22,"12:06",16,85,60,11,14,25,45,2,10,57,19,1,11,31,362,86,129,577,381.75,100.9,2159.30508474576,1764.78846153846,49,105,154,95.0819672131148
"./Ship3_Latin-square/2019-09-22_12h06m_Subject 47243.txt","47243",2019-09-22,"12:06",16,83,60,11,12,23,52,5,8,65,25,8,4,37,542,66,137,745,238.5,156.466666666667,2213.49152542373,1387.50847457627,119,59,178,100
"./Ship3_Latin-square/2019-09-22_12h06m_Subject 47249.txt","47249",2019-09-22,"12:06",24,87,60,16,11,27,84,14,16,114,86,86,15,187,269,19,83,371,542.066666666667,264.283333333333,1942.35593220339,1318.96551724138,72,53,125,98.3606557377049
"./Ship3_Latin-square/2019-09-22_12h06m_Subject 47639.txt","47639",2019-09-22,"12:06",16,79,58,15,6,21,62,8,6,76,45,49,3,97,361,52,40,453,816.438596491228,259.350877192982,2410.45614035088,2133.63636363636,93,56,149,98.2758620689655
"./Ship3_Latin-square/2019-09-22_12h06m_Subject 47649.txt","47649",2019-09-22,"12:06",0,78,60,3,15,18,49,1,7,57,5,3,3,11,527,23,136,686,280.75,111.116666666667,2999.89830508475,2067.15789473684,52,242,294,83.6065573770492
"./Ship3_Latin-square/2019-09-22_12h06m_Subject 47753.txt","47753",2019-09-22,"12:06",16,83,60,15,8,23,27,7,4,38,26,99,6,131,515,53,97,665,268.233333333333,165.816666666667,2430.4406779661,1413.42105263158,132,68,200,96.7213114754098
"./Ship3_Latin-square/2019-09-22_12h06m_Subject 47758.txt","47758",2019-09-22,"12:06",24,76,60,10,6,16,69,1,10,80,19,2,6,27,384,0,84,468,258.6,120.616666666667,1942.25423728814,1069.8431372549,48,52,100,86.8852459016393
"./Ship3_Latin-square/2019-09-22_12h06m_Subject 47759.txt","47759",2019-09-22,"12:06",24,81,60,12,9,21,89,4,21,114,68,13,8,89,228,6,73,307,634.2,272.583333333333,1901.64406779661,1134.8813559322,41,38,79,100
"./Ship3_Latin-square/2019-09-22_12h06m_Subject 47776.txt","47776",2019-09-22,"12:06",16,82,60,8,14,22,13,1,5,19,61,13,10,84,860,77,321,1258,62.1,176.35,2105.06779661017,1266.50847457627,130,26,156,100
"./Ship3_Latin-square/2019-09-22_12h06m_Subject 47799.txt","47799",2019-09-22,"12:06",24,80,57,12,11,23,71,3,24,98,73,20,8,101,162,4,45,211,876.824561403509,565.175438596491,1799.98214285714,2199.76595744681,54,75,129,86.2068965517241
"./Ship3_Latin-square/2019-09-22_13h12m_Subject 46876.txt","46876",2019-09-22,"13:12",2,85,60,12,13,25,22,6,4,32,28,10,8,46,611,134,125,870,211.55,201.75,2891.47457627119,1738.32075471698,62,97,159,95.0819672131148
"./Ship3_Latin-square/2019-09-22_13h12m_Subject 46877.txt","46877",2019-09-22,"13:12",0,80,60,11,9,20,7,1,1,9,35,64,12,111,1350,312,197,1859,55.4333333333333,146.333333333333,2999.8813559322,1177.50847457627,48,85,133,100
"./Ship3_Latin-square/2019-09-22_13h12m_Subject 46893.txt","46893",2019-09-22,"13:12",16,79,60,8,11,19,22,0,5,27,63,25,7,95,932,72,249,1253,77.7166666666667,195.316666666667,2105.05084745763,1096.40677966102,56,88,144,100
"./Ship3_Latin-square/2019-09-22_13h12m_Subject 46895.txt","46895",2019-09-22,"13:12",0,78,55,9,14,23,29,5,3,37,21,5,12,38,175,38,63,276,1334.29090909091,197.272727272727,2999.90740740741,2812.92682926829,34,62,96,83.9285714285714
"./Ship3_Latin-square/2019-09-22_13h12m_Subject 47638.txt","47638",2019-09-22,"13:12",16,81,60,13,8,21,73,14,14,101,48,8,7,63,314,38,50,402,1059.68333333333,221.116666666667,2321.93220338983,1432.70175438596,77,41,118,98.3606557377049
"./Ship3_Latin-square/2019-09-22_13h12m_Subject 47757.txt","47757",2019-09-22,"13:12",24,71,50,17,4,21,147,37,21,205,39,31,3,73,193,20,23,236,1444.38,225.74,2375.9,1476.45652173913,67,56,123,92.156862745098
"./Ship3_Latin-square/2019-09-22_13h12m_Subject 47769.txt","47769",2019-09-22,"13:12",16,81,60,13,8,21,79,10,15,104,54,19,4,77,397,49,53,499,747.3,242.316666666667,2322,1785.37288135593,82,74,156,100
"./Ship3_Latin-square/2019-09-22_13h12m_Subject 47771.txt","47771",2019-09-22,"13:12",4,78,60,8,10,18,26,0,4,30,10,2,18,30,816,97,126,1039,124.516666666667,116.383333333333,2789.77966101695,1425.66101694915,28,84,112,100
"./Ship3_Latin-square/2019-09-22_13h12m_Subject 47775.txt","47775",2019-09-22,"13:12",4,78,60,9,9,18,63,8,8,79,8,4,3,15,368,56,62,486,388.2,93.4166666666667,2789.74576271186,1713.47457627119,55,43,98,100
"./Ship3_Latin-square/2019-09-22_13h12m_Subject 47781.txt","47781",2019-09-22,"13:12",8,79,60,9,10,19,13,2,2,17,21,4,17,42,942,128,205,1275,70.9666666666667,192.45,2593.16949152542,1561.89655172414,65,132,197,98.3333333333333
"./Ship3_Latin-square/2019-09-22_13h12m_Subject 47782.txt","47782",2019-09-22,"13:12",24,85,60,14,11,25,62,6,15,83,35,13,25,73,311,4,100,415,388.666666666667,127.983333333333,1942.35593220339,1017.89130434783,30,84,114,77.0491803278689
"./Ship3_Latin-square/2019-09-22_13h12m_Subject 47783.txt","47783",2019-09-22,"13:12",8,79,60,11,8,19,23,7,7,37,38,5,8,51,698,71,113,882,311.25,173.15,2647.4406779661,1917.36842105263,63,65,128,96.7213114754098
"./Ship3_Latin-square/2019-09-22_13h12m_Subject 47785.txt","47785",2019-09-22,"13:12",8,81,60,10,11,21,16,2,3,21,45,18,5,68,1119,221,190,1530,138.416666666667,136.633333333333,2593.16949152542,1376.94915254237,45,98,143,100
"./Ship3_Latin-square/2019-09-22_13h12m_Subject 47786.txt","47786",2019-09-22,"13:12",24,46,33,9,4,13,48,12,9,69,28,6,18,52,87,3,6,96,1823.51515151515,584.787878787879,2127.21212121212,2230.92592592593,40,33,73,82.3529411764706
"./Ship3_Latin-square/2019-09-22_13h12m_Subject 47788.txt","47788",2019-09-22,"13:12",24,78,60,10,8,18,59,10,13,82,86,40,8,134,325,7,82,414,481.366666666667,274.416666666667,1942.33898305085,1026.01851851852,31,55,86,91.8032786885246
"./Ship3_Latin-square/2019-09-23_09h55m_Subject 46878.txt","46878",2019-09-23,"09:55",24,85,60,13,12,25,68,2,19,89,28,13,6,47,406,8,128,542,282.9,169.85,1860.98305084746,1627.10869565217,79,82,161,85.2459016393443
"./Ship3_Latin-square/2019-09-23_09h55m_Subject 46885.txt","46885",2019-09-23,"09:55",16,69,50,12,7,19,77,13,13,103,4,1,0,5,183,26,24,233,2128.96,130.36,2359.94,3165.6,102,43,145,86.2745098039216
"./Ship3_Latin-square/2019-09-23_09h55m_Subject 46899.txt","46899",2019-09-23,"09:55",0,80,60,8,12,20,34,3,5,42,6,5,11,22,876,80,210,1166,240.466666666667,118.233333333333,2999.91525423729,1202.77966101695,21,66,87,100
"./Ship3_Latin-square/2019-09-23_09h55m_Subject 47081.txt","47081",2019-09-23,"09:55",24,84,60,11,13,24,21,4,5,30,30,7,22,59,381,9,153,543,128.683333333333,156.883333333333,1779.54237288136,1380.36956521739,41,78,119,78.6885245901639
"./Ship3_Latin-square/2019-09-23_09h55m_Subject 47091.txt","47091",2019-09-23,"09:55",0,82,60,8,14,22,18,1,3,22,69,8,14,91,303,39,83,425,364.716666666667,200.483333333333,2999.86440677966,1877.10169491525,35,52,87,98.3606557377049
"./Ship3_Latin-square/2019-09-23_09h55m_Subject 47095.txt","47095",2019-09-23,"09:55",16,80,60,8,12,20,43,10,15,68,25,16,40,81,327,32,75,434,762.316666666667,163.766666666667,2132.13559322034,1952.11538461538,48,103,151,88.5245901639344
"./Ship3_Latin-square/2019-09-23_09h55m_Subject 47231.txt","47231",2019-09-23,"09:55",0,77,53,1,23,24,56,3,23,82,27,0,17,44,150,5,63,218,1244.60377358491,139.867924528302,2999.90566037736,2774.70731707317,7,92,99,85.1851851851852
"./Ship3_Latin-square/2019-09-23_09h55m_Subject 47238.txt","47238",2019-09-23,"09:55",8,81,60,12,9,21,17,4,3,24,43,16,13,72,484,83,73,640,312.6,243,2633.84745762712,1498.28571428571,64,59,123,96.7213114754098
"./Ship3_Latin-square/2019-09-23_09h55m_Subject 47242.txt","47242",2019-09-23,"09:55",8,82,60,13,9,22,25,1,0,26,130,74,6,210,619,125,102,846,175.85,317.766666666667,2620.30508474576,1218.93220338983,59,50,109,100
"./Ship3_Latin-square/2019-09-23_09h55m_Subject 47244.txt","47244",2019-09-23,"09:55",16,77,60,9,8,17,20,2,4,26,92,12,10,114,568,71,116,755,208.933333333333,252.75,2240.62711864407,1230.875,44,102,146,96.7213114754098
"./Ship3_Latin-square/2019-09-23_09h55m_Subject 47633.txt","47633",2019-09-23,"09:55",24,80,60,13,7,20,67,19,9,95,75,19,15,109,289,13,35,337,546.266666666667,278.533333333333,2064.35593220339,1586.42105263158,112,55,167,96.7213114754098
"./Ship3_Latin-square/2019-09-23_09h55m_Subject 47636.txt","47636",2019-09-23,"09:55",0,81,60,8,13,21,54,7,5,66,92,9,13,114,469,70,116,655,802.266666666667,217.216666666667,2999.91525423729,2685.41071428571,121,119,240,96.7213114754098
"./Ship3_Latin-square/2019-09-23_09h55m_Subject 47752.txt","47752",2019-09-23,"09:55",0,80,60,10,10,20,65,7,4,76,23,18,8,49,639,97,92,828,933.75,111.8,2999.94915254237,1897.33898305085,91,63,154,98.3606557377049
"./Ship3_Latin-square/2019-09-23_09h55m_Subject 47767.txt","47767",2019-09-23,"09:55",8,79,60,8,11,19,20,1,2,23,22,11,6,39,350,46,75,471,261.583333333333,138.816666666667,2579.59322033898,1498.17857142857,32,44,76,96.7213114754098
"./Ship3_Latin-square/2019-09-23_09h55m_Subject 47768.txt","47768",2019-09-23,"09:55",0,82,60,7,15,22,44,2,5,51,34,3,16,53,514,57,191,762,851.8,161.266666666667,2999.93220338983,2431.45454545455,40,97,137,93.4426229508197
"./Ship3_Latin-square/2019-09-23_09h55m_Subject 47780.txt","47780",2019-09-23,"09:55",2,80,60,6,14,20,41,6,10,57,59,12,4,75,442,52,99,593,471.966666666667,377.433333333333,2877.89830508475,1653.47457627119,71,47,118,100
"./Ship3_Latin-square/2019-09-23_10h00m_Subject 46884.txt","46884",2019-09-23,"10:00",16,44,33,10,1,11,27,7,0,34,13,5,1,19,91,20,1,112,3437.8125,459.53125,2649.875,4702.19047619048,64,21,85,69.6969696969697
"./Ship3_Latin-square/2019-09-23_10h00m_Subject 47083.txt","47083",2019-09-23,"10:00",0,78,58,5,15,20,57,10,13,80,57,7,18,82,434,62,115,611,1227.1724137931,216.172413793103,2999.85964912281,2476.61818181818,85,94,179,96.6101694915254
"./Ship3_Latin-square/2019-09-23_10h00m_Subject 47086.txt","47086",2019-09-23,"10:00",4,81,60,9,12,21,31,2,0,33,32,7,8,47,440,72,79,591,188.616666666667,164.416666666667,2776.23728813559,1432.79661016949,28,86,114,100
"./Ship3_Latin-square/2019-09-23_10h00m_Subject 47246.txt","47246",2019-09-23,"10:00",16,83,60,11,12,23,20,2,8,30,15,1,5,21,388,50,84,522,158.933333333333,158.066666666667,2186.40677966102,1370.31481481481,21,78,99,93.4426229508197
"./Ship3_Latin-square/2019-09-23_10h00m_Subject 47635.txt","47635",2019-09-23,"10:00",0,80,60,1,19,20,38,3,4,45,52,1,20,73,496,4,131,631,557.766666666667,174.8,2999.93220338983,1692.37209302326,26,163,189,78.6885245901639
"./Ship3_Latin-square/2019-09-23_10h00m_Subject 47779.txt","47779",2019-09-23,"10:00",0,81,60,6,15,21,47,1,3,51,71,9,15,95,235,11,29,275,805.866666666667,177.783333333333,2999.8813559322,3041.17647058824,49,86,135,86.8852459016393
"./Ship3_Latin-square/2019-09-23_10h00m_Subject 47790.txt","47790",2019-09-23,"10:00",16,79,60,12,7,19,57,7,4,68,31,16,4,51,305,42,39,386,474.75,141.533333333333,2321.98305084746,1877.58823529412,86,67,153,88.5245901639344
"./Ship3_Latin-square/2019-09-23_10h00m_Subject 47797.txt","47797",2019-09-23,"10:00",24,45,32,10,3,13,57,9,7,73,39,11,7,57,55,7,7,69,3576.6875,391.8125,2325,4874.66666666667,28,33,61,93.9393939393939
"./Ship3_Latin-square/2019-09-23_11h26m_Subject 46900.txt","46900",2019-09-23,"11:26",2,77,60,6,11,17,19,1,4,24,87,8,20,115,883,90,140,1113,138.9,162.466666666667,2884.71186440678,1249.21428571429,13,96,109,96.7213114754098
"./Ship3_Latin-square/2019-09-23_11h26m_Subject 46986.txt","46986",2019-09-23,"11:26",4,70,53,9,8,17,47,10,3,60,19,7,9,35,271,47,42,360,2010.94230769231,168.557692307692,2807.61538461538,2430.88636363636,77,61,138,92.4528301886792
"./Ship3_Latin-square/2019-09-23_11h26m_Subject 47076.txt","47076",2019-09-23,"11:26",8,79,60,10,9,19,8,0,7,15,40,3,11,54,558,71,69,698,105.95,184.15,2606.74576271186,1657.98,53,123,176,88.5245901639344
"./Ship3_Latin-square/2019-09-23_11h26m_Subject 47079.txt","47079",2019-09-23,"11:26",16,78,60,9,9,18,30,6,4,40,69,12,12,93,244,30,49,323,340.316666666667,239.766666666667,2159.27118644068,1672.89090909091,60,55,115,91.8032786885246
"./Ship3_Latin-square/2019-09-23_11h26m_Subject 47082.txt","47082",2019-09-23,"11:26",8,79,60,9,10,19,37,7,2,46,16,4,5,25,386,51,63,500,552.833333333333,110.516666666667,2593.16949152542,2593.15094339623,88,82,170,93.4426229508197
"./Ship3_Latin-square/2019-09-23_11h26m_Subject 47092.txt","47092",2019-09-23,"11:26",16,79,60,9,10,19,24,3,6,33,36,5,6,47,553,44,118,715,114.75,172.533333333333,2159.27118644068,1187.74137931034,59,71,130,100
"./Ship3_Latin-square/2019-09-23_11h26m_Subject 47098.txt","47098",2019-09-23,"11:26",0,84,60,4,20,24,16,1,4,21,4,0,12,16,382,32,99,513,200.6,79.6,2999.93220338983,1557.66666666667,30,95,125,88.5245901639344
"./Ship3_Latin-square/2019-09-23_11h26m_Subject 47226.txt","47226",2019-09-23,"11:26",8,78,60,10,8,18,9,0,0,9,82,48,14,144,2443,432,549,3424,118.216666666667,161.7,2606.71186440678,1248.53448275862,27,98,125,100
"./Ship3_Latin-square/2019-09-23_11h26m_Subject 47227.txt","47227",2019-09-23,"11:26",8,81,60,8,13,21,71,5,8,84,30,4,13,47,266,48,66,380,598.733333333333,142.166666666667,2538.98305084746,2025.44736842105,36,155,191,73.7704918032787
"./Ship3_Latin-square/2019-09-23_11h26m_Subject 47250.txt","47250",2019-09-23,"11:26",4,79,60,12,7,19,14,7,2,23,25,22,5,52,803,154,126,1083,201.15,120.266666666667,2816.91525423729,1616.93220338983,35,51,86,100
"./Ship3_Latin-square/2019-09-23_11h26m_Subject 47645.txt","47645",2019-09-23,"11:26",4,70,52,12,6,18,87,19,11,117,21,7,10,38,229,59,37,325,1578.61538461538,190.865384615385,2843.05882352941,2764.08695652174,98,49,147,92.4528301886792
"./Ship3_Latin-square/2019-09-23_11h26m_Subject 47646.txt","47646",2019-09-23,"11:26",8,76,60,6,10,16,26,2,0,28,84,7,37,128,1502,84,387,1973,231.883333333333,116.083333333333,2565.98305084746,1716.2037037037,68,113,181,93.4426229508197
"./Ship3_Latin-square/2019-09-23_11h26m_Subject 47755.txt","47755",2019-09-23,"11:26",0,79,60,7,12,19,26,2,3,31,21,4,3,28,729,85,144,958,162.783333333333,177.85,2999.86440677966,1823.15789473684,48,208,256,98.3606557377049
"./Ship3_Latin-square/2019-09-23_11h26m_Subject 47760.txt","47760",2019-09-23,"11:26",16,81,60,11,10,21,60,10,15,85,38,8,4,50,520,55,115,690,413.766666666667,203.766666666667,2267.72881355932,998.172413793103,15,20,35,98.3606557377049
"./Ship3_Latin-square/2019-09-23_11h26m_Subject 47770.txt","47770",2019-09-23,"11:26",24,40,29,7,4,11,53,16,10,79,27,19,10,56,84,7,14,105,4218.39285714286,392.928571428571,2057.10714285714,4758.40909090909,53,38,91,79.3103448275862
"./Ship3_Latin-square/2019-09-23_11h26m_Subject 47795.txt","47795",2019-09-23,"11:26",8,70,55,11,4,15,72,20,8,100,25,14,2,41,221,37,22,280,1042.44444444444,153.537037037037,2688.85185185185,2827.03921568627,52,16,68,96.3636363636364
"./Ship3_Latin-square/2019-09-23_11h30m_Subject 47229.txt","47229",2019-09-23,"11:30",8,79,60,8,11,19,14,1,3,18,33,11,2,46,804,100,199,1103,101.516666666667,128.883333333333,2566.03389830508,1153.54237288136,28,82,110,100
"./Ship3_Latin-square/2019-09-23_11h30m_Subject 47233.txt","47233",2019-09-23,"11:30",16,79,60,9,10,19,38,2,4,44,37,9,12,58,268,25,69,362,361.6,153.116666666667,2159.25423728814,1243.7358490566,49,71,120,93.4426229508197
"./Ship3_Latin-square/2019-09-23_11h30m_Subject 47234.txt","47234",2019-09-23,"11:30",4,85,60,14,11,25,33,45,9,87,93,31,34,158,516,153,96,765,290.75,625.233333333333,2810.1186440678,1647.81818181818,74,104,178,98.3606557377049
"./Ship3_Latin-square/2019-09-23_11h30m_Subject 47237.txt","47237",2019-09-23,"11:30",8,77,60,4,13,17,45,2,28,75,30,2,23,55,425,23,97,545,402.633333333333,227.116666666667,2511.83050847458,1804.72413793103,46,116,162,98.3606557377049
"./Ship3_Latin-square/2019-09-23_11h30m_Subject 47241.txt","47241",2019-09-23,"11:30",24,81,60,9,12,21,26,3,2,31,6,10,7,23,558,17,211,786,124.883333333333,139.733333333333,1779.62711864407,993.114285714286,31,95,126,77.0491803278689
"./Ship3_Latin-square/2019-09-23_11h30m_Subject 47247.txt","47247",2019-09-23,"11:30",0,77,56,17,4,21,71,22,9,102,50,40,4,94,460,289,33,782,1305.76363636364,241.636363636364,2999.98181818182,1554.05,206,21,227,82.1428571428571
"./Ship3_Latin-square/2019-09-23_11h30m_Subject 47777.txt","47777",2019-09-23,"11:30",2,80,60,10,10,20,32,0,0,32,3,8,3,14,606,112,126,844,176.75,94.6,2898.28813559322,1467.60344827586,40,65,105,100
"./Ship3_Latin-square/2019-09-23_11h30m_Subject 47784.txt","47784",2019-09-23,"11:30",0,79,60,6,13,19,21,6,5,32,33,3,12,48,395,46,86,527,312.583333333333,166.583333333333,2999.93220338983,2115.48275862069,42,86,128,100
"./Ship3_Latin-square/2019-09-23_12h37m_Subject 46881.txt","46881",2019-09-23,"12:37",8,83,60,11,12,23,34,8,5,47,27,16,10,53,671,88,212,971,288.35,115.566666666667,2579.66101694915,1274.38983050847,41,72,113,100
"./Ship3_Latin-square/2019-09-23_12h37m_Subject 47087.txt","47087",2019-09-23,"12:37",8,80,60,11,9,20,16,3,1,20,57,63,3,123,393,61,54,508,162.716666666667,167.5,2633.79661016949,1498.69491525424,74,35,109,100
"./Ship3_Latin-square/2019-09-23_12h37m_Subject 47626.txt","47626",2019-09-23,"12:37",2,82,57,0,25,25,29,0,5,34,59,0,49,108,215,0,116,331,569.122807017544,206.649122807018,2814.01754385965,1808.63636363636,13,402,415,32.7586206896552
"./Ship3_Latin-square/2019-09-23_12h37m_Subject 47632.txt","47632",2019-09-23,"12:37",16,83,60,12,11,23,19,7,6,32,47,12,16,75,586,70,150,806,291.4,222.983333333333,2240.64406779661,1084.88235294118,39,115,154,86.8852459016393
"./Ship3_Latin-square/2019-09-23_12h37m_Subject 47634.txt","47634",2019-09-23,"12:37",8,78,60,9,9,18,36,5,7,48,14,2,4,20,309,44,64,417,332.033333333333,123.65,2606.72881355932,1992.92452830189,94,55,149,91.8032786885246
"./Ship3_Latin-square/2019-09-23_12h37m_Subject 47640.txt","47640",2019-09-23,"12:37",8,82,60,13,9,22,43,5,8,56,35,6,7,48,473,65,109,647,743.8,154.483333333333,2633.86440677966,2227.88679245283,66,42,108,93.4426229508197
"./Ship3_Latin-square/2019-09-23_12h37m_Subject 47754.txt","47754",2019-09-23,"12:37",16,58,43,11,4,15,71,9,3,83,36,5,3,44,150,18,27,195,2496.25581395349,276.976744186047,2404.62790697674,3373.86486486487,32,51,83,86.3636363636364
"./Ship3_Latin-square/2019-09-23_12h37m_Subject 47800.txt","47800",2019-09-23,"12:37",4,76,60,7,9,16,46,4,6,56,45,5,7,57,387,43,49,479,364.983333333333,169.433333333333,2789.81355932203,1851.42372881356,49,91,140,100
"./Ship3_Latin-square/2019-09-23_12h40m_Subject 46880.txt","46880",2019-09-23,"12:40",8,82,60,10,12,22,8,0,2,10,7,8,6,21,655,105,126,886,141.2,101.566666666667,2566.06779661017,1480.39024390244,62,189,251,77.0491803278689
"./Ship3_Latin-square/2019-09-23_12h40m_Subject 46882.txt","46882",2019-09-23,"12:40",4,77,60,6,11,17,23,0,1,24,46,15,2,63,999,91,236,1326,150.666666666667,145.616666666667,2762.64406779661,1767.16666666667,22,159,181,93.4426229508197
"./Ship3_Latin-square/2019-09-23_12h40m_Subject 46883.txt","46883",2019-09-23,"12:40",0,81,60,10,11,21,30,7,2,39,25,5,8,38,426,74,79,579,364.05,165.166666666667,2999.89830508475,2026,48,101,149,95.0819672131148
"./Ship3_Latin-square/2019-09-23_12h40m_Subject 46894.txt","46894",2019-09-23,"12:40",24,74,53,14,7,21,66,15,9,90,25,8,0,33,139,7,27,173,1461.61538461538,150.230769230769,2030.71153846154,3522.84210526316,76,35,111,81.1320754716981
"./Ship3_Latin-square/2019-09-23_12h40m_Subject 46896.txt","46896",2019-09-23,"12:40",24,76,56,10,10,20,87,3,18,108,53,5,44,102,293,8,50,351,1264.69642857143,176.339285714286,1821.76363636364,1813.43137254902,39,51,90,92.8571428571429
"./Ship3_Latin-square/2019-09-23_12h40m_Subject 47088.txt","47088",2019-09-23,"12:40",8,76,60,6,10,16,52,4,20,76,34,6,5,45,728,117,128,973,250.45,158.066666666667,2566.03389830508,1336.01724137931,66,105,171,100
"./Ship3_Latin-square/2019-09-23_12h40m_Subject 47228.txt","47228",2019-09-23,"12:40",24,84,60,9,15,24,32,5,8,45,12,1,13,26,249,17,147,413,271.916666666667,86.1,1657.57627118644,1353.1,37,104,141,77.0491803278689
"./Ship3_Latin-square/2019-09-23_12h40m_Subject 47243.txt","47243",2019-09-23,"12:40",24,86,60,12,14,26,95,11,30,136,50,53,11,114,370,17,154,541,333.383333333333,253.3,1820.28813559322,1466.37288135593,137,39,176,100
"./Ship3_Latin-square/2019-09-23_12h40m_Subject 47249.txt","47249",2019-09-23,"12:40",8,81,60,10,11,21,42,12,6,60,113,22,21,156,336,44,70,450,290.116666666667,365.883333333333,2579.62711864407,1641.87931034483,56,60,116,98.3606557377049
"./Ship3_Latin-square/2019-09-23_12h40m_Subject 47639.txt","47639",2019-09-23,"12:40",24,67,48,12,7,19,83,8,16,107,56,23,13,92,228,7,23,258,1345.75,613.3125,2049.95833333333,2101.04651162791,81,33,114,91.8367346938776
"./Ship3_Latin-square/2019-09-23_12h40m_Subject 47649.txt","47649",2019-09-23,"12:40",16,64,48,12,4,16,27,8,0,35,13,3,2,18,163,23,15,201,1394.89583333333,295.104166666667,2433.3125,4878.85714285714,119,69,188,55.1020408163265
"./Ship3_Latin-square/2019-09-23_12h40m_Subject 47753.txt","47753",2019-09-23,"12:40",0,77,60,4,13,17,36,0,6,42,36,0,9,45,742,51,132,925,276,143.3,2999.89830508475,1615.10526315789,46,141,187,96.7213114754098
"./Ship3_Latin-square/2019-09-23_12h40m_Subject 47758.txt","47758",2019-09-23,"12:40",8,80,60,10,10,20,17,0,2,19,18,1,6,25,827,119,156,1102,101.816666666667,108.683333333333,2593.20338983051,1242.56896551724,56,37,93,98.3606557377049
"./Ship3_Latin-square/2019-09-23_12h40m_Subject 47759.txt","47759",2019-09-23,"12:40",8,84,60,14,10,24,22,4,5,31,74,37,6,117,529,77,144,750,184.4,278.233333333333,2660.96610169492,1294.37037037037,44,92,136,95.0819672131148
"./Ship3_Latin-square/2019-09-23_12h40m_Subject 47776.txt","47776",2019-09-23,"12:40",24,76,60,8,8,16,29,2,3,34,44,12,8,64,726,13,118,857,107.916666666667,136.383333333333,1860.96610169492,759.877192982456,58,24,82,96.7213114754098
"./Ship3_Latin-square/2019-09-23_12h40m_Subject 47799.txt","47799",2019-09-23,"12:40",8,80,60,9,11,20,16,2,9,27,95,15,37,147,463,57,118,638,161.116666666667,276.8,2566.05084745763,1421.77586206897,43,40,83,96.7213114754098
"./Ship3_Latin-square/2019-09-23_13h42m_Subject 46888.txt","46888",2019-09-23,"13:42",4,79,60,7,12,19,9,0,1,10,63,9,7,79,835,101,167,1103,59.7333333333333,201.516666666667,2762.67796610169,1855.64406779661,55,87,142,100
"./Ship3_Latin-square/2019-09-23_13h42m_Subject 46889.txt","46889",2019-09-23,"13:42",16,78,60,12,6,18,39,5,2,46,17,5,1,23,656,66,107,829,424.25,97.4833333333333,2349.1186440678,1419.23214285714,62,88,150,96.7213114754098
"./Ship3_Latin-square/2019-09-23_13h42m_Subject 46890.txt","46890",2019-09-23,"13:42",4,83,60,10,13,23,25,3,3,31,10,3,4,17,246,48,74,368,477.75,113.266666666667,2783.05084745763,2622.56097560976,94,91,185,78.6885245901639
"./Ship3_Latin-square/2019-09-23_13h42m_Subject 46892.txt","46892",2019-09-23,"13:42",24,82,60,15,7,22,66,12,1,79,42,49,1,92,318,19,63,400,435.916666666667,264.75,2145.67796610169,1957.8125,64,67,131,86.8852459016393
"./Ship3_Latin-square/2019-09-23_13h42m_Subject 46898.txt","46898",2019-09-23,"13:42",2,87,60,10,17,27,41,5,11,57,18,4,9,31,555,126,131,812,358.566666666667,196.35,2881.33898305085,1671.57407407407,37,116,153,95.0819672131148
"./Ship3_Latin-square/2019-09-23_13h42m_Subject 47097.txt","47097",2019-09-23,"13:42",8,83,60,11,12,23,43,2,4,49,78,19,13,110,690,106,139,935,442.233333333333,255.7,2593.13559322034,1393.10169491525,59,88,147,100
"./Ship3_Latin-square/2019-09-23_13h42m_Subject 47099.txt","47099",2019-09-23,"13:42",24,41,29,11,1,12,8,5,0,13,18,237,0,255,189,40,6,235,191.103448275862,178.51724137931,2586.20689655172,1677.28,67,5,72,83.3333333333333
"./Ship3_Latin-square/2019-09-23_13h42m_Subject 47798.txt","47798",2019-09-23,"13:42",24,65,49,9,7,16,50,4,11,65,18,14,7,39,88,0,24,112,1443.12244897959,152.734693877551,1971.34693877551,3630,43,61,104,72
"./Ship3_Latin-square/2019-09-23_13h50m_Subject 46876.txt","46876",2019-09-23,"13:50",8,72,52,13,7,20,26,11,4,41,9,2,4,15,370,67,73,510,1315.86274509804,168.490196078431,2701.92156862745,2009.09523809524,75,54,129,90.3846153846154
"./Ship3_Latin-square/2019-09-23_13h50m_Subject 46877.txt","46877",2019-09-23,"13:50",24,86,60,17,9,26,29,4,5,38,95,19,15,129,610,31,140,781,160,312.066666666667,2023.67796610169,1181.67346938776,83,112,195,86.8852459016393
"./Ship3_Latin-square/2019-09-23_13h50m_Subject 46893.txt","46893",2019-09-23,"13:50",24,79,60,11,8,19,45,2,10,57,93,26,7,126,666,18,169,853,141.533333333333,266.916666666667,1861.01694915254,865.824561403509,35,43,78,98.3606557377049
"./Ship3_Latin-square/2019-09-23_13h50m_Subject 46895.txt","46895",2019-09-23,"13:50",16,69,50,14,5,19,69,13,7,89,34,41,5,80,169,31,19,219,1569.61224489796,252.081632653061,2510.12244897959,2269.52173913043,40,38,78,94
"./Ship3_Latin-square/2019-09-23_13h50m_Subject 47638.txt","47638",2019-09-23,"13:50",24,72,50,18,4,22,56,19,5,80,39,36,0,75,203,20,16,239,1326.95918367347,273.204081632653,2412.18367346939,2945.5,100,22,122,96
"./Ship3_Latin-square/2019-09-23_13h50m_Subject 47757.txt","47757",2019-09-23,"13:50",8,76,56,11,9,20,96,19,11,126,36,9,4,49,281,60,45,386,1583.07142857143,242.75,2636.29090909091,2318.38461538462,62,111,173,96.4912280701754
"./Ship3_Latin-square/2019-09-23_13h50m_Subject 47769.txt","47769",2019-09-23,"13:50",24,71,50,14,7,21,90,15,26,131,52,33,7,92,328,21,25,374,1576.12,306.6,2167.24489795918,1838.27083333333,76,49,125,100
"./Ship3_Latin-square/2019-09-23_13h50m_Subject 47771.txt","47771",2019-09-23,"13:50",16,83,60,13,10,23,41,3,10,54,26,58,2,86,454,49,85,588,257.766666666667,142.8,2267.74576271186,1595.94339622642,32,65,97,93.4426229508197
"./Ship3_Latin-square/2019-09-23_13h50m_Subject 47775.txt","47775",2019-09-23,"13:50",16,77,60,10,7,17,128,24,14,166,47,13,2,62,246,28,46,320,702.75,205.616666666667,2294.77966101695,1915.1724137931,85,50,135,98.3606557377049
"./Ship3_Latin-square/2019-09-23_13h50m_Subject 47781.txt","47781",2019-09-23,"13:50",4,79,60,8,11,19,15,2,5,22,22,10,3,35,1206,154,219,1579,89.9666666666667,146.266666666667,2783.03389830508,1524.08771929825,37,94,131,96.7213114754098
"./Ship3_Latin-square/2019-09-23_13h50m_Subject 47782.txt","47782",2019-09-23,"13:50",8,81,60,11,10,21,19,0,11,30,21,15,2,38,707,108,156,971,125.366666666667,145.8,2606.67796610169,1500.75862068966,54,51,105,98.3606557377049
"./Ship3_Latin-square/2019-09-23_13h50m_Subject 47783.txt","47783",2019-09-23,"13:50",4,80,60,7,13,20,56,5,8,69,46,7,12,65,668,64,56,788,1213.6,244.783333333333,2762.67796610169,2004.73684210526,53,103,156,98.3606557377049
"./Ship3_Latin-square/2019-09-23_13h50m_Subject 47785.txt","47785",2019-09-23,"13:50",4,80,60,10,10,20,8,2,1,11,52,22,19,93,1389,224,230,1843,78.25,131.55,2796.5593220339,1299.27450980392,34,248,282,88.5245901639344
"./Ship3_Latin-square/2019-09-23_13h50m_Subject 47786.txt","47786",2019-09-23,"13:50",2,72,53,6,13,19,74,11,19,104,15,8,27,50,243,23,77,343,1266.49056603774,147.528301886792,2884.59615384615,2541.625,37,54,91,92.5925925925926
"./Ship3_Latin-square/2019-09-23_13h50m_Subject 47788.txt","47788",2019-09-23,"13:50",8,77,60,8,9,17,43,4,13,60,65,8,8,81,579,84,109,772,297.3,178.166666666667,2579.5593220339,1589.94827586207,36,83,119,98.3606557377049
"./Ship3_Latin-square/2019-09-23_15h00m_Subject 47080.txt","47080",2019-09-23,"15:00",4,77,60,5,12,17,9,0,2,11,58,3,8,69,1023,113,287,1423,70.7,124.016666666667,2755.84745762712,1503.05454545455,35,197,232,95.0819672131148
"./Ship3_Latin-square/2019-09-23_15h00m_Subject 47089.txt","47089",2019-09-23,"15:00",8,83,60,15,8,23,22,5,4,31,50,15,8,73,488,95,74,657,244.683333333333,153.083333333333,2701.66101694915,1053.67796610169,90,27,117,98.3606557377049
"./Ship3_Latin-square/2019-09-23_15h00m_Subject 47762.txt","47762",2019-09-23,"15:00",24,76,56,12,8,20,72,11,14,97,71,26,23,120,147,4,36,187,826.142857142857,537.732142857143,1842.82142857143,1857.67346938776,72,53,125,89.4736842105263
"./Ship3_Latin-square/2019-09-23_15h00m_Subject 47791.txt","47791",2019-09-23,"15:00",16,82,60,12,10,22,14,0,1,15,39,14,7,60,576,72,134,782,114.216666666667,194.133333333333,2213.49152542373,1130.32203389831,23,56,79,100
"./Ship3_Latin-square/2019-09-24_09h50m_Subject 46884.txt","46884",2019-09-24,"09:50",2,71,60,5,6,11,29,1,2,32,23,1,4,28,277,7,26,310,482.816666666667,325.2,2898.27118644068,2481.79545454545,64,107,171,80.327868852459
"./Ship3_Latin-square/2019-09-24_09h50m_Subject 47083.txt","47083",2019-09-24,"09:50",16,80,57,11,12,23,52,10,18,80,47,14,18,79,294,42,105,441,757.438596491228,214,2157.85964912281,1908.27777777778,90,75,165,94.8275862068966
"./Ship3_Latin-square/2019-09-24_09h50m_Subject 47086.txt","47086",2019-09-24,"09:50",24,82,60,15,7,22,93,15,15,123,24,3,9,36,195,13,10,218,954.169491525424,131.254237288136,2105.05084745763,1713.4,46,71,117,93.3333333333333
"./Ship3_Latin-square/2019-09-24_09h50m_Subject 47246.txt","47246",2019-09-24,"09:50",2,81,60,8,13,21,9,2,2,13,21,8,9,38,490,79,103,672,125.066666666667,166.516666666667,2881.33898305085,1910.08474576271,34,96,130,100
"./Ship3_Latin-square/2019-09-24_09h50m_Subject 47635.txt","47635",2019-09-24,"09:50",24,87,60,13,14,27,79,10,33,122,62,16,25,103,198,2,98,298,408.5,214.583333333333,1820.28813559322,1450.5593220339,62,32,94,100
"./Ship3_Latin-square/2019-09-24_09h50m_Subject 47779.txt","47779",2019-09-24,"09:50",24,51,38,9,4,13,36,6,4,46,44,9,2,55,50,7,10,67,2059.28947368421,571.135135135135,2091.75675675676,4888.25,65,24,89,78.9473684210526
"./Ship3_Latin-square/2019-09-24_09h50m_Subject 47790.txt","47790",2019-09-24,"09:50",0,80,60,7,13,20,18,0,0,18,8,1,12,21,978,63,225,1266,192.233333333333,136.55,2999.96610169492,1545.38461538462,35,248,283,93.4426229508197
"./Ship3_Latin-square/2019-09-24_09h50m_Subject 47797.txt","47797",2019-09-24,"09:50",2,63,49,5,9,14,38,2,9,49,50,6,24,80,206,42,45,293,2387.91666666667,309.104166666667,2891.60416666667,3201.81818181818,22,84,106,93.8775510204082
"./Ship3_Latin-square/2019-09-24_09h52m_Subject 46878.txt","46878",2019-09-24,"09:52",0,79,60,6,13,19,15,0,5,20,6,2,0,8,1165,122,224,1511,81.85,114.5,2999.93220338983,1431.01694915254,48,98,146,98.3606557377049
"./Ship3_Latin-square/2019-09-24_09h52m_Subject 46885.txt","46885",2019-09-24,"09:52",2,85,60,10,15,25,40,14,9,63,9,2,4,15,307,44,86,437,427.216666666667,108.466666666667,2877.94915254237,2286.07547169811,55,76,131,93.4426229508197
"./Ship3_Latin-square/2019-09-24_09h52m_Subject 46899.txt","46899",2019-09-24,"09:52",16,81,60,13,8,21,65,12,15,92,38,9,8,55,619,62,138,819,295.333333333333,162.2,2376.27118644068,849.237288135593,37,28,65,100
"./Ship3_Latin-square/2019-09-24_09h52m_Subject 47081.txt","47081",2019-09-24,"09:52",2,81,60,10,11,21,13,2,3,18,19,2,6,27,667,131,115,913,71.9166666666667,162.283333333333,2894.79661016949,1509.3275862069,45,58,103,98.3333333333333
"./Ship3_Latin-square/2019-09-24_09h52m_Subject 47091.txt","47091",2019-09-24,"09:52",16,74,60,8,6,14,16,0,1,17,40,10,5,55,229,24,26,279,340.483333333333,170.666666666667,2240.66101694915,1527,40,69,109,90.1639344262295
"./Ship3_Latin-square/2019-09-24_09h52m_Subject 47095.txt","47095",2019-09-24,"09:52",0,78,60,8,10,18,62,2,9,73,30,19,33,82,495,61,129,685,528.016666666667,193.716666666667,2999.91525423729,1829.51724137931,31,56,87,98.3606557377049
"./Ship3_Latin-square/2019-09-24_09h52m_Subject 47231.txt","47231",2019-09-24,"09:52",16,76,53,10,13,23,59,9,12,80,31,25,24,80,117,20,36,173,1415.7358490566,177.132075471698,2124.49056603774,2666.71428571429,39,56,95,92.5925925925926
"./Ship3_Latin-square/2019-09-24_09h52m_Subject 47238.txt","47238",2019-09-24,"09:52",4,81,60,9,12,21,16,1,4,21,52,29,13,94,486,82,85,653,217.25,215.266666666667,2789.77966101695,1383.46551724138,37,44,81,98.3606557377049
"./Ship3_Latin-square/2019-09-24_09h52m_Subject 47242.txt","47242",2019-09-24,"09:52",4,79,60,7,12,19,16,1,3,20,133,15,12,160,583,64,97,744,124.7,355.466666666667,2762.67796610169,1516,55,54,109,100
"./Ship3_Latin-square/2019-09-24_09h52m_Subject 47244.txt","47244",2019-09-24,"09:52",2,79,60,9,10,19,14,1,0,15,64,18,20,102,783,124,126,1033,151.55,216.433333333333,2901.66101694915,1607.94736842105,78,77,155,100
"./Ship3_Latin-square/2019-09-24_09h52m_Subject 47633.txt","47633",2019-09-24,"09:52",0,75,60,6,9,15,23,2,4,29,58,8,12,78,425,27,85,537,294.716666666667,188.1,2999.8813559322,1966.20338983051,89,72,161,98.3606557377049
"./Ship3_Latin-square/2019-09-24_09h52m_Subject 47636.txt","47636",2019-09-24,"09:52",24,66,48,11,7,18,112,8,27,147,101,15,11,127,193,14,31,238,1418.91666666667,585.68085106383,2029.74468085106,2760.04545454545,128,83,211,93.75
"./Ship3_Latin-square/2019-09-24_09h52m_Subject 47752.txt","47752",2019-09-24,"09:52",16,79,60,13,6,19,63,15,3,81,28,24,2,54,397,51,35,483,696.616666666667,125.9,2321.96610169492,1481.63636363636,65,46,111,93.3333333333333
"./Ship3_Latin-square/2019-09-24_09h52m_Subject 47767.txt","47767",2019-09-24,"09:52",4,78,60,8,10,18,27,4,3,34,40,11,14,65,347,39,59,445,363.35,220.616666666667,2789.81355932203,1499.10344827586,29,39,68,100
"./Ship3_Latin-square/2019-09-24_09h52m_Subject 47768.txt","47768",2019-09-24,"09:52",24,76,54,12,10,22,68,7,14,89,48,9,12,69,206,7,51,264,881.962962962963,329.62962962963,1913.15094339623,2238.79069767442,64,65,129,83.3333333333333
"./Ship3_Latin-square/2019-09-24_09h52m_Subject 47780.txt","47780",2019-09-24,"09:52",0,78,60,7,11,18,49,5,1,55,48,11,4,63,458,41,81,580,520.15,198.85,2999.89830508475,1804.18644067797,50,48,98,100
"./Ship3_Latin-square/2019-09-24_11h01m_Subject 47229.txt","47229",2019-09-24,"11:01",4,79,60,10,9,19,12,3,1,16,42,7,5,54,1078,165,180,1423,96.1,163.933333333333,2803.33898305085,1200.62711864407,57,62,119,100
"./Ship3_Latin-square/2019-09-24_11h01m_Subject 47233.txt","47233",2019-09-24,"11:01",2,78,60,9,9,18,11,2,2,15,29,10,2,41,390,53,69,512,87.85,150.066666666667,2898.23728813559,1507.47272727273,40,46,86,95.0819672131148
"./Ship3_Latin-square/2019-09-24_11h01m_Subject 47234.txt","47234",2019-09-24,"11:01",24,87,60,13,14,27,39,6,10,55,52,14,24,90,377,21,150,548,155.916666666667,209.25,1779.66101694915,1200.22222222222,50,68,118,93.4426229508197
"./Ship3_Latin-square/2019-09-24_11h01m_Subject 47237.txt","47237",2019-09-24,"11:01",24,79,60,14,5,19,21,1,5,27,49,36,13,98,426,8,48,482,312.9,247.9,2145.72881355932,913.456140350877,46,29,75,98.3606557377049
"./Ship3_Latin-square/2019-09-24_11h01m_Subject 47241.txt","47241",2019-09-24,"11:01",2,85,60,2,23,25,8,0,4,12,9,0,2,11,1117,41,314,1472,66.6166666666667,142.316666666667,2837.27118644068,1365.81355932203,25,113,138,100
"./Ship3_Latin-square/2019-09-24_11h01m_Subject 47247.txt","47247",2019-09-24,"11:01",16,74,60,7,7,14,39,4,2,45,44,5,5,54,231,26,43,300,324.15,216.016666666667,2186.37288135593,1732.575,39,127,166,75.4098360655738
"./Ship3_Latin-square/2019-09-24_11h01m_Subject 47777.txt","47777",2019-09-24,"11:01",8,72,60,5,7,12,35,5,4,44,19,6,4,29,591,52,63,706,341.1,164.35,2593.15254237288,1606.98305084746,52,35,87,100
"./Ship3_Latin-square/2019-09-24_11h01m_Subject 47784.txt","47784",2019-09-24,"11:01",16,78,60,11,7,18,70,3,13,86,42,12,8,62,780,76,109,965,316.883333333333,224.25,2294.84745762712,984.694915254237,56,81,137,100
"./Ship3_Latin-square/2019-09-24_11h03m_Subject 46900.txt","46900",2019-09-24,"11:03",8,82,60,9,13,22,3,0,0,3,56,9,11,76,689,87,240,1016,91.35,139.033333333333,2579.62711864407,1259.47457627119,47,66,113,100
"./Ship3_Latin-square/2019-09-24_11h03m_Subject 46986.txt","46986",2019-09-24,"11:03",24,54,39,12,3,15,45,14,2,61,13,15,1,29,149,11,26,186,1838.73684210526,143.421052631579,2368.39473684211,2945.90909090909,66,22,88,92.3076923076923
"./Ship3_Latin-square/2019-09-24_11h03m_Subject 47076.txt","47076",2019-09-24,"11:03",4,82,60,11,11,22,8,2,0,10,26,3,4,33,831,111,190,1132,76.8166666666667,123.7,2803.37288135593,1785.41818181818,73,125,198,93.4426229508197
"./Ship3_Latin-square/2019-09-24_11h03m_Subject 47079.txt","47079",2019-09-24,"11:03",2,78,60,8,10,18,11,1,1,13,54,9,9,72,357,55,71,483,138.166666666667,228.033333333333,2898.23728813559,1933.83928571429,82,44,126,95.0819672131148
"./Ship3_Latin-square/2019-09-24_11h03m_Subject 47082.txt","47082",2019-09-24,"11:03",4,81,60,11,10,21,20,5,4,29,17,20,7,44,318,73,81,472,543.833333333333,103.8,2816.86440677966,2159.03703703704,91,41,132,93.4426229508197
"./Ship3_Latin-square/2019-09-24_11h03m_Subject 47092.txt","47092",2019-09-24,"11:03",2,80,60,10,10,20,18,0,3,21,16,8,5,29,918,169,120,1207,85.1166666666667,129.95,2898.20338983051,1556.06779661017,50,116,166,100
"./Ship3_Latin-square/2019-09-24_11h03m_Subject 47098.txt","47098",2019-09-24,"11:03",8,79,60,11,8,19,15,0,2,17,1,3,1,5,288,50,45,383,202.633333333333,82.4333333333333,2633.83050847458,1784.82978723404,81,54,135,83.6065573770492
"./Ship3_Latin-square/2019-09-24_11h03m_Subject 47226.txt","47226",2019-09-24,"11:03",4,77,60,6,11,17,3,0,0,3,67,6,26,99,3360,318,710,4388,26.25,139.4,2782.96610169492,1308.10526315789,20,260,280,96.7213114754098
"./Ship3_Latin-square/2019-09-24_11h03m_Subject 47227.txt","47227",2019-09-24,"11:03",4,79,60,6,13,19,39,2,7,48,7,2,4,13,389,50,100,539,597.4,102.733333333333,2755.86440677966,1920.22727272727,46,148,194,81.9672131147541
"./Ship3_Latin-square/2019-09-24_11h03m_Subject 47250.txt","47250",2019-09-24,"11:03",16,79,60,11,8,19,16,6,3,25,24,12,9,45,691,52,121,864,154.633333333333,125.483333333333,2267.76271186441,967.24,27,120,147,91.8032786885246
"./Ship3_Latin-square/2019-09-24_11h03m_Subject 47645.txt","47645",2019-09-24,"11:03",24,48,34,12,2,14,105,20,5,130,6,4,1,11,130,13,10,153,4491.0303030303,202,2490.81818181818,3542.09375,94,17,111,97.0588235294118
"./Ship3_Latin-square/2019-09-24_11h03m_Subject 47646.txt","47646",2019-09-24,"11:03",4,78,60,7,11,18,8,1,0,9,117,9,31,157,2012,226,446,2684,84.15,166.533333333333,2769.40677966102,1380.43103448276,30,89,119,98.3606557377049
"./Ship3_Latin-square/2019-09-24_11h03m_Subject 47755.txt","47755",2019-09-24,"11:03",16,80,60,12,8,20,49,6,8,63,20,11,3,34,513,65,87,665,190.7,151.816666666667,2294.86440677966,1554.47058823529,72,149,221,86.8852459016393
"./Ship3_Latin-square/2019-09-24_11h03m_Subject 47760.txt","47760",2019-09-24,"11:03",2,79,60,10,9,19,37,2,7,46,32,15,4,51,1030,223,146,1399,118.45,166.633333333333,2898.22033898305,1128.69491525424,13,44,57,100
"./Ship3_Latin-square/2019-09-24_11h03m_Subject 47770.txt","47770",2019-09-24,"11:03",0,61,46,7,8,15,71,17,3,91,47,18,15,80,220,36,26,282,2439.67391304348,238.739130434783,2999.93333333333,3747.53488372093,62,88,150,95.7446808510638
"./Ship3_Latin-square/2019-09-24_11h03m_Subject 47795.txt","47795",2019-09-24,"11:03",4,76,60,6,10,16,53,3,7,63,27,6,5,38,315,21,61,397,516.533333333333,153.05,2782.94915254237,2078.67272727273,42,35,77,96.7213114754098
"./Ship3_Latin-square/2019-09-24_12h13m_Subject 46880.txt","46880",2019-09-24,"12:13",4,79,60,5,14,19,8,0,2,10,15,1,10,26,742,75,187,1004,98.7166666666667,100.933333333333,2742.32203389831,1878.64285714286,62,276,338,80.327868852459
"./Ship3_Latin-square/2019-09-24_12h13m_Subject 46882.txt","46882",2019-09-24,"12:13",16,79,60,8,11,19,30,3,5,38,93,5,10,108,432,25,73,530,331.166666666667,286.066666666667,2159.30508474576,1580.47058823529,24,120,144,90.1639344262295
"./Ship3_Latin-square/2019-09-24_12h13m_Subject 46883.txt","46883",2019-09-24,"12:13",16,79,58,13,8,21,71,11,11,93,52,78,10,140,242,36,33,311,764.155172413793,324.98275862069,2365.37931034483,2239.22448979592,67,80,147,88.135593220339
"./Ship3_Latin-square/2019-09-24_12h13m_Subject 46894.txt","46894",2019-09-24,"12:13",8,82,60,10,12,22,43,3,7,53,18,5,6,29,518,68,125,711,762.716666666667,126.583333333333,2606.76271186441,1635.57627118644,78,23,101,100
"./Ship3_Latin-square/2019-09-24_12h13m_Subject 46896.txt","46896",2019-09-24,"12:13",16,78,60,9,9,18,56,2,8,66,35,6,6,47,564,40,140,744,660.633333333333,146.3,2240.64406779661,1469.6724137931,37,54,91,100
"./Ship3_Latin-square/2019-09-24_12h13m_Subject 47088.txt","47088",2019-09-24,"12:13",0,82,60,5,17,22,18,1,6,25,46,5,27,78,1281,154,270,1705,99.9666666666667,220.5,2999.8813559322,1424.22033898305,29,136,165,100
"./Ship3_Latin-square/2019-09-24_12h13m_Subject 47228.txt","47228",2019-09-24,"12:13",8,79,60,8,11,19,22,0,7,29,22,0,8,30,535,95,121,751,221,94.05,2552.49152542373,1503.03636363636,40,85,125,96.7213114754098
"./Ship3_Latin-square/2019-09-24_12h13m_Subject 47243.txt","47243",2019-09-24,"12:13",8,81,60,11,10,21,35,6,6,47,32,67,4,103,800,147,165,1112,137,181.566666666667,2633.8813559322,1547.57627118644,151,62,213,100
"./Ship3_Latin-square/2019-09-24_12h13m_Subject 47249.txt","47249",2019-09-24,"12:13",0,80,60,8,12,20,24,0,5,29,77,21,22,120,517,79,96,692,142.766666666667,209.383333333333,2999.89830508475,1596.91525423729,66,56,122,100
"./Ship3_Latin-square/2019-09-24_12h13m_Subject 47639.txt","47639",2019-09-24,"12:13",8,80,60,12,8,20,16,2,1,19,12,9,4,25,680,131,115,926,99.1333333333333,138.316666666667,2620.32203389831,1653.29310344828,76,60,136,100
"./Ship3_Latin-square/2019-09-24_12h13m_Subject 47649.txt","47649",2019-09-24,"12:13",2,83,60,8,15,23,45,6,8,59,14,3,3,20,479,98,155,732,323.766666666667,118.383333333333,2877.91525423729,1860.71794871795,55,201,256,85.2459016393443
"./Ship3_Latin-square/2019-09-24_12h13m_Subject 47753.txt","47753",2019-09-24,"12:13",24,85,60,16,9,25,67,27,8,102,39,17,11,67,318,8,57,383,406.883333333333,199.15,2105.08474576271,1316.76,104,60,164,85.2459016393443
"./Ship3_Latin-square/2019-09-24_12h13m_Subject 47758.txt","47758",2019-09-24,"12:13",0,80,60,4,16,20,13,0,0,13,17,0,9,26,1343,78,322,1743,67.6666666666667,113.333333333333,2999.89830508475,1338.79661016949,32,87,119,100
"./Ship3_Latin-square/2019-09-24_12h13m_Subject 47759.txt","47759",2019-09-24,"12:13",0,85,60,14,11,25,18,2,0,20,25,13,4,42,905,203,206,1314,86.1,163.433333333333,2999.89830508475,1286.27118644068,20,40,60,100
"./Ship3_Latin-square/2019-09-24_12h13m_Subject 47776.txt","47776",2019-09-24,"12:13",8,80,60,9,11,20,12,0,1,13,57,16,2,75,962,117,196,1275,89.1166666666667,172.3,2552.52542372881,1346.93103448276,64,44,108,100
"./Ship3_Latin-square/2019-09-24_12h13m_Subject 47799.txt","47799",2019-09-24,"12:13",0,78,60,8,10,18,13,2,2,17,40,15,14,69,718,117,119,954,185.55,161.816666666667,2999.8813559322,1571.08620689655,57,36,93,100
"./Ship3_Latin-square/2019-09-24_12h16m_Subject 46881.txt","46881",2019-09-24,"12:16",4,81,60,8,13,21,18,1,4,23,19,2,3,24,944,110,217,1271,171.833333333333,115.166666666667,2769.45762711864,1437.75438596491,46,106,152,100
"./Ship3_Latin-square/2019-09-24_12h16m_Subject 47087.txt","47087",2019-09-24,"12:16",4,79,60,10,9,19,18,1,1,20,102,19,5,126,391,75,53,519,127.9,212.183333333333,2796.59322033898,1505.35593220339,67,36,103,98.3606557377049
"./Ship3_Latin-square/2019-09-24_12h16m_Subject 47626.txt","47626",2019-09-24,"12:16",8,82,60,11,11,22,33,4,2,39,28,12,6,46,246,29,55,330,412.683333333333,164.866666666667,2593.20338983051,2436.59615384615,81,71,152,88.5245901639344
"./Ship3_Latin-square/2019-09-24_12h16m_Subject 47632.txt","47632",2019-09-24,"12:16",8,80,60,8,12,20,26,3,5,34,36,2,18,56,693,79,153,925,404,226.883333333333,2579.59322033898,1058.57627118644,27,73,100,98.3606557377049
"./Ship3_Latin-square/2019-09-24_12h16m_Subject 47634.txt","47634",2019-09-24,"12:16",4,81,60,11,10,21,51,5,11,67,19,5,4,28,330,51,78,459,447.6,184.916666666667,2810.13559322034,1931.69090909091,79,49,128,93.4426229508197
"./Ship3_Latin-square/2019-09-24_12h16m_Subject 47640.txt","47640",2019-09-24,"12:16",4,79,60,9,10,19,38,9,3,50,33,8,7,48,363,45,100,508,832.15,158.483333333333,2803.37288135593,2280.6170212766,48,103,151,85.2459016393443
"./Ship3_Latin-square/2019-09-24_12h16m_Subject 47754.txt","47754",2019-09-24,"12:16",24,45,33,8,4,12,81,11,16,108,23,17,2,42,55,4,8,67,4015.5,254.90625,2099.90625,4544.69230769231,24,43,67,87.8787878787879
"./Ship3_Latin-square/2019-09-24_12h16m_Subject 47800.txt","47800",2019-09-24,"12:16",16,75,60,8,7,15,44,6,6,56,64,9,6,79,283,33,39,355,475.15,229.75,2213.54237288136,1696.41379310345,57,59,116,98.3606557377049
"./Ship3_Latin-square/2019-09-24_13h24m_Subject 46888.txt","46888",2019-09-24,"13:24",16,79,60,10,9,19,16,0,1,17,54,17,11,82,541,72,127,740,165.083333333333,175.583333333333,2213.52542372881,1358.35185185185,56,117,173,93.4426229508197
"./Ship3_Latin-square/2019-09-24_13h24m_Subject 46889.txt","46889",2019-09-24,"13:24",2,80,60,9,11,20,7,4,2,13,22,3,5,30,1062,166,192,1420,89.7833333333333,149.283333333333,2891.45762711864,1593.58620689655,86,105,191,100
"./Ship3_Latin-square/2019-09-24_13h24m_Subject 46890.txt","46890",2019-09-24,"13:24",0,81,60,9,12,21,19,2,1,22,4,0,17,21,408,65,98,571,244.2,103.266666666667,2999.94915254237,2185.39024390244,66,143,209,81.9672131147541
"./Ship3_Latin-square/2019-09-24_13h24m_Subject 46892.txt","46892",2019-09-24,"13:24",8,75,60,7,8,15,16,0,0,16,13,5,6,24,792,83,106,981,99.3666666666667,116.483333333333,2606.72881355932,1353.03448275862,67,74,141,98.3606557377049
"./Ship3_Latin-square/2019-09-24_13h24m_Subject 46898.txt","46898",2019-09-24,"13:24",0,74,60,6,8,14,17,0,0,17,25,2,2,29,848,72,91,1011,108.866666666667,150.983333333333,2999.93220338983,1724.84745762712,41,83,124,100
"./Ship3_Latin-square/2019-09-24_13h24m_Subject 47097.txt","47097",2019-09-24,"13:24",4,81,60,9,12,21,30,3,6,39,69,15,22,106,759,106,210,1075,503.583333333333,240.666666666667,2776.23728813559,1581.30508474576,51,81,132,100
"./Ship3_Latin-square/2019-09-24_13h24m_Subject 47099.txt","47099",2019-09-24,"13:24",8,78,60,11,7,18,7,1,0,8,32,38,1,71,1096,171,136,1403,65.9333333333333,200.166666666667,2633.8813559322,960.525423728814,23,60,83,100
"./Ship3_Latin-square/2019-09-24_13h24m_Subject 47798.txt","47798",2019-09-24,"13:24",0,77,60,3,14,17,23,0,3,26,8,0,0,8,287,5,58,350,522.65,120.583333333333,2999.93220338983,2337.1,25,179,204,70.4918032786885
"./Ship3_Latin-square/2019-09-24_13h27m_Subject 46876.txt","46876",2019-09-24,"13:27",4,79,60,10,9,19,38,7,7,52,19,16,19,54,500,30,90,620,341.983333333333,144.05,2796.5593220339,1695.125,45,86,131,96.7213114754098
"./Ship3_Latin-square/2019-09-24_13h27m_Subject 46877.txt","46877",2019-09-24,"13:27",0,82,60,10,12,22,6,0,0,6,23,5,9,37,1368,236,271,1875,60.3,145.533333333333,2999.89830508475,1149.84745762712,36,83,119,100
"./Ship3_Latin-square/2019-09-24_13h27m_Subject 46893.txt","46893",2019-09-24,"13:27",8,73,60,8,5,13,12,1,1,14,61,10,2,73,1106,132,93,1331,104.866666666667,184.533333333333,2647.38983050847,1346.01694915254,119,79,198,100
"./Ship3_Latin-square/2019-09-24_13h27m_Subject 46895.txt","46895",2019-09-24,"13:27",2,81,60,4,17,21,36,4,13,53,26,0,15,41,294,15,97,406,675.25,170.433333333333,2864.40677966102,2110.84615384615,31,119,150,95.0819672131148
"./Ship3_Latin-square/2019-09-24_13h27m_Subject 47638.txt","47638",2019-09-24,"13:27",8,74,54,10,10,20,130,10,14,154,68,12,26,106,243,45,55,343,1562.85185185185,302.888888888889,2622.54716981132,2141.41509433962,58,28,86,100
"./Ship3_Latin-square/2019-09-24_13h27m_Subject 47757.txt","47757",2019-09-24,"13:27",0,79,58,6,15,21,72,7,13,92,30,5,5,40,343,34,100,477,1080.24137931034,219.655172413793,2999.85964912281,2248.96226415094,40,167,207,93.2203389830508
"./Ship3_Latin-square/2019-09-24_13h27m_Subject 47769.txt","47769",2019-09-24,"13:27",8,81,60,14,7,21,50,5,5,60,36,15,6,57,535,85,39,659,422.6,175.95,2661.01694915254,1908.84745762712,75,74,149,100
"./Ship3_Latin-square/2019-09-24_13h27m_Subject 47771.txt","47771",2019-09-24,"13:27",24,88,60,16,12,28,60,5,13,78,27,11,12,50,356,5,102,463,417.783333333333,171.583333333333,1942.32203389831,2009.80434782609,40,72,112,85.2459016393443
"./Ship3_Latin-square/2019-09-24_13h27m_Subject 47775.txt","47775",2019-09-24,"13:27",24,82,60,15,7,22,142,46,14,202,50,38,8,96,221,6,57,284,860.25,166.433333333333,2105.01694915254,1325.40740740741,63,53,116,91.8032786885246
"./Ship3_Latin-square/2019-09-24_13h27m_Subject 47781.txt","47781",2019-09-24,"13:27",16,80,60,9,11,20,49,0,5,54,36,7,4,47,698,33,186,917,163.666666666667,209.65,2159.25423728814,1491.34090909091,60,228,288,81.9672131147541
"./Ship3_Latin-square/2019-09-24_13h27m_Subject 47782.txt","47782",2019-09-24,"13:27",0,82,60,7,15,22,14,5,2,21,14,2,10,26,711,63,131,905,204.45,113.433333333333,2999.8813559322,1570.84482758621,46,42,88,98.3606557377049
"./Ship3_Latin-square/2019-09-24_13h27m_Subject 47783.txt","47783",2019-09-24,"13:27",16,80,60,11,9,20,58,5,10,73,27,2,9,38,554,33,73,660,1064.66666666667,132.75,2267.76271186441,1799.54385964912,63,52,115,96.7213114754098
"./Ship3_Latin-square/2019-09-24_13h27m_Subject 47785.txt","47785",2019-09-24,"13:27",16,82,60,13,9,22,12,4,1,17,57,15,11,83,779,80,210,1069,126.316666666667,160.983333333333,2322,1304.21276595745,39,156,195,85.2459016393443
"./Ship3_Latin-square/2019-09-24_13h27m_Subject 47786.txt","47786",2019-09-24,"13:27",0,77,60,5,12,17,79,3,18,100,25,1,8,34,282,29,53,364,994,134.016666666667,2999.93220338983,2506.85454545455,53,23,76,93.4426229508197
"./Ship3_Latin-square/2019-09-24_13h27m_Subject 47788.txt","47788",2019-09-24,"13:27",0,77,60,5,12,17,34,3,3,40,72,12,20,104,650,69,148,867,250.066666666667,192.266666666667,2999.94915254237,1810.84745762712,30,82,112,100
"./Ship3_Latin-square/2019-09-24_14h21m_Subject 47080.txt","47080",2019-09-24,"14:21",16,77,60,9,8,17,21,6,3,30,28,6,4,38,636,76,182,894,183.083333333333,139.733333333333,2213.50847457627,1504.96153846154,63,95,158,91.8032786885246
"./Ship3_Latin-square/2019-09-24_14h21m_Subject 47089.txt","47089",2019-09-24,"14:21",4,74,56,9,9,18,106,5,11,122,112,36,42,190,293,38,53,384,1533.54545454545,359.236363636364,2810.87272727273,2132.30188679245,92,37,129,96.4285714285714
"./Ship3_Latin-square/2019-09-24_14h21m_Subject 47762.txt","47762",2019-09-24,"14:21",0,78,60,8,10,18,70,8,5,83,23,8,6,37,187,30,50,267,1202.23333333333,147.983333333333,2999.8813559322,3280.24,66,59,125,88.5245901639344
"./Ship3_Latin-square/2019-09-24_14h21m_Subject 47791.txt","47791",2019-09-24,"14:21",2,83,60,8,15,23,18,2,3,23,33,7,9,49,614,82,118,814,223.416666666667,160.25,2874.54237288136,1532.73214285714,27,34,61,95.0819672131148
"./Ship3_Latin-square/2019-09-25_09h54m_Subject 46884.txt","46884",2019-09-25,"09:54",8,71,53,11,7,18,27,3,4,34,15,3,3,21,159,40,32,231,805.423076923077,253.423076923077,2646.09615384615,3503.73913043478,91,83,174,62.2641509433962
"./Ship3_Latin-square/2019-09-25_09h54m_Subject 47083.txt","47083",2019-09-25,"09:54",2,78,60,4,14,18,52,2,10,64,47,4,11,62,382,24,87,493,793.916666666667,259.316666666667,2867.77966101695,2249.85714285714,57,95,152,100
"./Ship3_Latin-square/2019-09-25_09h54m_Subject 47086.txt","47086",2019-09-25,"09:54",2,80,60,10,10,20,8,0,1,9,14,5,2,21,314,72,56,442,294.666666666667,130.283333333333,2905.01694915254,2017.58536585366,88,91,179,78.6885245901639
"./Ship3_Latin-square/2019-09-25_09h54m_Subject 47246.txt","47246",2019-09-25,"09:54",8,81,60,10,11,21,25,4,2,31,8,1,3,12,373,50,82,505,171.55,128.75,2579.62711864407,1723.57407407407,31,92,123,95.0819672131148
"./Ship3_Latin-square/2019-09-25_09h54m_Subject 47635.txt","47635",2019-09-25,"09:54",0,79,60,8,11,19,20,2,0,22,43,8,8,59,671,74,134,879,148,141.916666666667,2999.79661016949,1691.52631578947,63,58,121,96.7213114754098
"./Ship3_Latin-square/2019-09-25_09h54m_Subject 47779.txt","47779",2019-09-25,"09:54",0,79,57,9,13,22,10,1,0,11,61,11,11,83,187,30,21,238,1091.35087719298,177.947368421053,2999.84210526316,2767.6875,72,82,154,70.6896551724138
"./Ship3_Latin-square/2019-09-25_09h54m_Subject 47790.txt","47790",2019-09-25,"09:54",24,77,56,12,9,21,47,5,11,63,37,17,7,61,250,10,47,307,663.672727272727,218.781818181818,1909.05454545455,1637.44736842105,31,82,113,73.2142857142857
"./Ship3_Latin-square/2019-09-25_09h54m_Subject 47797.txt","47797",2019-09-25,"09:54",0,72,54,6,12,18,44,5,8,57,11,0,11,22,329,26,52,407,1427.60377358491,142.981132075472,2999.84905660377,2521.32653061224,7,95,102,94.4444444444444
"./Ship3_Latin-square/2019-09-25_09h57m_Subject 46878.txt","46878",2019-09-25,"09:57",16,75,60,8,7,15,20,0,3,23,11,12,1,24,573,51,77,701,112.416666666667,143.316666666667,2186.42372881356,1375.90566037736,60,116,176,91.8032786885246
"./Ship3_Latin-square/2019-09-25_09h57m_Subject 46885.txt","46885",2019-09-25,"09:57",8,83,60,12,11,23,72,19,12,103,14,4,2,20,314,36,77,427,932.3,142.333333333333,2620.27118644068,2157.98245614035,64,53,117,96.7213114754098
"./Ship3_Latin-square/2019-09-25_09h57m_Subject 46899.txt","46899",2019-09-25,"09:57",2,77,60,11,6,17,27,2,3,32,28,2,1,31,715,144,92,951,208.166666666667,136.816666666667,2915.23728813559,1002.98305084746,24,40,64,100
"./Ship3_Latin-square/2019-09-25_09h57m_Subject 47081.txt","47081",2019-09-25,"09:57",0,82,60,8,14,22,17,2,7,26,16,8,18,42,656,82,141,879,154.866666666667,109.3,2999.93220338983,1372.41379310345,35,54,89,100
"./Ship3_Latin-square/2019-09-25_09h57m_Subject 47091.txt","47091",2019-09-25,"09:57",2,78,60,4,14,18,26,1,8,35,57,5,11,73,280,24,61,365,384.166666666667,179.433333333333,2867.71186440678,2123.24137931034,41,72,113,98.3606557377049
"./Ship3_Latin-square/2019-09-25_09h57m_Subject 47095.txt","47095",2019-09-25,"09:57",24,67,49,12,6,18,74,12,9,95,38,32,10,80,204,10,34,248,2172.18367346939,275.729166666667,2099.97916666667,2390.82608695652,57,35,92,97.9591836734694
"./Ship3_Latin-square/2019-09-25_09h57m_Subject 47231.txt","47231",2019-09-25,"09:57",2,83,59,4,20,24,42,3,13,58,40,6,6,52,213,18,83,314,968.423728813559,164.220338983051,2847.4406779661,2012.0487804878,12,142,154,76.6666666666667
"./Ship3_Latin-square/2019-09-25_09h57m_Subject 47238.txt","47238",2019-09-25,"09:57",16,82,60,12,10,22,15,0,5,20,50,16,5,71,436,67,112,615,275.183333333333,183.983333333333,2294.8813559322,1102.37931034483,44,55,99,98.3606557377049
"./Ship3_Latin-square/2019-09-25_09h57m_Subject 47242.txt","47242",2019-09-25,"09:57",16,75,60,8,7,15,31,0,5,36,39,9,6,54,586,58,92,736,170.55,135.966666666667,2240.64406779661,1068.39285714286,47,95,142,95.0819672131148
"./Ship3_Latin-square/2019-09-25_09h57m_Subject 47244.txt","47244",2019-09-25,"09:57",8,80,60,10,10,20,20,2,5,27,63,20,30,113,687,86,129,902,171.05,218,2579.66101694915,1440.26315789474,64,128,192,96.7213114754098
"./Ship3_Latin-square/2019-09-25_09h57m_Subject 47633.txt","47633",2019-09-25,"09:57",16,81,60,11,10,21,23,2,8,33,71,15,12,98,248,21,64,333,442.983333333333,177.133333333333,2240.62711864407,1636.61818181818,70,57,127,93.4426229508197
"./Ship3_Latin-square/2019-09-25_09h57m_Subject 47636.txt","47636",2019-09-25,"09:57",0,74,54,8,12,20,85,7,8,100,83,18,9,110,328,60,61,449,1671,209.407407407407,2999.88679245283,2985.44230769231,109,87,196,98.1818181818182
"./Ship3_Latin-square/2019-09-25_09h57m_Subject 47752.txt","47752",2019-09-25,"09:57",2,80,60,10,10,20,62,6,7,75,29,17,4,50,676,107,83,866,571.55,119.783333333333,2901.61016949153,1464.03448275862,65,59,124,98.3606557377049
"./Ship3_Latin-square/2019-09-25_09h57m_Subject 47767.txt","47767",2019-09-25,"09:57",16,78,60,11,7,18,45,8,6,59,45,18,7,70,246,29,53,328,428.95,202.216666666667,2321.96610169492,1451.19298245614,53,30,83,96.7213114754098
"./Ship3_Latin-square/2019-09-25_09h57m_Subject 47768.txt","47768",2019-09-25,"09:57",0,79,60,5,14,19,17,4,9,30,22,2,5,29,696,74,152,922,226.233333333333,126.383333333333,2999.86440677966,1962.15517241379,42,90,132,98.3606557377049
"./Ship3_Latin-square/2019-09-25_09h57m_Subject 47780.txt","47780",2019-09-25,"09:57",24,82,60,11,11,22,69,11,18,98,78,29,6,113,249,5,54,308,747.316666666667,334.933333333333,1861,1323.64406779661,59,20,79,100
"./Ship3_Latin-square/2019-09-25_11h06m_Subject 47229.txt","47229",2019-09-25,"11:06",16,81,60,9,12,21,29,2,7,38,46,4,9,59,604,47,132,783,133.816666666667,192.583333333333,2159.28813559322,1093.25423728814,52,50,102,100
"./Ship3_Latin-square/2019-09-25_11h06m_Subject 47233.txt","47233",2019-09-25,"11:06",8,81,60,8,13,21,56,4,13,73,33,8,6,47,365,34,99,498,240.95,161.05,2552.52542372881,1524.96296296296,32,93,125,93.4426229508197
"./Ship3_Latin-square/2019-09-25_11h06m_Subject 47234.txt","47234",2019-09-25,"11:06",2,82,60,8,14,22,30,8,5,43,57,10,14,81,599,97,106,802,257.833333333333,282.433333333333,2881.27118644068,1627.77192982456,36,94,130,100
"./Ship3_Latin-square/2019-09-25_11h06m_Subject 47237.txt","47237",2019-09-25,"11:06",16,81,60,12,9,21,33,20,15,68,59,11,7,77,343,35,54,432,252.616666666667,340.2,2294.8813559322,1257.10909090909,38,61,99,93.4426229508197
"./Ship3_Latin-square/2019-09-25_11h06m_Subject 47241.txt","47241",2019-09-25,"11:06",0,84,60,4,20,24,15,0,1,16,7,0,1,8,1095,97,292,1484,83.25,123.683333333333,2999.8813559322,1669.61016949153,42,124,166,100
"./Ship3_Latin-square/2019-09-25_11h06m_Subject 47247.txt","47247",2019-09-25,"11:06",2,74,60,7,7,14,31,3,1,35,31,3,3,37,284,35,42,361,353.8,178.45,2898.27118644068,2021.19444444444,36,183,219,67.2131147540984
"./Ship3_Latin-square/2019-09-25_11h06m_Subject 47777.txt","47777",2019-09-25,"11:06",4,78,60,8,10,18,31,3,9,43,26,5,3,34,425,80,95,600,315.616666666667,161.916666666667,2782.96610169492,2158.05084745763,47,43,90,100
"./Ship3_Latin-square/2019-09-25_11h06m_Subject 47784.txt","47784",2019-09-25,"11:06",2,81,60,9,12,21,30,2,1,33,67,25,11,103,1454,243,273,1970,137.266666666667,235.7,2888.08474576271,1216.83050847458,75,101,176,100
"./Ship3_Latin-square/2019-09-25_11h08m_Subject 46900.txt","46900",2019-09-25,"11:08",4,77,60,7,10,17,7,1,1,9,24,5,16,45,750,71,163,984,94.7666666666667,133.783333333333,2789.79661016949,1294.73214285714,34,66,100,100
"./Ship3_Latin-square/2019-09-25_11h08m_Subject 46986.txt","46986",2019-09-25,"11:08",2,45,33,8,4,12,48,7,5,60,4,4,35,43,147,37,11,195,3842.69696969697,119.69696969697,2927.21212121212,3942.03333333333,48,23,71,97.0588235294118
"./Ship3_Latin-square/2019-09-25_11h08m_Subject 47076.txt","47076",2019-09-25,"11:08",16,83,60,14,9,23,23,2,10,35,151,62,48,261,401,59,33,493,254.433333333333,536.35,2294.86440677966,1676.97959183673,61,138,199,85.2459016393443
"./Ship3_Latin-square/2019-09-25_11h08m_Subject 47079.txt","47079",2019-09-25,"11:08",8,83,60,10,13,23,41,1,8,50,62,11,18,91,267,42,51,360,390.183333333333,255.55,2552.49152542373,1970.16981132075,91,56,147,91.8032786885246
"./Ship3_Latin-square/2019-09-25_11h08m_Subject 47082.txt","47082",2019-09-25,"11:08",16,50,41,5,4,9,56,5,5,66,32,5,2,39,211,18,15,244,4136.825,178.325,2319.925,2016.55555555556,43,41,84,92.6829268292683
"./Ship3_Latin-square/2019-09-25_11h08m_Subject 47092.txt","47092",2019-09-25,"11:08",8,78,60,9,9,18,20,2,4,26,21,8,2,31,650,103,130,883,103.466666666667,131.183333333333,2593.18644067797,1532.09090909091,65,105,170,95.0819672131148
"./Ship3_Latin-square/2019-09-25_11h08m_Subject 47098.txt","47098",2019-09-25,"11:08",24,79,54,15,10,25,76,1,33,110,16,10,12,38,130,2,27,159,990.240740740741,222.166666666667,2049.01886792453,2489.13333333333,46,68,114,89.0909090909091
"./Ship3_Latin-square/2019-09-25_11h08m_Subject 47226.txt","47226",2019-09-25,"11:08",16,83,60,11,12,23,15,0,4,19,32,19,15,66,1528,171,643,2342,156.6,109.1,2186.32203389831,991.471698113208,98,48,146,95.0819672131148
"./Ship3_Latin-square/2019-09-25_11h08m_Subject 47227.txt","47227",2019-09-25,"11:08",16,80,60,8,12,20,50,5,10,65,26,25,4,55,248,28,58,334,928.616666666667,174.933333333333,2159.30508474576,1509.50980392157,49,89,138,86.8852459016393
"./Ship3_Latin-square/2019-09-25_11h08m_Subject 47250.txt","47250",2019-09-25,"11:08",24,82,60,13,9,22,71,2,25,98,36,24,13,73,312,4,61,377,760.3,155.783333333333,2023.67796610169,1256.35294117647,35,44,79,88.5245901639344
"./Ship3_Latin-square/2019-09-25_11h08m_Subject 47645.txt","47645",2019-09-25,"11:08",2,62,43,10,9,19,92,21,16,129,20,7,20,47,181,42,25,248,2366.2380952381,182.904761904762,2904.71428571429,3157.2619047619,62,66,128,100
"./Ship3_Latin-square/2019-09-25_11h08m_Subject 47646.txt","47646",2019-09-25,"11:08",16,84,60,11,13,24,36,7,14,57,127,42,31,200,1181,39,454,1674,372.783333333333,345.583333333333,2132.13559322034,1293.28,48,105,153,91.8032786885246
"./Ship3_Latin-square/2019-09-25_11h08m_Subject 47755.txt","47755",2019-09-25,"11:08",2,80,60,10,10,20,58,4,7,69,21,4,2,27,547,87,108,742,387.833333333333,197.233333333333,2898.18644067797,2066.27083333333,53,228,281,90.1639344262295
"./Ship3_Latin-square/2019-09-25_11h08m_Subject 47760.txt","47760",2019-09-25,"11:08",8,79,60,11,8,19,41,5,6,52,48,15,5,68,663,96,90,849,234.25,167.033333333333,2620.27118644068,1161.59322033898,16,33,49,100
"./Ship3_Latin-square/2019-09-25_11h08m_Subject 47770.txt","47770",2019-09-25,"11:08",16,37,28,8,1,9,63,11,4,78,42,10,0,52,91,14,1,106,6414.60714285714,651.285714285714,2542.82142857143,3956.46153846154,59,24,83,96.551724137931
"./Ship3_Latin-square/2019-09-25_11h08m_Subject 47795.txt","47795",2019-09-25,"11:08",16,60,45,9,6,15,110,12,10,132,43,10,8,61,138,12,10,160,3011.59090909091,223.977272727273,2309,2164.95454545455,38,19,57,100
"./Ship3_Latin-square/2019-09-25_12h19m_Subject 46880.txt","46880",2019-09-25,"12:19",16,79,60,9,10,19,5,0,1,6,27,10,0,37,514,26,123,663,107.85,159.866666666667,2186.40677966102,1333.19444444444,66,108,174,77.0491803278689
"./Ship3_Latin-square/2019-09-25_12h19m_Subject 46882.txt","46882",2019-09-25,"12:19",24,79,58,12,9,21,78,5,20,103,69,24,73,166,289,6,48,343,816.263157894737,394.736842105263,1863.12280701754,1518.72916666667,29,136,165,87.9310344827586
"./Ship3_Latin-square/2019-09-25_12h19m_Subject 46883.txt","46883",2019-09-25,"12:19",2,78,60,7,11,18,23,0,10,33,17,4,2,23,588,79,108,775,155.333333333333,160.566666666667,2891.50847457627,1531.98275862069,32,68,100,100
"./Ship3_Latin-square/2019-09-25_12h19m_Subject 46894.txt","46894",2019-09-25,"12:19",0,83,60,5,18,23,56,4,7,67,15,1,12,28,684,23,160,867,694.633333333333,117.5,2999.86440677966,1921.78947368421,40,67,107,98.3606557377049
"./Ship3_Latin-square/2019-09-25_12h19m_Subject 46896.txt","46896",2019-09-25,"12:19",8,76,60,5,11,16,29,2,8,39,36,4,9,49,651,46,118,815,246.766666666667,120.633333333333,2538.94915254237,1515.22413793103,37,51,88,98.3606557377049
"./Ship3_Latin-square/2019-09-25_12h19m_Subject 47088.txt","47088",2019-09-25,"12:19",4,79,60,9,10,19,39,2,4,45,29,8,6,43,877,149,141,1167,246.633333333333,165.366666666667,2796.59322033898,1567.64406779661,69,126,195,100
"./Ship3_Latin-square/2019-09-25_12h19m_Subject 47228.txt","47228",2019-09-25,"12:19",0,81,60,9,12,21,23,6,3,32,37,12,5,54,576,69,104,749,300.166666666667,118.366666666667,2999.94915254237,1762.41071428571,28,83,111,95.0819672131148
"./Ship3_Latin-square/2019-09-25_12h19m_Subject 47243.txt","47243",2019-09-25,"12:19",0,79,60,10,9,19,45,3,2,50,17,10,0,27,1152,177,178,1507,121.733333333333,145.666666666667,2999.93220338983,1219.1186440678,139,71,210,98.3606557377049
"./Ship3_Latin-square/2019-09-25_12h19m_Subject 47249.txt","47249",2019-09-25,"12:19",4,78,60,7,11,18,42,5,3,50,90,10,24,124,479,49,81,609,280.783333333333,261.683333333333,2762.69491525424,1484.10169491525,49,108,157,100
"./Ship3_Latin-square/2019-09-25_12h19m_Subject 47639.txt","47639",2019-09-25,"12:19",0,81,60,8,13,21,19,3,2,24,5,4,4,13,1043,154,211,1408,112.983333333333,118.3,2999.8813559322,1636.59322033898,76,85,161,100
"./Ship3_Latin-square/2019-09-25_12h19m_Subject 47649.txt","47649",2019-09-25,"12:19",8,82,60,12,10,22,67,10,5,82,53,1,4,58,382,39,110,531,482.316666666667,210.75,2620.30508474576,2343.46511627907,114,155,269,81.9672131147541
"./Ship3_Latin-square/2019-09-25_12h19m_Subject 47753.txt","47753",2019-09-25,"12:19",2,78,60,7,11,18,16,4,5,25,44,9,8,61,700,89,118,907,178.516666666667,206.516666666667,2884.66101694915,1495.61016949153,47,100,147,100
"./Ship3_Latin-square/2019-09-25_12h19m_Subject 47758.txt","47758",2019-09-25,"12:19",4,78,60,6,12,18,12,2,1,15,21,3,4,28,1178,133,244,1555,73.3166666666667,112.016666666667,2776.22033898305,1195,53,59,112,100
"./Ship3_Latin-square/2019-09-25_12h19m_Subject 47759.txt","47759",2019-09-25,"12:19",4,78,60,9,9,18,9,3,1,13,28,1,3,32,702,71,127,900,119.666666666667,152.816666666667,2803.37288135593,1469.20689655172,31,55,86,98.3606557377049
"./Ship3_Latin-square/2019-09-25_12h19m_Subject 47776.txt","47776",2019-09-25,"12:19",0,81,60,8,13,21,18,2,1,21,49,15,28,92,1329,186,268,1783,94.8,135.966666666667,2999.8813559322,1115.79661016949,53,43,96,100
"./Ship3_Latin-square/2019-09-25_12h19m_Subject 47799.txt","47799",2019-09-25,"12:19",4,81,60,8,13,21,27,1,1,29,81,16,21,118,543,68,99,710,194.266666666667,264.133333333333,2762.66101694915,1313.71186440678,57,25,82,100
"./Ship3_Latin-square/2019-09-25_12h22m_Subject 46881.txt","46881",2019-09-25,"12:22",16,76,60,7,9,16,48,2,8,58,88,4,14,106,547,49,101,697,237.416666666667,312.733333333333,2159.30508474576,984.054545454545,19,87,106,96.7213114754098
"./Ship3_Latin-square/2019-09-25_12h22m_Subject 47087.txt","47087",2019-09-25,"12:22",16,82,60,13,9,22,38,6,6,50,45,20,7,72,216,31,29,276,374.45,162.55,2294.84745762712,1747.42105263158,70,31,101,95.0819672131148
"./Ship3_Latin-square/2019-09-25_12h22m_Subject 47626.txt","47626",2019-09-25,"12:22",4,77,60,10,7,17,10,2,0,12,64,46,7,117,264,39,51,354,231.733333333333,211.733333333333,2810.1186440678,2223.86666666667,102,93,195,81.9672131147541
"./Ship3_Latin-square/2019-09-25_12h22m_Subject 47632.txt","47632",2019-09-25,"12:22",16,81,60,12,9,21,23,2,2,27,13,11,4,28,728,76,99,903,410.916666666667,123.2,2267.74576271186,1118.33928571429,44,54,98,93.4426229508197
"./Ship3_Latin-square/2019-09-25_12h22m_Subject 47634.txt","47634",2019-09-25,"12:22",16,83,60,13,10,23,63,25,13,101,11,4,10,25,190,26,58,274,798.3,129.6,2267.72881355932,2219.0625,95,43,138,85.2459016393443
"./Ship3_Latin-square/2019-09-25_12h22m_Subject 47640.txt","47640",2019-09-25,"12:22",16,81,58,14,9,23,47,8,6,61,33,10,5,48,242,32,50,324,1338.75862068966,160.701754385965,2326.26315789474,2871.63265306122,59,60,119,91.3793103448276
"./Ship3_Latin-square/2019-09-25_12h22m_Subject 47754.txt","47754",2019-09-25,"12:22",8,61,43,11,7,18,39,37,3,79,49,33,24,106,152,32,33,217,2021.44186046512,298.395348837209,2646.41860465116,3762.05882352941,34,71,105,86.3636363636364
"./Ship3_Latin-square/2019-09-25_12h22m_Subject 47800.txt","47800",2019-09-25,"12:22",24,81,60,10,11,21,65,11,7,83,75,13,28,116,161,3,57,221,761.416666666667,250.566666666667,1779.62711864407,1197.72549019608,44,69,113,88.5245901639344
"./Ship3_Latin-square/2019-09-25_13h32m_Subject 46888.txt","46888",2019-09-25,"13:32",24,68,50,14,4,18,35,13,1,49,51,25,50,126,202,8,21,231,1791.88,244.98,2327.92,3664.47727272727,77,73,150,90.1960784313726
"./Ship3_Latin-square/2019-09-25_13h32m_Subject 46889.txt","46889",2019-09-25,"13:32",8,82,60,9,13,22,17,2,5,24,26,9,8,43,774,109,192,1075,202.483333333333,132.083333333333,2552.47457627119,1761.86274509804,65,161,226,90.1639344262295
"./Ship3_Latin-square/2019-09-25_13h32m_Subject 46890.txt","46890",2019-09-25,"13:32",8,58,41,7,10,17,11,0,5,16,15,1,21,37,185,24,50,259,312.146341463415,177.853658536585,2531.63414634146,2382.47368421053,94,75,169,64.2857142857143
"./Ship3_Latin-square/2019-09-25_13h32m_Subject 46892.txt","46892",2019-09-25,"13:32",0,77,60,6,11,17,11,5,3,19,8,0,6,14,1022,118,184,1324,90.0833333333333,112.333333333333,2999.89830508475,1479.96610169492,51,105,156,100
"./Ship3_Latin-square/2019-09-25_13h32m_Subject 46898.txt","46898",2019-09-25,"13:32",24,75,60,9,6,15,39,1,7,47,21,1,4,26,396,18,54,468,253.566666666667,162.666666666667,1942.32203389831,1373.69387755102,41,95,136,86.8852459016393
"./Ship3_Latin-square/2019-09-25_13h32m_Subject 47097.txt","47097",2019-09-25,"13:32",16,85,60,14,11,25,44,12,14,70,78,36,14,128,412,77,85,574,510.966666666667,217.933333333333,2294.81355932203,1769.93220338983,89,52,141,100
"./Ship3_Latin-square/2019-09-25_13h32m_Subject 47099.txt","47099",2019-09-25,"13:32",0,78,60,8,10,18,7,2,0,9,29,4,2,35,1345,190,186,1721,67.9666666666667,179.866666666667,2999.8813559322,1187.43103448276,27,73,100,100
"./Ship3_Latin-square/2019-09-25_13h32m_Subject 47798.txt","47798",2019-09-25,"13:32",16,79,60,9,10,19,25,3,2,30,12,5,3,20,197,17,40,254,1094.01666666667,142.35,2159.27118644068,2273.40476190476,48,83,131,83.6065573770492
"./Ship3_Latin-square/2019-09-25_13h34m_Subject 46876.txt","46876",2019-09-25,"13:34",16,52,40,9,3,12,42,8,3,53,40,7,2,49,183,21,18,222,3658.23076923077,320.435897435897,2425.53846153846,3220.82352941176,50,36,86,85
"./Ship3_Latin-square/2019-09-25_13h34m_Subject 46877.txt","46877",2019-09-25,"13:34",16,82,60,14,8,22,18,2,4,24,51,16,30,97,785,121,165,1071,103.466666666667,210,2349,1109.5,60,113,173,91.8032786885246
"./Ship3_Latin-square/2019-09-25_13h34m_Subject 46893.txt","46893",2019-09-25,"13:34",0,75,60,6,9,15,10,1,2,13,74,19,4,97,1207,136,184,1527,73.85,211.516666666667,2999.89830508475,1704.03448275862,94,99,193,96.7213114754098
"./Ship3_Latin-square/2019-09-25_13h34m_Subject 46895.txt","46895",2019-09-25,"13:34",8,49,38,6,5,11,74,29,9,112,73,48,11,132,113,11,6,130,2963.89189189189,749.648648648649,2654.02702702703,2373.5,35,48,83,86.8421052631579
"./Ship3_Latin-square/2019-09-25_13h34m_Subject 47638.txt","47638",2019-09-25,"13:34",0,80,60,10,10,20,77,9,9,95,28,6,14,48,397,65,51,513,584.116666666667,179.483333333333,2999.91525423729,1738.59322033898,36,54,90,100
"./Ship3_Latin-square/2019-09-25_13h34m_Subject 47757.txt","47757",2019-09-25,"13:34",4,74,55,11,8,19,73,12,9,94,16,3,7,26,272,65,30,367,1469.43636363636,205,2822.14814814815,2025.83333333333,67,77,144,100
"./Ship3_Latin-square/2019-09-25_13h34m_Subject 47769.txt","47769",2019-09-25,"13:34",0,81,60,11,10,21,25,3,4,32,40,13,3,56,619,123,83,825,176.183333333333,146.95,2999.8813559322,1869.15517241379,110,71,181,98.3606557377049
"./Ship3_Latin-square/2019-09-25_13h34m_Subject 47771.txt","47771",2019-09-25,"13:34",8,81,60,9,12,21,29,2,6,37,11,5,4,20,673,61,162,896,174.45,109.266666666667,2593.20338983051,1293.44827586207,24,70,94,98.3606557377049
"./Ship3_Latin-square/2019-09-25_13h34m_Subject 47775.txt","47775",2019-09-25,"13:34",8,83,60,11,12,23,76,8,23,107,56,16,18,90,457,44,103,604,354.366666666667,206.383333333333,2579.61016949153,1481.77966101695,40,46,86,100
"./Ship3_Latin-square/2019-09-25_13h34m_Subject 47781.txt","47781",2019-09-25,"13:34",24,82,60,12,10,22,23,5,2,30,54,18,9,81,586,21,113,720,174.016666666667,248.016666666667,1942.32203389831,1113.9512195122,40,92,132,80.327868852459
"./Ship3_Latin-square/2019-09-25_13h34m_Subject 47782.txt","47782",2019-09-25,"13:34",4,82,60,9,13,22,21,3,5,29,22,20,3,45,532,88,135,755,130.166666666667,138.283333333333,2776.23728813559,1468.93103448276,43,33,76,98.3606557377049
"./Ship3_Latin-square/2019-09-25_13h34m_Subject 47783.txt","47783",2019-09-25,"13:34",24,78,60,10,8,18,103,18,12,133,38,9,8,55,265,8,75,348,982.183333333333,173.3,1860.98305084746,1512.86206896552,68,30,98,100
"./Ship3_Latin-square/2019-09-25_13h34m_Subject 47785.txt","47785",2019-09-25,"13:34",24,85,60,15,10,25,29,3,10,42,51,19,20,90,604,15,185,804,172.583333333333,200.316666666667,1983,1207.90909090909,41,96,137,80.327868852459
"./Ship3_Latin-square/2019-09-25_13h34m_Subject 47786.txt","47786",2019-09-25,"13:34",24,68,53,8,7,15,74,6,16,96,34,2,3,39,149,9,20,178,1294.8679245283,316.415094339623,1822.58490566038,2283.64444444444,46,41,87,85.1851851851852
"./Ship3_Latin-square/2019-09-25_13h34m_Subject 47788.txt","47788",2019-09-25,"13:34",4,80,60,8,12,20,23,1,12,36,69,12,12,93,638,95,113,846,187.15,174.316666666667,2776.25423728814,1681.76271186441,32,75,107,100
"./Ship3_Latin-square/2019-09-25_14h37m_Subject 47080.txt","47080",2019-09-25,"14:37",24,84,60,12,12,24,19,1,3,23,41,14,7,62,520,16,221,757,128.683333333333,154.383333333333,1779.57627118644,1063.59459459459,25,101,126,75.4098360655738
"./Ship3_Latin-square/2019-09-25_14h37m_Subject 47089.txt","47089",2019-09-25,"14:37",16,79,56,14,9,23,55,13,13,81,78,37,11,126,247,31,41,319,1288.83928571429,369.982142857143,2371.39285714286,2101.6,108,38,146,98.2456140350877
"./Ship3_Latin-square/2019-09-25_14h37m_Subject 47762.txt","47762",2019-09-25,"14:37",16,74,57,13,4,17,74,14,6,94,25,18,0,43,161,20,7,188,1419.21052631579,212.263157894737,2438.57894736842,3200.51020408163,90,63,153,87.9310344827586
"./Ship3_Latin-square/2019-09-25_14h37m_Subject 47791.txt","47791",2019-09-25,"14:37",8,79,60,8,11,19,6,0,0,6,8,5,1,14,715,69,136,920,78.35,109.633333333333,2552.52542372881,1331.10344827586,29,22,51,100
"./Ship3_Latin-square/2019-09-26_10h00m_Subject 46884.txt","46884",2019-09-26,"10:00",4,77,60,8,9,17,28,2,3,33,21,4,2,27,354,49,41,444,306.3,166.35,2803.35593220339,2179.25,130,57,187,85.2459016393443
"./Ship3_Latin-square/2019-09-26_10h00m_Subject 47083.txt","47083",2019-09-26,"10:00",8,69,52,9,8,17,78,10,8,96,35,7,8,50,357,50,44,451,1482.56862745098,166.274509803922,2592.09803921569,2420.91666666667,77,92,169,94.2307692307692
"./Ship3_Latin-square/2019-09-26_10h00m_Subject 47086.txt","47086",2019-09-26,"10:00",0,81,60,7,14,21,13,2,1,16,29,5,2,36,611,68,147,826,196.633333333333,148.25,2999.98305084746,1226.62711864407,22,70,92,100
"./Ship3_Latin-square/2019-09-26_10h00m_Subject 47246.txt","47246",2019-09-26,"10:00",4,83,60,10,13,23,20,3,0,23,6,6,4,16,442,74,112,628,139.166666666667,130.333333333333,2789.81355932203,1616.37931034483,36,49,85,100
"./Ship3_Latin-square/2019-09-26_10h00m_Subject 47635.txt","47635",2019-09-26,"10:00",16,82,60,10,12,22,47,3,3,53,49,14,13,76,414,57,101,572,232.966666666667,177.016666666667,2159.27118644068,1412.86440677966,50,31,81,100
"./Ship3_Latin-square/2019-09-26_10h00m_Subject 47779.txt","47779",2019-09-26,"10:00",16,49,36,9,4,13,31,6,3,40,46,17,2,65,50,13,6,69,3694.77777777778,648.138888888889,2422.13888888889,7284.11538461538,71,22,93,75.6756756756757
"./Ship3_Latin-square/2019-09-26_10h00m_Subject 47790.txt","47790",2019-09-26,"10:00",2,81,60,10,11,21,10,5,2,17,14,8,16,38,722,98,94,914,179.5,156.133333333333,2894.84745762712,1616.46808510638,33,250,283,85.2459016393443
"./Ship3_Latin-square/2019-09-26_10h00m_Subject 47797.txt","47797",2019-09-26,"10:00",24,52,40,8,4,12,66,8,8,82,62,11,31,104,82,10,16,108,1649.25,680.875,1979.95,4596.18918918919,25,74,99,92.6829268292683
"./Ship3_Latin-square/2019-09-26_10h03m_Subject 46878.txt","46878",2019-09-26,"10:03",2,80,60,9,11,20,12,2,4,18,13,10,48,71,965,180,148,1293,78.2666666666667,154.883333333333,2894.86440677966,1607.5593220339,73,81,154,98.3606557377049
"./Ship3_Latin-square/2019-09-26_10h03m_Subject 46885.txt","46885",2019-09-26,"10:03",4,82,60,9,13,22,40,10,10,60,14,4,1,19,261,42,84,387,660.9,108.766666666667,2769.40677966102,2471.42592592593,56,59,115,95.0819672131148
"./Ship3_Latin-square/2019-09-26_10h03m_Subject 46899.txt","46899",2019-09-26,"10:03",8,79,60,10,9,19,17,1,6,24,15,3,11,29,760,96,176,1032,128.733333333333,111.683333333333,2620.33898305085,1031.05084745763,32,28,60,100
"./Ship3_Latin-square/2019-09-26_10h03m_Subject 47081.txt","47081",2019-09-26,"10:03",24,79,60,11,8,19,46,6,4,56,43,5,10,58,268,10,65,343,258,192.4,1820.32203389831,1237.82692307692,45,65,110,88.5245901639344
"./Ship3_Latin-square/2019-09-26_10h03m_Subject 47091.txt","47091",2019-09-26,"10:03",8,77,60,9,8,17,40,4,2,46,47,9,7,63,231,29,32,292,340.083333333333,167.55,2620.25423728814,1959.33928571429,66,58,124,95.0819672131148
"./Ship3_Latin-square/2019-09-26_10h03m_Subject 47095.txt","47095",2019-09-26,"10:03",2,77,60,5,12,17,28,4,7,39,19,1,14,34,457,46,68,571,523.3,187.283333333333,2871.16949152542,1823.94339622642,27,101,128,91.8032786885246
"./Ship3_Latin-square/2019-09-26_10h03m_Subject 47231.txt","47231",2019-09-26,"10:03",8,77,60,7,10,17,45,5,10,60,72,6,3,81,145,12,37,194,1154.65,246.683333333333,2566.05084745763,2520.06976744186,36,81,117,81.9672131147541
"./Ship3_Latin-square/2019-09-26_10h03m_Subject 47238.txt","47238",2019-09-26,"10:03",24,85,60,9,16,25,19,3,9,31,68,21,33,122,272,16,133,421,198.466666666667,247.6,1535.54237288136,949.758620689655,21,162,183,63.9344262295082
"./Ship3_Latin-square/2019-09-26_10h03m_Subject 47242.txt","47242",2019-09-26,"10:03",24,83,60,14,9,23,84,4,21,109,58,24,15,97,423,4,110,537,336.45,192.233333333333,2023.66101694915,1070.48936170213,37,94,131,81.9672131147541
"./Ship3_Latin-square/2019-09-26_10h03m_Subject 47244.txt","47244",2019-09-26,"10:03",4,81,60,9,12,21,18,2,0,20,58,11,26,95,862,142,175,1179,125.366666666667,199.866666666667,2782.94915254237,1450.8813559322,58,106,164,100
"./Ship3_Latin-square/2019-09-26_10h03m_Subject 47633.txt","47633",2019-09-26,"10:03",2,76,60,6,10,16,30,1,3,34,63,8,16,87,521,62,72,655,304.183333333333,174.8,2888.10169491525,1625.01724137931,68,93,161,98.3606557377049
"./Ship3_Latin-square/2019-09-26_10h03m_Subject 47636.txt","47636",2019-09-26,"10:03",16,67,51,11,5,16,51,9,3,63,45,25,4,74,207,35,15,257,1335.82,229.52,2359.88,3559.9347826087,132,63,195,92.156862745098
"./Ship3_Latin-square/2019-09-26_10h03m_Subject 47752.txt","47752",2019-09-26,"10:03",8,82,60,12,10,22,61,14,9,84,20,15,2,37,378,67,79,524,847.633333333333,114.533333333333,2633.79661016949,2235.49090909091,58,84,142,95.0819672131148
"./Ship3_Latin-square/2019-09-26_10h03m_Subject 47767.txt","47767",2019-09-26,"10:03",24,61,46,12,3,15,133,15,22,170,58,50,3,111,209,4,8,221,1825.06666666667,336.155555555556,2253.28888888889,1439.38095238095,59,36,95,93.4782608695652
"./Ship3_Latin-square/2019-09-26_10h03m_Subject 47768.txt","47768",2019-09-26,"10:03",16,84,60,12,12,24,63,6,7,76,40,10,11,61,475,64,83,622,402.533333333333,178.733333333333,2213.50847457627,1441.84482758621,31,70,101,98.3606557377049
"./Ship3_Latin-square/2019-09-26_10h03m_Subject 47780.txt","47780",2019-09-26,"10:03",0,82,60,9,13,22,43,6,6,55,66,25,14,105,494,77,113,684,355.883333333333,362.816666666667,2999.8813559322,1581.94915254237,64,39,103,100
"./Ship3_Latin-square/2019-09-26_11h10m_Subject 47229.txt","47229",2019-09-26,"11:10",24,85,60,13,12,25,58,3,15,76,61,22,14,97,513,15,122,650,276.516666666667,242.5,1860.98305084746,1124,94,65,159,90.1639344262295
"./Ship3_Latin-square/2019-09-26_11h10m_Subject 47233.txt","47233",2019-09-26,"11:10",4,83,60,11,12,23,22,3,6,31,30,4,5,39,407,70,78,555,105.2,183.216666666667,2803.35593220339,1574.46,58,95,153,90.1639344262295
"./Ship3_Latin-square/2019-09-26_11h10m_Subject 47234.txt","47234",2019-09-26,"11:10",0,82,60,8,14,22,48,6,16,70,38,19,17,74,726,122,122,970,262.85,241.333333333333,2999.89830508475,1261.17857142857,51,63,114,96.7213114754098
"./Ship3_Latin-square/2019-09-26_11h10m_Subject 47237.txt","47237",2019-09-26,"11:10",8,77,60,8,9,17,30,0,4,34,13,2,1,16,401,32,75,508,268.183333333333,162.6,2566.06779661017,1500.82142857143,42,48,90,96.7213114754098
"./Ship3_Latin-square/2019-09-26_11h10m_Subject 47241.txt","47241",2019-09-26,"11:10",24,83,60,12,11,23,17,5,3,25,22,8,9,39,623,14,174,811,103.083333333333,174.633333333333,1820.28813559322,946.675675675676,42,84,126,78.6885245901639
"./Ship3_Latin-square/2019-09-26_11h10m_Subject 47247.txt","47247",2019-09-26,"11:10",8,76,60,10,6,16,69,5,1,75,20,4,2,26,371,55,35,461,453.666666666667,159.183333333333,2660.93220338983,2013,90,122,212,86.8852459016393
"./Ship3_Latin-square/2019-09-26_11h10m_Subject 47777.txt","47777",2019-09-26,"11:10",16,80,60,9,11,20,84,7,5,96,15,2,16,33,372,42,80,494,523.716666666667,151.2,2159.25423728814,1578.12068965517,72,61,133,98.3606557377049
"./Ship3_Latin-square/2019-09-26_11h10m_Subject 47784.txt","47784",2019-09-26,"11:10",8,81,60,8,13,21,24,1,5,30,44,13,7,64,1349,124,395,1868,111.166666666667,183.833333333333,2538.96610169492,993.677966101695,51,96,147,100
"./Ship3_Latin-square/2019-09-26_11h12m_Subject 46900.txt","46900",2019-09-26,"11:12",16,81,60,11,10,21,13,1,2,16,19,14,7,40,477,48,102,627,189.283333333333,139.05,2240.62711864407,927.305084745763,26,39,65,100
"./Ship3_Latin-square/2019-09-26_11h12m_Subject 46986.txt","46986",2019-09-26,"11:12",0,75,53,8,14,22,49,5,6,60,15,3,23,41,269,44,58,371,1336.19230769231,173.307692307692,2999.84615384615,2720.09523809524,66,63,129,88.6792452830189
"./Ship3_Latin-square/2019-09-26_11h12m_Subject 47076.txt","47076",2019-09-26,"11:12",24,74,55,14,5,19,87,5,11,103,58,32,13,103,309,12,31,352,818.890909090909,281.472727272727,2199.92592592593,1300.63829787234,61,86,147,89.2857142857143
"./Ship3_Latin-square/2019-09-26_11h12m_Subject 47079.txt","47079",2019-09-26,"11:12",4,79,60,7,12,19,31,1,4,36,52,17,11,80,326,49,57,432,336.2,218.4,2776.23728813559,1821.13793103448,41,59,100,100
"./Ship3_Latin-square/2019-09-26_11h12m_Subject 47082.txt","47082",2019-09-26,"11:12",24,39,28,10,1,11,55,27,1,83,21,10,1,32,121,16,5,142,2842.77777777778,238.296296296296,2555.33333333333,2896.64,65,11,76,96.4285714285714
"./Ship3_Latin-square/2019-09-26_11h12m_Subject 47092.txt","47092",2019-09-26,"11:12",4,78,60,9,9,18,13,1,0,14,24,6,1,31,905,132,161,1198,71.2166666666667,138.816666666667,2803.37288135593,1574.52542372881,54,123,177,100
"./Ship3_Latin-square/2019-09-26_11h12m_Subject 47098.txt","47098",2019-09-26,"11:12",16,57,41,13,3,16,91,14,14,119,39,51,2,92,128,24,10,162,3191.85365853659,357.325,2519.95,2667.47058823529,53,46,99,90.2439024390244
"./Ship3_Latin-square/2019-09-26_11h12m_Subject 47226.txt","47226",2019-09-26,"11:12",24,78,60,11,7,18,53,2,12,67,59,36,4,99,1105,9,129,1243,439.25,146.583333333333,1860.91525423729,1103.28846153846,29,47,76,88.5245901639344
"./Ship3_Latin-square/2019-09-26_11h12m_Subject 47227.txt","47227",2019-09-26,"11:12",24,79,60,11,8,19,100,18,15,133,40,15,10,65,147,6,46,199,857.033333333333,221.033333333333,1942.32203389831,1619.07692307692,49,57,106,88.5245901639344
"./Ship3_Latin-square/2019-09-26_11h12m_Subject 47250.txt","47250",2019-09-26,"11:12",8,83,60,13,10,23,14,4,2,20,19,9,7,35,803,146,155,1104,112.216666666667,94.7666666666667,2647.37288135593,1320.59322033898,33,96,129,100
"./Ship3_Latin-square/2019-09-26_11h12m_Subject 47645.txt","47645",2019-09-26,"11:12",0,68,48,8,12,20,85,11,24,120,18,3,21,42,258,58,51,367,1905.70212765957,208.468085106383,2999.87234042553,2789.57777777778,54,65,119,95.8333333333333
"./Ship3_Latin-square/2019-09-26_11h12m_Subject 47646.txt","47646",2019-09-26,"11:12",24,77,60,10,7,17,65,4,8,77,99,16,4,119,568,5,191,764,466.833333333333,223.183333333333,1901.62711864407,1402.79545454545,37,86,123,80.327868852459
"./Ship3_Latin-square/2019-09-26_11h12m_Subject 47755.txt","47755",2019-09-26,"11:12",8,78,60,11,7,18,41,6,2,49,15,9,2,26,597,94,84,775,263.3,143.6,2633.84745762712,1751.92727272727,74,179,253,93.3333333333333
"./Ship3_Latin-square/2019-09-26_11h12m_Subject 47760.txt","47760",2019-09-26,"11:12",4,76,60,7,9,16,27,1,5,33,31,4,13,48,973,124,134,1231,134.566666666667,156.033333333333,2789.76271186441,1235.84745762712,19,44,63,100
"./Ship3_Latin-square/2019-09-26_11h12m_Subject 47770.txt","47770",2019-09-26,"11:12",2,57,44,7,6,13,47,12,2,61,47,9,9,65,155,32,12,199,2888.93023255814,252.348837209302,2897.55813953488,4664.25714285714,60,81,141,84.0909090909091
"./Ship3_Latin-square/2019-09-26_11h12m_Subject 47795.txt","47795",2019-09-26,"11:12",24,48,35,13,0,13,73,36,0,109,20,48,0,68,146,9,0,155,1187.02941176471,156.882352941176,2717.47058823529,2111.47058823529,46,1,47,100
"./Ship3_Latin-square/2019-09-26_12h13m_Subject 46881.txt","46881",2019-09-26,"12:13",24,81,60,12,9,21,47,4,11,62,32,9,4,45,358,13,80,451,324.083333333333,155.216666666667,1942.35593220339,1007.88461538462,22,75,97,90.1639344262295
"./Ship3_Latin-square/2019-09-26_12h13m_Subject 47087.txt","47087",2019-09-26,"12:13",24,84,60,13,11,24,57,5,12,74,54,45,8,107,263,19,59,341,287.05,212.616666666667,1860.93220338983,1322.28813559322,82,26,108,100
"./Ship3_Latin-square/2019-09-26_12h13m_Subject 47626.txt","47626",2019-09-26,"12:13",16,78,60,8,10,18,56,8,10,74,70,20,7,97,240,18,61,319,567.35,499.65,2159.27118644068,1667.71929824561,56,70,126,98.3606557377049
"./Ship3_Latin-square/2019-09-26_12h13m_Subject 47632.txt","47632",2019-09-26,"12:13",4,80,60,10,10,20,27,5,2,34,23,5,5,33,648,129,60,837,314.816666666667,152.066666666667,2796.5593220339,1362.23728813559,23,54,77,100
"./Ship3_Latin-square/2019-09-26_12h13m_Subject 47634.txt","47634",2019-09-26,"12:13",24,81,57,14,10,24,75,17,20,112,40,19,22,81,177,4,62,243,1131.60714285714,272.107142857143,2014.25,1309.60416666667,73,55,128,89.4736842105263
"./Ship3_Latin-square/2019-09-26_12h13m_Subject 47640.txt","47640",2019-09-26,"12:13",24,72,52,13,7,20,67,9,10,86,81,19,19,119,145,3,23,171,1710.72549019608,372.176470588235,2011.66666666667,2197.54545454545,59,71,130,88.4615384615385
"./Ship3_Latin-square/2019-09-26_12h13m_Subject 47754.txt","47754",2019-09-26,"12:13",0,74,54,6,14,20,50,25,12,87,60,3,76,139,473,36,92,601,1315.62962962963,223.851851851852,2999.90740740741,3348.46511627907,28,235,263,83.6363636363636
"./Ship3_Latin-square/2019-09-26_12h13m_Subject 47800.txt","47800",2019-09-26,"12:13",8,82,60,6,16,22,56,9,11,76,45,5,12,62,367,29,72,468,603.966666666667,170.183333333333,2471.15254237288,1606.57627118644,47,64,111,100
"./Ship3_Latin-square/2019-09-26_12h23m_Subject 46880.txt","46880",2019-09-26,"12:23",24,83,60,12,11,23,43,0,12,55,34,18,19,71,360,3,109,472,350.45,196.533333333333,1860.94915254237,1229,85,79,164,80.327868852459
"./Ship3_Latin-square/2019-09-26_12h23m_Subject 46882.txt","46882",2019-09-26,"12:23",8,77,60,8,9,17,58,17,3,78,81,40,42,163,647,125,121,893,271.45,265.016666666667,2593.20338983051,1555.53571428571,29,100,129,95.0819672131148
"./Ship3_Latin-square/2019-09-26_12h23m_Subject 46883.txt","46883",2019-09-26,"12:23",8,79,60,9,10,19,57,7,2,66,66,11,2,79,387,44,76,507,256.966666666667,207.4,2579.59322033898,1829.61403508772,65,75,140,96.7213114754098
"./Ship3_Latin-square/2019-09-26_12h23m_Subject 46894.txt","46894",2019-09-26,"12:23",4,80,60,9,11,20,37,4,8,49,25,2,1,28,377,69,65,511,673.3,150.05,2789.72881355932,2309.32075471698,47,47,94,95.0819672131148
"./Ship3_Latin-square/2019-09-26_12h23m_Subject 46896.txt","46896",2019-09-26,"12:23",16,79,60,9,10,19,22,9,5,36,29,8,10,47,549,39,128,716,212.866666666667,125.083333333333,2159.28813559322,1701.26785714286,55,72,127,95.0819672131148
"./Ship3_Latin-square/2019-09-26_12h23m_Subject 47088.txt","47088",2019-09-26,"12:23",2,82,60,6,16,22,29,12,7,48,35,7,13,55,881,99,297,1277,192.333333333333,156.583333333333,2871.1186440678,1548.87719298246,32,138,170,96.7213114754098
"./Ship3_Latin-square/2019-09-26_12h23m_Subject 47228.txt","47228",2019-09-26,"12:23",4,80,60,8,12,20,24,2,5,31,22,4,3,29,461,60,127,648,327.716666666667,104.816666666667,2789.76271186441,1883.47272727273,39,97,136,96.7213114754098
"./Ship3_Latin-square/2019-09-26_12h23m_Subject 47243.txt","47243",2019-09-26,"12:23",4,76,60,8,8,16,29,3,1,33,44,1,13,58,927,131,129,1187,102.05,165.733333333333,2796.50847457627,1369.18644067797,136,69,205,98.3606557377049
"./Ship3_Latin-square/2019-09-26_12h23m_Subject 47249.txt","47249",2019-09-26,"12:23",2,79,60,8,11,19,34,3,8,45,92,22,34,148,451,57,85,593,224.533333333333,251.766666666667,2891.45762711864,1407.15789473684,46,90,136,98.3606557377049
"./Ship3_Latin-square/2019-09-26_12h23m_Subject 47639.txt","47639",2019-09-26,"12:23",4,79,60,7,12,19,14,2,1,17,15,10,1,26,933,112,210,1255,73.15,145.633333333333,2776.22033898305,1626.66101694915,75,51,126,100
"./Ship3_Latin-square/2019-09-26_12h23m_Subject 47649.txt","47649",2019-09-26,"12:23",4,79,60,9,10,19,36,9,8,53,9,1,2,12,375,78,90,543,814.15,123.133333333333,2789.77966101695,2233.12121212121,68,180,248,70.4918032786885
"./Ship3_Latin-square/2019-09-26_12h23m_Subject 47753.txt","47753",2019-09-26,"12:23",4,80,60,10,10,20,54,3,2,59,18,7,39,64,657,105,131,893,562.666666666667,141.083333333333,2796.5593220339,1742.74137931034,134,77,211,98.3606557377049
"./Ship3_Latin-square/2019-09-26_12h23m_Subject 47758.txt","47758",2019-09-26,"12:23",2,78,60,5,13,18,12,0,1,13,22,9,9,40,1169,88,247,1504,63.7333333333333,125.25,2874.52542372881,1279.71186440678,56,60,116,100
"./Ship3_Latin-square/2019-09-26_12h23m_Subject 47759.txt","47759",2019-09-26,"12:23",2,80,60,10,10,20,11,2,1,14,22,2,19,43,748,95,138,981,104.366666666667,137.1,2894.81355932203,1613.81355932203,51,59,110,100
"./Ship3_Latin-square/2019-09-26_12h23m_Subject 47776.txt","47776",2019-09-26,"12:23",4,80,60,10,10,20,10,1,4,15,45,14,15,74,1105,175,202,1482,99.8166666666667,152.066666666667,2796.52542372881,1278.31034482759,41,89,130,98.3606557377049
"./Ship3_Latin-square/2019-09-26_12h23m_Subject 47799.txt","47799",2019-09-26,"12:23",2,80,60,6,14,20,35,4,3,42,61,10,33,104,444,54,127,625,304.816666666667,193.083333333333,2881.28813559322,1698.91379310345,63,32,95,100
"./Ship3_Latin-square/2019-09-26_13h24m_Subject 46888.txt","46888",2019-09-26,"13:24",8,81,60,9,12,21,22,0,4,26,34,7,8,49,626,99,165,890,211.016666666667,147.25,2566.05084745763,1548.67796610169,44,84,128,100
"./Ship3_Latin-square/2019-09-26_13h24m_Subject 46889.txt","46889",2019-09-26,"13:24",4,76,60,5,11,16,13,0,1,14,23,4,5,32,931,79,200,1210,103.6,138.95,2762.64406779661,1548.20833333333,70,221,291,90.1639344262295
"./Ship3_Latin-square/2019-09-26_13h24m_Subject 46890.txt","46890",2019-09-26,"13:24",24,71,54,11,6,17,56,12,12,80,9,19,2,30,159,2,29,190,1096.7358490566,145.716981132075,2003.77358490566,2684.875,64,58,122,81.4814814814815
"./Ship3_Latin-square/2019-09-26_13h24m_Subject 46892.txt","46892",2019-09-26,"13:24",4,77,60,8,9,17,17,3,0,20,5,6,2,13,932,127,131,1190,103.666666666667,92.7166666666667,2796.54237288136,1383.59322033898,59,76,135,100
"./Ship3_Latin-square/2019-09-26_13h24m_Subject 46898.txt","46898",2019-09-26,"13:24",0,83,60,9,14,23,21,4,5,30,15,2,3,20,637,79,93,809,211.683333333333,112.483333333333,2999.91525423729,1848.05263157895,30,92,122,98.3606557377049
"./Ship3_Latin-square/2019-09-26_13h24m_Subject 47097.txt","47097",2019-09-26,"13:24",24,83,60,16,7,23,94,7,11,112,73,38,15,126,327,16,39,382,632.733333333333,237.683333333333,2145.66101694915,1385.24137931034,80,46,126,98.3606557377049
"./Ship3_Latin-square/2019-09-26_13h24m_Subject 47099.txt","47099",2019-09-26,"13:24",4,75,60,8,7,15,7,0,1,8,85,14,8,107,1148,179,166,1493,77.3,214.966666666667,2803.38983050847,1227.98275862069,17,72,89,98.3606557377049
"./Ship3_Latin-square/2019-09-26_13h24m_Subject 47798.txt","47798",2019-09-26,"13:24",2,81,60,7,14,21,19,1,3,23,9,1,2,12,245,20,54,319,484.316666666667,107.05,2877.93220338983,2102.84375,61,120,181,70.4918032786885
"./Ship3_Latin-square/2019-09-26_13h30m_Subject 46876.txt","46876",2019-09-26,"13:30",24,51,38,11,2,13,49,10,3,62,13,18,1,32,151,0,9,160,885.405405405405,132.837837837838,2221.59459459459,3331.09677419355,54,33,87,84.2105263157895
"./Ship3_Latin-square/2019-09-26_13h30m_Subject 46877.txt","46877",2019-09-26,"13:30",2,79,60,10,9,19,6,1,3,10,35,27,48,110,1332,252,217,1801,52.1166666666667,161.7,2894.81355932203,1165.10344827586,66,98,164,98.3606557377049
"./Ship3_Latin-square/2019-09-26_13h30m_Subject 46893.txt","46893",2019-09-26,"13:30",4,82,60,8,14,22,3,2,2,7,81,12,20,113,1313,177,335,1825,54.2833333333333,163.333333333333,2755.84745762712,1447.32203389831,100,110,210,98.3606557377049
"./Ship3_Latin-square/2019-09-26_13h30m_Subject 46895.txt","46895",2019-09-26,"13:30",4,82,59,12,11,23,54,5,7,66,23,9,8,40,230,42,57,329,1239.66101694915,158.084745762712,2813.75862068966,2216.48979591837,37,76,113,90
"./Ship3_Latin-square/2019-09-26_13h30m_Subject 47638.txt","47638",2019-09-26,"13:30",4,83,60,12,11,23,76,6,10,92,17,8,3,28,256,49,49,354,805.5,179.85,2803.33898305085,2468.60377358491,85,28,113,93.4426229508197
"./Ship3_Latin-square/2019-09-26_13h30m_Subject 47757.txt","47757",2019-09-26,"13:30",2,75,56,10,9,19,69,16,9,94,19,3,1,23,237,51,46,334,1488.67857142857,235.928571428571,2903.55357142857,2261.02083333333,58,95,153,89.4736842105263
"./Ship3_Latin-square/2019-09-26_13h30m_Subject 47769.txt","47769",2019-09-26,"13:30",4,84,60,12,12,24,32,4,4,40,50,11,10,71,476,80,89,645,263.983333333333,194.966666666667,2803.35593220339,1942,58,68,126,98.3606557377049
"./Ship3_Latin-square/2019-09-26_13h30m_Subject 47771.txt","47771",2019-09-26,"13:30",0,79,60,9,10,19,14,1,0,15,4,2,0,6,1002,166,179,1347,112,95.3833333333333,2999.89830508475,1347.94915254237,43,55,98,100
"./Ship3_Latin-square/2019-09-26_13h30m_Subject 47775.txt","47775",2019-09-26,"13:30",0,82,60,8,14,22,54,2,9,65,5,6,0,11,510,58,124,692,214.816666666667,94.9333333333333,2999.89830508475,1715.22033898305,33,82,115,100
"./Ship3_Latin-square/2019-09-26_13h30m_Subject 47781.txt","47781",2019-09-26,"13:30",8,82,60,10,12,22,13,0,2,15,21,5,10,36,1025,181,216,1422,87.55,203.633333333333,2579.57627118644,1310.69491525424,33,126,159,100
"./Ship3_Latin-square/2019-09-26_13h30m_Subject 47782.txt","47782",2019-09-26,"13:30",2,79,60,7,12,19,17,0,2,19,11,2,1,14,663,88,114,865,162.716666666667,102.55,2888.06779661017,1601.96428571429,36,47,83,95.0819672131148
"./Ship3_Latin-square/2019-09-26_13h30m_Subject 47783.txt","47783",2019-09-26,"13:30",8,79,60,9,10,19,71,6,8,85,35,13,9,57,434,101,98,633,791.7,157.833333333333,2579.59322033898,1883.5,91,49,140,100
"./Ship3_Latin-square/2019-09-26_13h30m_Subject 47785.txt","47785",2019-09-26,"13:30",8,81,60,9,12,21,14,3,0,17,48,9,20,77,1045,151,215,1411,155.933333333333,159.85,2579.64406779661,1528.16363636364,30,246,276,93.4426229508197
"./Ship3_Latin-square/2019-09-26_13h30m_Subject 47786.txt","47786",2019-09-26,"13:30",0,79,60,8,11,19,60,9,11,80,26,2,7,35,315,46,41,402,863.716666666667,167.15,2999.91525423729,2556.49056603774,82,42,124,90.1639344262295
"./Ship3_Latin-square/2019-09-26_13h30m_Subject 47788.txt","47788",2019-09-26,"13:30",2,77,60,5,12,17,29,0,12,41,47,6,9,62,745,61,140,946,158.416666666667,138.916666666667,2877.94915254237,1629.57627118644,43,64,107,100
"./Ship3_Latin-square/2019-09-26_14h27m_Subject 47080.txt","47080",2019-09-26,"14:27",8,79,60,9,10,19,18,3,1,22,39,10,13,62,804,97,126,1027,265.95,128.733333333333,2593.1186440678,1550.43396226415,50,132,182,90.1639344262295
"./Ship3_Latin-square/2019-09-26_14h27m_Subject 47089.txt","47089",2019-09-26,"14:27",24,50,34,15,1,16,58,6,1,65,45,90,0,135,143,1,0,144,2117.70588235294,1826.05882352941,2788.11764705882,2712.67741935484,89,5,94,94.2857142857143
"./Ship3_Latin-square/2019-09-26_14h27m_Subject 47762.txt","47762",2019-09-26,"14:27",2,79,60,6,13,19,35,5,2,42,17,3,6,26,305,32,74,411,393.733333333333,117.9,2881.33898305085,2118.37209302326,71,105,176,83.6065573770492
"./Ship3_Latin-square/2019-09-26_14h27m_Subject 47791.txt","47791",2019-09-26,"14:27",4,83,60,8,15,23,6,0,0,6,23,4,10,37,770,102,163,1035,74.4666666666667,156.183333333333,2755.8813559322,1359.64406779661,33,44,77,100
"./Ship3_Latin-square/2019-09-27_09h49m_Subject 46884.txt","46884",2019-09-27,"09:49",16,48,37,8,3,11,39,3,2,44,34,6,3,43,165,19,11,195,3626.81081081081,728.833333333333,2377.75,6025.22857142857,45,36,81,97.2972972972973
"./Ship3_Latin-square/2019-09-27_09h49m_Subject 47083.txt","47083",2019-09-27,"09:49",4,80,60,5,15,20,67,0,10,77,43,4,16,63,258,29,99,386,1007.51666666667,233.383333333333,2742.32203389831,2508.61363636364,71,138,209,77.0491803278689
"./Ship3_Latin-square/2019-09-27_09h49m_Subject 47086.txt","47086",2019-09-27,"09:49",24,79,57,13,9,22,86,15,28,129,43,11,19,73,166,12,31,209,882.428571428571,433.910714285714,1928.53571428571,2418.02173913043,73,79,152,85.9649122807018
"./Ship3_Latin-square/2019-09-27_09h49m_Subject 47246.txt","47246",2019-09-27,"09:49",16,79,60,7,12,19,29,3,5,37,14,3,5,22,305,31,92,428,204.183333333333,153.7,2105.05084745763,1554.48275862069,27,61,88,98.3606557377049
"./Ship3_Latin-square/2019-09-27_09h49m_Subject 47635.txt","47635",2019-09-27,"09:49",2,81,60,4,17,21,29,1,7,37,42,2,15,59,477,42,142,661,750.266666666667,162.3,2861.01694915254,2538.03636363636,56,65,121,93.4426229508197
"./Ship3_Latin-square/2019-09-27_09h49m_Subject 47779.txt","47779",2019-09-27,"09:49",2,76,56,9,11,20,48,3,10,61,64,20,21,105,184,22,59,265,908.910714285714,195.535714285714,2889.25,3183.4693877551,58,52,110,89.4736842105263
"./Ship3_Latin-square/2019-09-27_09h49m_Subject 47790.txt","47790",2019-09-27,"09:49",4,78,60,10,8,18,35,3,4,42,14,5,5,24,715,91,83,889,386.233333333333,163.383333333333,2803.27118644068,1577.94827586207,34,51,85,98.3606557377049
"./Ship3_Latin-square/2019-09-27_09h49m_Subject 47797.txt","47797",2019-09-27,"09:49",0,77,58,3,16,19,49,0,7,56,9,0,12,21,326,13,61,400,1562.28070175439,124.157894736842,2999.94736842105,2255.6170212766,40,130,170,84.4827586206897
"./Ship3_Latin-square/2019-09-27_09h52m_Subject 46878.txt","46878",2019-09-27,"09:52",8,79,60,10,9,19,51,4,6,61,60,12,34,106,722,119,94,935,210.916666666667,326.616666666667,2593.16949152542,1463.22413793103,67,118,185,96.7213114754098
"./Ship3_Latin-square/2019-09-27_09h52m_Subject 46885.txt","46885",2019-09-27,"09:52",16,46,36,7,3,10,123,14,14,151,34,7,2,43,114,13,6,133,1960.02857142857,330.2,2451.28571428571,2235.65714285714,44,31,75,100
"./Ship3_Latin-square/2019-09-27_09h52m_Subject 46899.txt","46899",2019-09-27,"09:52",4,79,60,6,13,19,25,5,2,32,14,5,6,25,730,34,266,1030,154.483333333333,110.383333333333,2762.71186440678,1163.40677966102,23,36,59,100
"./Ship3_Latin-square/2019-09-27_09h52m_Subject 47081.txt","47081",2019-09-27,"09:52",0,75,60,4,11,15,20,0,0,20,32,0,6,38,562,45,118,725,169.45,157.466666666667,2999.91525423729,1841.56896551724,26,85,111,98.3606557377049
"./Ship3_Latin-square/2019-09-27_09h52m_Subject 47091.txt","47091",2019-09-27,"09:52",4,75,60,5,10,15,29,9,1,39,52,6,7,65,285,30,57,372,342.15,167.466666666667,2769.4406779661,1875.53448275862,40,67,107,98.3606557377049
"./Ship3_Latin-square/2019-09-27_09h52m_Subject 47095.txt","47095",2019-09-27,"09:52",4,78,58,6,14,20,50,1,9,60,29,4,19,52,283,43,74,400,1175,207.210526315789,2754.35087719298,2674.32692307692,49,90,139,91.3793103448276
"./Ship3_Latin-square/2019-09-27_09h52m_Subject 47231.txt","47231",2019-09-27,"09:52",4,78,60,6,12,18,62,4,14,80,5,8,3,16,154,15,55,224,790.95,112.433333333333,2762.69491525424,2193.9,28,55,83,86.8852459016393
"./Ship3_Latin-square/2019-09-27_09h52m_Subject 47238.txt","47238",2019-09-27,"09:52",8,81,60,12,9,21,26,3,3,32,50,21,11,82,427,103,87,617,204.2,189.383333333333,2661.01694915254,1363.5,36,43,79,98.3606557377049
"./Ship3_Latin-square/2019-09-27_09h52m_Subject 47242.txt","47242",2019-09-27,"09:52",8,78,60,7,11,18,25,0,33,58,52,6,9,67,640,79,129,848,128.933333333333,168.383333333333,2552.47457627119,1206.96610169492,45,57,102,100
"./Ship3_Latin-square/2019-09-27_09h52m_Subject 47244.txt","47244",2019-09-27,"09:52",16,79,60,9,10,19,34,3,6,43,78,18,12,108,476,49,75,600,349.283333333333,349.35,2213.4406779661,1213.03448275862,54,88,142,98.3606557377049
"./Ship3_Latin-square/2019-09-27_09h52m_Subject 47633.txt","47633",2019-09-27,"09:52",8,78,60,7,11,18,24,1,0,25,57,8,8,73,361,33,95,489,569.533333333333,194.483333333333,2538.93220338983,1590.96551724138,71,69,140,98.3606557377049
"./Ship3_Latin-square/2019-09-27_09h52m_Subject 47636.txt","47636",2019-09-27,"09:52",2,68,51,7,10,17,56,4,11,71,124,39,6,169,255,38,39,332,1850.25490196078,280.078431372549,2890.11764705882,3380.16326530612,91,93,184,98.0769230769231
"./Ship3_Latin-square/2019-09-27_09h52m_Subject 47752.txt","47752",2019-09-27,"09:52",4,83,60,12,11,23,48,9,5,62,22,14,6,42,459,61,154,674,627.9,107.133333333333,2810.1186440678,1755.26785714286,36,87,123,96.7213114754098
"./Ship3_Latin-square/2019-09-27_09h52m_Subject 47767.txt","47767",2019-09-27,"09:52",8,81,60,10,11,21,31,1,6,38,55,11,13,79,394,62,76,532,388.966666666667,306.366666666667,2593.10169491525,1296.03389830508,39,42,81,100
"./Ship3_Latin-square/2019-09-27_09h52m_Subject 47768.txt","47768",2019-09-27,"09:52",2,82,60,11,11,22,60,12,7,79,21,6,7,34,495,108,90,693,529.666666666667,140.216666666667,2894.91525423729,2081.57894736842,47,88,135,96.7213114754098
"./Ship3_Latin-square/2019-09-27_09h52m_Subject 47780.txt","47780",2019-09-27,"09:52",16,78,60,8,10,18,70,4,10,84,49,15,11,75,291,25,66,382,692.116666666667,208.383333333333,2132.13559322034,1708.23636363636,63,60,123,95.0819672131148
"./Ship3_Latin-square/2019-09-27_11h00m_Subject 47229.txt","47229",2019-09-27,"11:00",8,81,60,10,11,21,21,1,2,24,44,8,11,63,914,149,179,1242,108.533333333333,194.133333333333,2606.74576271186,1257.53448275862,57,85,142,98.3606557377049
"./Ship3_Latin-square/2019-09-27_11h00m_Subject 47233.txt","47233",2019-09-27,"11:00",16,84,60,10,14,24,33,1,11,45,33,12,12,57,371,33,121,525,181.716666666667,144.65,2105.03389830508,1361.83333333333,66,74,140,95.0819672131148
"./Ship3_Latin-square/2019-09-27_11h00m_Subject 47234.txt","47234",2019-09-27,"11:00",24,83,60,14,9,23,48,2,14,64,57,13,8,78,215,27,49,291,366.816666666667,266.5,1942.35593220339,1788.76470588235,83,60,143,95.0819672131148
"./Ship3_Latin-square/2019-09-27_11h00m_Subject 47237.txt","47237",2019-09-27,"11:00",16,76,60,9,7,16,24,1,5,30,78,24,28,130,491,34,38,563,203.066666666667,292.666666666667,2240.61016949153,1092.36206896552,38,49,87,98.3606557377049
"./Ship3_Latin-square/2019-09-27_11h00m_Subject 47241.txt","47241",2019-09-27,"11:00",0,78,60,5,13,18,11,1,2,14,9,2,2,13,1128,115,199,1442,97,101.666666666667,2999.86440677966,1526.13559322034,39,128,167,100
"./Ship3_Latin-square/2019-09-27_11h00m_Subject 47247.txt","47247",2019-09-27,"11:00",4,75,60,7,8,15,12,2,2,16,17,4,2,23,389,54,38,481,160.283333333333,165.616666666667,2796.5593220339,2328.13461538462,94,113,207,90.1639344262295
"./Ship3_Latin-square/2019-09-27_11h00m_Subject 47777.txt","47777",2019-09-27,"11:00",24,73,52,12,9,21,93,21,13,127,34,4,6,44,93,10,26,129,1354.74509803922,233.098039215686,1964.62745098039,3374.92682926829,47,64,111,84.6153846153846
"./Ship3_Latin-square/2019-09-27_11h00m_Subject 47784.txt","47784",2019-09-27,"11:00",4,80,60,8,12,20,31,7,2,40,103,25,28,156,1658,219,340,2217,159.85,276.166666666667,2769.45762711864,1048.84745762712,120,135,255,100
"./Ship3_Latin-square/2019-09-27_11h03m_Subject 46900.txt","46900",2019-09-27,"11:03",24,83,60,14,9,23,36,11,5,52,43,14,14,71,309,6,73,388,318.7,194.583333333333,1983.01694915254,1058.16666666667,41,60,101,91.8032786885246
"./Ship3_Latin-square/2019-09-27_11h03m_Subject 46986.txt","46986",2019-09-27,"11:03",24,56,41,12,3,15,43,7,3,53,16,9,0,25,117,10,6,133,2995.39024390244,278.951219512195,2297.51219512195,4392.52173913043,97,32,129,69.0476190476191
"./Ship3_Latin-square/2019-09-27_11h03m_Subject 47076.txt","47076",2019-09-27,"11:03",8,81,60,10,11,21,17,1,4,22,25,29,18,72,599,80,153,832,182.516666666667,126.316666666667,2606.72881355932,1641.89090909091,56,132,188,93.4426229508197
"./Ship3_Latin-square/2019-09-27_11h03m_Subject 47079.txt","47079",2019-09-27,"11:03",16,80,60,11,9,20,39,3,4,46,54,14,6,74,224,38,38,300,585.233333333333,246.4,2267.69491525424,2055.17647058824,94,53,147,86.8852459016393
"./Ship3_Latin-square/2019-09-27_11h03m_Subject 47082.txt","47082",2019-09-27,"11:03",8,74,58,8,8,16,71,11,4,86,33,44,3,80,396,47,35,478,1020.36842105263,152.59649122807,2592.98245614035,2364.83018867925,46,85,131,94.8275862068966
"./Ship3_Latin-square/2019-09-27_11h03m_Subject 47092.txt","47092",2019-09-27,"11:03",16,80,60,10,10,20,18,3,1,22,32,5,5,42,648,64,147,859,86.0333333333333,168.65,2213.5593220339,1192.83050847458,62,38,100,100
"./Ship3_Latin-square/2019-09-27_11h03m_Subject 47098.txt","47098",2019-09-27,"11:03",8,49,35,12,2,14,30,9,0,39,112,70,0,182,123,39,6,168,1169.51428571429,1841.22857142857,2817.02857142857,3529.82608695652,70,35,105,75
"./Ship3_Latin-square/2019-09-27_11h03m_Subject 47226.txt","47226",2019-09-27,"11:03",8,77,60,9,8,17,12,2,4,18,112,27,19,158,2271,329,180,2780,150.983333333333,137.866666666667,2593.18644067797,1127.49152542373,21,28,49,100
"./Ship3_Latin-square/2019-09-27_11h03m_Subject 47227.txt","47227",2019-09-27,"11:03",8,79,60,10,9,19,57,21,4,82,23,10,14,47,355,61,41,457,816.7,131.466666666667,2593.20338983051,1856.23076923077,16,151,167,88.5245901639344
"./Ship3_Latin-square/2019-09-27_11h03m_Subject 47250.txt","47250",2019-09-27,"11:03",0,79,60,5,14,19,29,1,5,35,24,5,12,41,978,68,232,1278,154.433333333333,103.016666666667,2999.91525423729,1362.33898305085,28,38,66,100
"./Ship3_Latin-square/2019-09-27_11h03m_Subject 47645.txt","47645",2019-09-27,"11:03",24,48,36,9,3,12,102,23,8,133,24,4,2,30,102,12,3,117,3529.05555555556,228.611111111111,2199.94444444444,3803.30303030303,74,33,107,94.5945945945946
"./Ship3_Latin-square/2019-09-27_11h03m_Subject 47646.txt","47646",2019-09-27,"11:03",8,79,60,8,11,19,21,3,4,28,162,43,37,242,1616,105,437,2158,194.8,228.95,2566.08474576271,1453.77586206897,26,66,92,98.3606557377049
"./Ship3_Latin-square/2019-09-27_11h03m_Subject 47755.txt","47755",2019-09-27,"11:03",4,81,60,10,11,21,42,4,2,48,24,13,12,49,614,116,127,857,353.15,233.133333333333,2796.57627118644,1972.26785714286,83,184,267,98.3606557377049
"./Ship3_Latin-square/2019-09-27_11h03m_Subject 47760.txt","47760",2019-09-27,"11:03",16,75,60,9,6,15,40,2,5,47,27,13,3,43,576,44,49,669,161.35,149.516666666667,2294.84745762712,1073.1186440678,18,24,42,100
"./Ship3_Latin-square/2019-09-27_11h03m_Subject 47770.txt","47770",2019-09-27,"11:03",8,52,40,6,6,12,69,20,6,95,47,7,9,63,198,16,24,238,2972.5641025641,374.282051282051,2589.74358974359,3785.37142857143,61,83,144,90
"./Ship3_Latin-square/2019-09-27_11h03m_Subject 47795.txt","47795",2019-09-27,"11:03",8,81,60,10,11,21,51,6,6,63,38,14,30,82,333,53,80,466,576.2,180.566666666667,2593.15254237288,2064.41818181818,73,25,98,95.0819672131148
"./Ship3_Latin-square/2019-09-27_12h06m_Subject 46881.txt","46881",2019-09-27,"12:06",8,75,60,6,9,15,73,5,6,84,28,4,3,35,535,26,70,631,1034.9,126.483333333333,2566.05084745763,1500.27586206897,22,94,116,98.3606557377049
"./Ship3_Latin-square/2019-09-27_12h06m_Subject 47087.txt","47087",2019-09-27,"12:06",8,60,46,5,9,14,29,2,8,39,43,4,6,53,246,31,56,333,1629.42222222222,174.866666666667,2555.53333333333,3208.86363636364,37,36,73,97.8260869565217
"./Ship3_Latin-square/2019-09-27_12h06m_Subject 47626.txt","47626",2019-09-27,"12:06",24,70,51,11,8,19,65,4,15,84,54,8,6,68,149,9,30,188,1092.50980392157,373.64,1991.98,3152.86486486487,77,75,152,84.3137254901961
"./Ship3_Latin-square/2019-09-27_12h06m_Subject 47632.txt","47632",2019-09-27,"12:06",24,84,60,11,13,24,35,8,13,56,42,16,15,73,318,23,134,475,330.333333333333,191.883333333333,1738.93220338983,966.061224489796,26,84,110,83.6065573770492
"./Ship3_Latin-square/2019-09-27_12h06m_Subject 47634.txt","47634",2019-09-27,"12:06",8,84,60,11,13,24,48,11,6,65,14,43,21,78,249,28,65,342,588.233333333333,127.666666666667,2579.57627118644,2440,90,71,161,78.6885245901639
"./Ship3_Latin-square/2019-09-27_12h06m_Subject 47640.txt","47640",2019-09-27,"12:06",8,57,40,12,5,17,46,14,4,64,13,29,2,44,155,48,15,218,1287.35897435897,128.589743589744,2733.28205128205,3316.52941176471,40,29,69,87.5
"./Ship3_Latin-square/2019-09-27_12h06m_Subject 47754.txt","47754",2019-09-27,"12:06",4,60,44,7,9,16,49,5,12,66,87,2,13,102,188,45,53,286,1650.39534883721,332.348837209302,2786,5042.15625,25,91,116,81.8181818181818
"./Ship3_Latin-square/2019-09-27_12h06m_Subject 47800.txt","47800",2019-09-27,"12:06",0,83,60,9,14,23,43,5,8,56,38,10,10,58,406,67,84,557,426.083333333333,149.4,2999.89830508475,1856.13559322034,55,80,135,100
"./Ship3_Latin-square/2019-09-27_12h16m_Subject 46880.txt","46880",2019-09-27,"12:16",8,82,60,11,11,22,11,0,1,12,51,12,3,66,634,71,149,854,150.333333333333,277.8,2579.61016949153,1866.425,76,214,290,78.6885245901639
"./Ship3_Latin-square/2019-09-27_12h16m_Subject 46882.txt","46882",2019-09-27,"12:16",0,79,60,6,13,19,13,2,0,15,63,12,53,128,1267,132,290,1689,100.516666666667,176.083333333333,2999.8813559322,1431.35593220339,25,51,76,100
"./Ship3_Latin-square/2019-09-27_12h16m_Subject 46883.txt","46883",2019-09-27,"12:16",4,77,60,7,10,17,46,2,7,55,203,33,14,250,412,51,54,517,343.15,437.066666666667,2782.94915254237,1429.96610169492,35,49,84,100
"./Ship3_Latin-square/2019-09-27_12h16m_Subject 46894.txt","46894",2019-09-27,"12:16",2,81,60,8,13,21,33,7,13,53,22,4,6,32,466,82,128,676,343.216666666667,139.333333333333,2881.32203389831,1987.71929824561,43,57,100,96.7213114754098
"./Ship3_Latin-square/2019-09-27_12h16m_Subject 46896.txt","46896",2019-09-27,"12:16",4,77,60,7,10,17,26,1,3,30,58,8,2,68,784,63,137,984,201.033333333333,326.866666666667,2789.81355932203,1729.45762711864,39,39,78,100
"./Ship3_Latin-square/2019-09-27_12h16m_Subject 47088.txt","47088",2019-09-27,"12:16",0,77,60,6,11,17,22,0,2,24,30,7,8,45,1025,166,184,1375,121.1,146.633333333333,2999.93220338983,1547.5593220339,40,78,118,100
"./Ship3_Latin-square/2019-09-27_12h16m_Subject 47228.txt","47228",2019-09-27,"12:16",2,79,60,8,11,19,22,1,4,27,10,4,7,21,540,96,77,713,325.1,87.6,2888.08474576271,1725.05357142857,30,64,94,95.0819672131148
"./Ship3_Latin-square/2019-09-27_12h16m_Subject 47243.txt","47243",2019-09-27,"12:16",2,79,60,8,11,19,54,3,4,61,57,23,3,83,872,120,178,1170,156.45,217.916666666667,2888.10169491525,1592.52542372881,124,70,194,100
"./Ship3_Latin-square/2019-09-27_12h16m_Subject 47249.txt","47249",2019-09-27,"12:16",0,80,60,8,12,20,38,9,1,48,66,12,28,106,511,61,97,669,264.416666666667,191.75,2999.94915254237,1657.27586206897,43,102,145,98.3606557377049
"./Ship3_Latin-square/2019-09-27_12h16m_Subject 47639.txt","47639",2019-09-27,"12:16",2,79,60,3,16,19,16,5,0,21,25,0,1,26,787,40,170,997,128.616666666667,185.7,2857.54237288136,1844.49122807018,32,128,160,98.3606557377049
"./Ship3_Latin-square/2019-09-27_12h16m_Subject 47649.txt","47649",2019-09-27,"12:16",16,59,43,12,4,16,39,10,1,50,7,2,0,9,206,22,36,264,762.238095238095,126.857142857143,2504.69047619048,4618.4375,70,38,108,86.046511627907
"./Ship3_Latin-square/2019-09-27_12h16m_Subject 47753.txt","47753",2019-09-27,"12:16",0,77,60,3,14,17,17,0,2,19,14,0,5,19,767,38,177,982,165.166666666667,136.083333333333,2999.91525423729,1785.91071428571,43,139,182,96.7213114754098
"./Ship3_Latin-square/2019-09-27_12h16m_Subject 47758.txt","47758",2019-09-27,"12:16",0,77,60,7,10,17,3,0,2,5,19,8,1,28,1302,148,147,1597,52.2,122.416666666667,2999.86440677966,1459.91525423729,68,79,147,100
"./Ship3_Latin-square/2019-09-27_12h16m_Subject 47759.txt","47759",2019-09-27,"12:16",0,83,60,12,11,23,10,2,3,15,23,17,14,54,774,162,130,1066,100.65,132.916666666667,2999.84745762712,1566.03389830508,40,53,93,100
"./Ship3_Latin-square/2019-09-27_12h16m_Subject 47776.txt","47776",2019-09-27,"12:16",2,81,60,9,12,21,20,6,1,27,54,25,14,93,1027,134,239,1400,147.1,160.166666666667,2888.1186440678,1261.8813559322,38,65,103,100
"./Ship3_Latin-square/2019-09-27_12h16m_Subject 47799.txt","47799",2019-09-27,"12:16",0,81,60,10,11,21,29,4,5,38,51,22,9,82,524,99,122,745,304.15,170.4,2999.94915254237,1576.89830508475,61,26,87,100
"./Ship3_Latin-square/2019-09-27_13h13m_Subject 46888.txt","46888",2019-09-27,"13:13",0,80,60,6,14,20,17,0,2,19,75,11,9,95,918,136,185,1239,210.383333333333,228.45,2999.93220338983,1602.10526315789,37,107,144,96.7213114754098
"./Ship3_Latin-square/2019-09-27_13h13m_Subject 46889.txt","46889",2019-09-27,"13:13",16,76,60,8,8,16,14,2,2,18,22,3,0,25,713,45,100,858,222.733333333333,134.633333333333,2213.4406779661,1445.87755102041,54,174,228,86.8852459016393
"./Ship3_Latin-square/2019-09-27_13h13m_Subject 46890.txt","46890",2019-09-27,"13:13",16,80,60,10,10,20,31,6,6,43,15,28,8,51,155,15,27,197,820.083333333333,151.05,2186.40677966102,2364.27027027027,70,73,143,72.1311475409836
"./Ship3_Latin-square/2019-09-27_13h13m_Subject 46892.txt","46892",2019-09-27,"13:13",2,80,60,8,12,20,14,0,2,16,27,0,6,33,982,124,184,1290,107.783333333333,134.7,2891.45762711864,1335.40677966102,46,58,104,100
"./Ship3_Latin-square/2019-09-27_13h13m_Subject 46898.txt","46898",2019-09-27,"13:13",16,79,60,12,7,19,34,3,6,43,14,8,11,33,275,52,25,352,538.4,202.95,2349.10169491525,1990.05769230769,51,71,122,91.8032786885246
"./Ship3_Latin-square/2019-09-27_13h13m_Subject 47097.txt","47097",2019-09-27,"13:13",8,78,60,8,10,18,72,7,15,94,72,8,17,97,453,72,100,625,594.5,287.766666666667,2566.05084745763,1305.8813559322,54,82,136,100
"./Ship3_Latin-square/2019-09-27_13h13m_Subject 47099.txt","47099",2019-09-27,"13:13",2,76,60,5,11,16,9,0,2,11,42,9,19,70,1334,93,232,1659,60.1,170.433333333333,2881.33898305085,1328.45762711864,53,64,117,98.3606557377049
"./Ship3_Latin-square/2019-09-27_13h13m_Subject 47798.txt","47798",2019-09-27,"13:13",8,78,60,9,9,18,32,0,4,36,7,4,4,15,202,23,22,247,624.3,126.266666666667,2593.16949152542,2321.13043478261,40,81,121,91.8032786885246
"./Ship3_Latin-square/2019-09-27_13h22m_Subject 46876.txt","46876",2019-09-27,"13:22",8,77,56,8,13,21,49,16,9,74,67,23,12,102,250,32,92,374,1264.78571428571,334.428571428571,2563.54545454545,1954.96226415094,37,54,91,96.4285714285714
"./Ship3_Latin-square/2019-09-27_13h22m_Subject 46877.txt","46877",2019-09-27,"13:22",8,78,60,9,9,18,4,0,1,5,59,12,33,104,1203,179,214,1596,61.25,217.7,2593.18644067797,1045.10169491525,42,70,112,100
"./Ship3_Latin-square/2019-09-27_13h22m_Subject 46893.txt","46893",2019-09-27,"13:22",2,79,60,8,11,19,8,0,0,8,78,13,15,106,1404,215,242,1861,61.7833333333333,146.916666666667,2884.67796610169,1452.91525423729,125,69,194,100
"./Ship3_Latin-square/2019-09-27_13h22m_Subject 46895.txt","46895",2019-09-27,"13:22",16,34,23,8,3,11,63,10,6,79,60,25,1,86,67,18,5,90,7911.26086956522,1424.47826086957,2512.95652173913,2735.35,22,32,54,91.6666666666667
"./Ship3_Latin-square/2019-09-27_13h22m_Subject 47638.txt","47638",2019-09-27,"13:22",2,80,60,10,10,20,50,10,12,72,19,2,17,38,336,55,67,458,465.45,163.083333333333,2908.40677966102,1811.28070175439,49,46,95,100
"./Ship3_Latin-square/2019-09-27_13h22m_Subject 47757.txt","47757",2019-09-27,"13:22",0,81,60,7,14,21,57,5,13,75,18,2,9,29,287,38,89,414,972.3,165.133333333333,2999.8813559322,2358.41304347826,51,141,192,85.2459016393443
"./Ship3_Latin-square/2019-09-27_13h22m_Subject 47769.txt","47769",2019-09-27,"13:22",2,81,60,11,10,21,26,3,11,40,36,10,14,60,460,118,112,690,220.916666666667,161.733333333333,2911.76271186441,2349.53448275862,131,57,188,98.3606557377049
"./Ship3_Latin-square/2019-09-27_13h22m_Subject 47771.txt","47771",2019-09-27,"13:22",4,78,60,7,11,18,12,0,1,13,6,4,1,11,947,75,175,1197,78.0833333333333,96.3,2769.42372881356,1281.50847457627,22,71,93,100
"./Ship3_Latin-square/2019-09-27_13h22m_Subject 47775.txt","47775",2019-09-27,"13:22",4,82,60,10,12,22,42,9,11,62,13,5,8,26,457,68,85,610,278.233333333333,104.966666666667,2789.79661016949,1367.94915254237,46,41,87,100
"./Ship3_Latin-square/2019-09-27_13h22m_Subject 47781.txt","47781",2019-09-27,"13:22",0,81,60,8,13,21,14,1,2,17,19,5,3,27,1142,197,186,1525,81.7666666666667,135.3,2999.89830508475,1606.31034482759,28,69,97,98.3606557377049
"./Ship3_Latin-square/2019-09-27_13h22m_Subject 47782.txt","47782",2019-09-27,"13:22",0,80,60,1,19,20,10,2,1,13,18,0,30,48,800,14,151,965,190.666666666667,103.316666666667,2999.79661016949,1375.77586206897,31,40,71,96.7213114754098
"./Ship3_Latin-square/2019-09-27_13h22m_Subject 47783.txt","47783",2019-09-27,"13:22",0,80,60,6,14,20,33,1,5,39,43,7,11,61,942,81,176,1199,419.133333333333,160.883333333333,2999.94915254237,1702.06779661017,47,101,148,100
"./Ship3_Latin-square/2019-09-27_13h22m_Subject 47785.txt","47785",2019-09-27,"13:22",0,76,60,7,9,16,11,0,5,16,54,13,9,76,1521,168,197,1886,173.716666666667,135.383333333333,2999.86440677966,1756.75862068966,57,180,237,96.7213114754098
"./Ship3_Latin-square/2019-09-27_13h22m_Subject 47786.txt","47786",2019-09-27,"13:22",16,77,60,9,8,17,63,4,13,80,32,5,65,102,170,21,19,210,1297.18333333333,159.6,2240.62711864407,2575.81132075472,68,65,133,91.8032786885246
"./Ship3_Latin-square/2019-09-27_13h22m_Subject 47788.txt","47788",2019-09-27,"13:22",0,78,60,7,11,18,34,2,3,39,46,7,11,64,685,68,122,875,344.4,122.1,2999.8813559322,2021.79661016949,46,95,141,100
"./Ship3_Latin-square/2019-09-27_14h16m_Subject 47080.txt","47080",2019-09-27,"14:16",0,80,60,7,13,20,8,0,0,8,43,13,6,62,954,130,188,1272,74.7833333333333,132.533333333333,2999.91525423729,1408.38596491228,43,64,107,98.3606557377049
"./Ship3_Latin-square/2019-09-27_14h16m_Subject 47089.txt","47089",2019-09-27,"14:16",8,82,59,13,10,23,20,3,3,26,95,23,11,129,251,42,50,343,1215.1186440678,318.101694915254,2655.12068965517,2309.48076923077,80,44,124,93.3333333333333
"./Ship3_Latin-square/2019-09-27_14h16m_Subject 47762.txt","47762",2019-09-27,"14:16",8,81,60,11,10,21,59,7,15,81,30,11,7,48,222,53,35,310,1098.15254237288,162.203389830508,2579.61016949153,2065.60714285714,72,58,130,98.3333333333333
"./Ship3_Latin-square/2019-09-27_14h16m_Subject 47791.txt","47791",2019-09-27,"14:16",16,82,60,10,12,22,16,1,1,18,19,13,12,44,451,55,99,605,126.1,143.983333333333,2105.06779661017,1217.82456140351,20,59,79,96.7213114754098
"./Ship3_Latin-square/2019-09-28_09h49m_Subject 46884.txt","46884",2019-09-28,"09:49",24,47,35,8,4,12,87,4,16,107,36,4,5,45,140,1,10,151,3171.31428571429,786.882352941176,2082.23529411765,3613.06451612903,40,50,90,91.4285714285714
"./Ship3_Latin-square/2019-09-28_09h49m_Subject 47083.txt","47083",2019-09-28,"09:49",16,78,60,10,8,18,84,19,13,116,50,14,10,74,298,36,52,386,1056.76666666667,320.1,2240.64406779661,1833.18181818182,99,93,192,93.4426229508197
"./Ship3_Latin-square/2019-09-28_09h49m_Subject 47086.txt","47086",2019-09-28,"09:49",0,81,60,7,14,21,17,0,2,19,16,2,5,23,499,72,105,676,190.416666666667,134.766666666667,2999.94915254237,1616.40350877193,41,76,117,96.7213114754098
"./Ship3_Latin-square/2019-09-28_09h49m_Subject 47246.txt","47246",2019-09-28,"09:49",24,81,60,10,11,21,78,9,8,95,26,5,16,47,175,7,65,247,606.8,185.166666666667,1738.91525423729,1458.42,23,68,91,86.8852459016393
"./Ship3_Latin-square/2019-09-28_09h49m_Subject 47635.txt","47635",2019-09-28,"09:49",8,77,60,6,11,17,27,3,11,41,50,8,10,68,393,39,94,526,300.15,200.783333333333,2566.05084745763,1916.06779661017,69,28,97,100
"./Ship3_Latin-square/2019-09-28_09h49m_Subject 47779.txt","47779",2019-09-28,"09:49",8,62,45,10,7,17,51,5,2,58,42,12,3,57,65,18,33,116,1991.18181818182,231.181818181818,2672.59090909091,4537.60714285714,73,54,127,68.8888888888889
"./Ship3_Latin-square/2019-09-28_09h49m_Subject 47790.txt","47790",2019-09-28,"09:49",0,79,60,9,10,19,24,5,2,31,18,9,4,31,783,121,169,1073,287.333333333333,139.283333333333,2999.91525423729,1585.17307692308,42,107,149,95.0819672131148
"./Ship3_Latin-square/2019-09-28_09h49m_Subject 47797.txt","47797",2019-09-28,"09:49",16,71,50,11,10,21,34,2,11,47,64,17,11,92,261,32,48,341,1188.92,741.12,2231.94,1801.5,30,121,151,82.3529411764706
"./Ship3_Latin-square/2019-09-28_09h51m_Subject 46878.txt","46878",2019-09-28,"09:51",4,82,60,10,12,22,16,10,3,29,11,22,20,53,816,175,168,1159,95.5833333333333,133.2,2783.05084745763,1547.08474576271,83,65,148,100
"./Ship3_Latin-square/2019-09-28_09h51m_Subject 46885.txt","46885",2019-09-28,"09:51",24,42,31,9,2,11,130,19,7,156,40,41,13,94,93,4,12,109,3555.2,660.966666666667,2360,3683.5,44,18,62,100
"./Ship3_Latin-square/2019-09-28_09h51m_Subject 46899.txt","46899",2019-09-28,"09:51",16,71,56,10,5,15,104,5,19,128,55,9,7,71,377,36,36,449,1657.42857142857,188.428571428571,2330.87272727273,975,32,21,53,100
"./Ship3_Latin-square/2019-09-28_09h51m_Subject 47081.txt","47081",2019-09-28,"09:51",16,79,60,10,9,19,21,1,3,25,23,3,6,32,402,54,79,535,192.533333333333,140.15,2240.66101694915,1403.45454545455,40,51,91,96.7213114754098
"./Ship3_Latin-square/2019-09-28_09h51m_Subject 47091.txt","47091",2019-09-28,"09:51",16,78,60,9,9,18,26,0,3,29,50,14,11,75,226,29,39,294,330.2,218.066666666667,2213.54237288136,1723.55555555556,57,68,125,93.4426229508197
"./Ship3_Latin-square/2019-09-28_09h51m_Subject 47095.txt","47095",2019-09-28,"09:51",0,81,60,8,13,21,19,6,17,42,17,9,16,42,540,86,122,748,190.25,153.4,2999.94915254237,1971.52542372881,43,71,114,100
"./Ship3_Latin-square/2019-09-28_09h51m_Subject 47238.txt","47238",2019-09-28,"09:51",0,83,60,12,11,23,20,4,7,31,45,24,12,81,529,102,127,758,393.833333333333,180.7,2999.93220338983,1238.12068965517,26,46,72,98.3606557377049
"./Ship3_Latin-square/2019-09-28_09h51m_Subject 47242.txt","47242",2019-09-28,"09:51",0,76,60,5,11,16,25,2,3,30,36,3,88,127,702,63,141,906,189.166666666667,168.7,2999.83050847458,1276.91525423729,38,33,71,100
"./Ship3_Latin-square/2019-09-28_09h51m_Subject 47244.txt","47244",2019-09-28,"09:51",24,76,60,11,5,16,59,3,1,63,86,17,6,109,411,15,53,479,449.2,300.683333333333,2064.37288135593,1042.61111111111,53,77,130,91.8032786885246
"./Ship3_Latin-square/2019-09-28_09h51m_Subject 47633.txt","47633",2019-09-28,"09:51",4,81,60,8,13,21,25,4,4,33,60,13,6,79,399,60,106,565,461.216666666667,160.016666666667,2769.45762711864,1767.07272727273,71,103,174,95.0819672131148
"./Ship3_Latin-square/2019-09-28_09h51m_Subject 47636.txt","47636",2019-09-28,"09:51",8,80,60,8,12,20,88,12,9,109,66,13,12,91,395,39,73,507,587.433333333333,221.033333333333,2525.42372881356,2319.49056603774,92,180,272,91.8032786885246
"./Ship3_Latin-square/2019-09-28_09h51m_Subject 47752.txt","47752",2019-09-28,"09:51",16,84,59,15,10,25,98,23,11,132,53,18,14,85,299,69,92,460,1044.20338983051,161.28813559322,2321.98305084746,1153.78947368421,52,65,117,96.6666666666667
"./Ship3_Latin-square/2019-09-28_09h51m_Subject 47767.txt","47767",2019-09-28,"09:51",0,78,60,7,11,18,20,1,8,29,38,7,4,49,446,65,102,613,287.266666666667,181.366666666667,2999.93220338983,1182.91525423729,20,42,62,100
"./Ship3_Latin-square/2019-09-28_09h51m_Subject 47768.txt","47768",2019-09-28,"09:51",8,78,60,10,8,18,42,4,4,50,15,5,1,21,562,71,57,690,353.85,135.866666666667,2606.71186440678,1767.58181818182,53,75,128,95.0819672131148
"./Ship3_Latin-square/2019-09-28_09h51m_Subject 47780.txt","47780",2019-09-28,"09:51",2,79,60,7,12,19,37,4,5,46,57,10,14,81,395,55,86,536,329.433333333333,293.8,2884.72881355932,1970.01694915254,64,59,123,100
"./Ship3_Latin-square/2019-09-28_10h58m_Subject 47229.txt","47229",2019-09-28,"10:58",0,83,60,10,13,23,16,2,5,23,32,9,5,46,962,223,228,1413,180.4,153.583333333333,2999.91525423729,1427.89830508475,47,77,124,100
"./Ship3_Latin-square/2019-09-28_10h58m_Subject 47233.txt","47233",2019-09-28,"10:58",24,82,60,10,12,22,57,7,13,77,56,11,18,85,264,4,117,385,400.716666666667,201.566666666667,1779.61016949153,982.604166666667,42,73,115,83.6065573770492
"./Ship3_Latin-square/2019-09-28_10h58m_Subject 47234.txt","47234",2019-09-28,"10:58",0,80,60,8,12,20,25,2,5,32,55,17,9,81,756,106,133,995,165.433333333333,257.783333333333,2999.83050847458,1270.47457627119,34,82,116,100
"./Ship3_Latin-square/2019-09-28_10h58m_Subject 47237.txt","47237",2019-09-28,"10:58",4,78,60,11,7,18,24,4,0,28,8,19,14,41,649,140,87,876,198.55,124.4,2816.91525423729,1201.38983050847,34,45,79,100
"./Ship3_Latin-square/2019-09-28_10h58m_Subject 47241.txt","47241",2019-09-28,"10:58",16,78,60,8,10,18,13,1,3,17,13,6,0,19,725,66,169,960,91.1833333333333,120.3,2159.27118644068,961.542372881356,39,68,107,100
"./Ship3_Latin-square/2019-09-28_10h58m_Subject 47247.txt","47247",2019-09-28,"10:58",16,78,60,8,10,18,43,5,7,55,38,7,4,49,193,24,31,248,592.2,246.7,2159.22033898305,2673.9347826087,31,108,139,83.6065573770492
"./Ship3_Latin-square/2019-09-28_10h58m_Subject 47777.txt","47777",2019-09-28,"10:58",8,83,60,10,13,23,28,5,7,40,36,12,14,62,557,66,173,796,409.2,208.85,2566.05084745763,1514.0701754386,32,81,113,96.7213114754098
"./Ship3_Latin-square/2019-09-28_10h58m_Subject 47784.txt","47784",2019-09-28,"10:58",16,77,60,8,9,17,65,4,3,72,57,18,5,80,917,74,161,1152,243.733333333333,227.65,2213.54237288136,937.474576271186,82,75,157,100
"./Ship3_Latin-square/2019-09-28_11h00m_Subject 46900.txt","46900",2019-09-28,"11:00",8,79,60,9,10,19,8,11,0,19,169,38,37,244,772,97,225,1094,158.9,323.733333333333,2579.59322033898,904.637931034483,18,80,98,98.3606557377049
"./Ship3_Latin-square/2019-09-28_11h00m_Subject 46986.txt","46986",2019-09-28,"11:00",0,81,60,12,9,21,29,5,1,35,16,3,3,22,525,86,91,702,321.85,146.3,2999.89830508475,1680.64406779661,66,69,135,100
"./Ship3_Latin-square/2019-09-28_11h00m_Subject 47076.txt","47076",2019-09-28,"11:00",0,81,60,9,12,21,12,0,2,14,4,2,7,13,1182,195,232,1609,148.466666666667,100.85,2999.94915254237,1474.36206896552,51,112,163,98.3606557377049
"./Ship3_Latin-square/2019-09-28_11h00m_Subject 47079.txt","47079",2019-09-28,"11:00",24,74,59,9,6,15,65,5,7,77,70,12,5,87,182,5,13,200,1441.42372881356,305.966101694915,1924.10344827586,2466.86274509804,65,62,127,91.5254237288136
"./Ship3_Latin-square/2019-09-28_11h00m_Subject 47082.txt","47082",2019-09-28,"11:00",0,82,60,9,13,22,28,4,7,39,30,8,14,52,417,75,103,595,408.483333333333,118.016666666667,2999.8813559322,1839.81818181818,66,68,134,95.0819672131148
"./Ship3_Latin-square/2019-09-28_11h00m_Subject 47092.txt","47092",2019-09-28,"11:00",24,82,60,11,11,22,47,0,22,69,53,11,16,80,485,0,167,652,294.033333333333,220.45,1820.28813559322,1181.19565217391,54,85,139,81.9672131147541
"./Ship3_Latin-square/2019-09-28_11h00m_Subject 47098.txt","47098",2019-09-28,"11:00",16,58,39,10,9,19,40,3,6,49,27,7,39,73,111,20,26,157,2910.71794871795,271.974358974359,2261.4358974359,2896.92857142857,55,55,110,85
"./Ship3_Latin-square/2019-09-28_11h00m_Subject 47226.txt","47226",2019-09-28,"11:00",0,79,60,7,12,19,13,0,2,15,48,18,17,83,2900,379,639,3918,108.216666666667,109.916666666667,2999.93220338983,1445.72413793103,16,141,157,100
"./Ship3_Latin-square/2019-09-28_11h00m_Subject 47227.txt","47227",2019-09-28,"11:00",0,79,60,7,12,19,23,2,7,32,14,11,8,33,578,79,154,811,404.116666666667,99.7,2999.8813559322,2099.91836734694,37,162,199,86.8852459016393
"./Ship3_Latin-square/2019-09-28_11h00m_Subject 47645.txt","47645",2019-09-28,"11:00",0,78,56,8,14,22,81,8,21,110,15,0,6,21,323,31,73,427,1167.42857142857,150.089285714286,2999.94545454545,2405.83333333333,45,93,138,98.2456140350877
"./Ship3_Latin-square/2019-09-28_11h00m_Subject 47646.txt","47646",2019-09-28,"11:00",0,79,60,7,12,19,8,2,2,12,103,8,31,142,2215,302,402,2919,74.75,132.683333333333,2999.91525423729,1511.29310344828,29,78,107,100
"./Ship3_Latin-square/2019-09-28_11h00m_Subject 47755.txt","47755",2019-09-28,"11:00",16,84,60,15,9,24,69,13,4,86,22,24,3,49,407,84,62,553,523.516666666667,187.366666666667,2376.18644067797,1703.33962264151,100,114,214,90.1639344262295
"./Ship3_Latin-square/2019-09-28_11h00m_Subject 47760.txt","47760",2019-09-28,"11:00",24,62,47,11,4,15,94,6,26,126,47,14,6,67,316,13,16,345,1106.91304347826,254,2112.95652173913,1147.5,33,22,55,100
"./Ship3_Latin-square/2019-09-28_11h00m_Subject 47770.txt","47770",2019-09-28,"11:00",4,51,39,8,4,12,64,12,6,82,46,62,8,116,186,36,17,239,3342.65789473684,400.736842105263,2820.97368421053,3076.76666666667,56,101,157,84.6153846153846
"./Ship3_Latin-square/2019-09-28_11h00m_Subject 47795.txt","47795",2019-09-28,"11:00",0,80,60,4,16,20,53,2,5,60,22,17,8,47,399,16,94,509,377.983333333333,144.833333333333,2999.89830508475,2606.60714285714,24,58,82,96.7213114754098
"./Ship3_Latin-square/2019-09-28_12h00m_Subject 46881.txt","46881",2019-09-28,"12:00",0,82,60,8,14,22,28,0,5,33,17,7,3,27,969,174,222,1365,371.833333333333,121.266666666667,2999.8813559322,1562.27272727273,44,165,209,96.7213114754098
"./Ship3_Latin-square/2019-09-28_12h00m_Subject 47087.txt","47087",2019-09-28,"12:00",0,82,60,10,12,22,32,3,2,37,44,10,17,71,522,116,82,720,437.816666666667,139,2999.93220338983,1458.39655172414,54,42,96,98.3606557377049
"./Ship3_Latin-square/2019-09-28_12h00m_Subject 47626.txt","47626",2019-09-28,"12:00",8,79,60,9,10,19,23,2,3,28,49,6,9,64,225,26,56,307,589.8,298.366666666667,2579.5593220339,2641.91836734694,82,92,174,88.5245901639344
"./Ship3_Latin-square/2019-09-28_12h00m_Subject 47632.txt","47632",2019-09-28,"12:00",2,79,60,9,10,19,12,0,1,13,41,23,3,67,1167,210,158,1535,216.166666666667,332.866666666667,2898.27118644068,1151.8813559322,56,85,141,100
"./Ship3_Latin-square/2019-09-28_12h00m_Subject 47634.txt","47634",2019-09-28,"12:00",0,82,60,8,14,22,48,6,6,60,20,6,16,42,395,57,127,579,465.25,143.816666666667,2999.91525423729,1893.125,62,66,128,93.4426229508197
"./Ship3_Latin-square/2019-09-28_12h00m_Subject 47640.txt","47640",2019-09-28,"12:00",0,80,60,9,11,20,36,4,9,49,22,4,6,32,813,125,138,1076,273.683333333333,136.216666666667,2999.94915254237,1527.13793103448,24,53,77,98.3606557377049
"./Ship3_Latin-square/2019-09-28_12h00m_Subject 47754.txt","47754",2019-09-28,"12:00",2,82,60,9,13,22,36,4,4,44,100,23,46,169,479,41,126,646,948.491525423729,276.033898305085,2888.08474576271,2494.03846153846,19,148,167,90
"./Ship3_Latin-square/2019-09-28_12h00m_Subject 47800.txt","47800",2019-09-28,"12:00",4,81,60,10,11,21,13,0,3,16,49,11,12,72,499,93,84,676,279.183333333333,168.616666666667,2783.01694915254,1298.38983050847,35,91,126,100
"./Ship3_Latin-square/2019-09-28_12h10m_Subject 46880.txt","46880",2019-09-28,"12:10",0,81,60,4,17,21,14,3,1,18,15,10,8,33,697,64,250,1011,176.95,117.05,2999.89830508475,2256.37209302326,60,327,387,83.6065573770492
"./Ship3_Latin-square/2019-09-28_12h10m_Subject 46882.txt","46882",2019-09-28,"12:10",4,81,60,10,11,21,16,0,5,21,30,13,12,55,790,139,128,1057,205.883333333333,157.633333333333,2782.98305084746,1525.37735849057,27,83,110,95.0819672131148
"./Ship3_Latin-square/2019-09-28_12h10m_Subject 46883.txt","46883",2019-09-28,"12:10",16,58,44,10,4,14,87,25,11,123,43,12,0,55,181,25,21,227,1513.53488372093,189.744186046512,2404.60465116279,1697.14285714286,42,28,70,97.7272727272727
"./Ship3_Latin-square/2019-09-28_12h10m_Subject 46894.txt","46894",2019-09-28,"12:10",0,79,60,5,14,19,36,1,8,45,11,0,19,30,650,100,123,873,449.916666666667,113.416666666667,2999.93220338983,1743.74576271186,29,38,67,100
"./Ship3_Latin-square/2019-09-28_12h10m_Subject 46896.txt","46896",2019-09-28,"12:10",24,76,58,4,14,18,73,0,14,87,45,5,34,84,228,4,115,347,1153.68965517241,362.655172413793,1442.08771929825,1655.6170212766,15,82,97,84.4827586206897
"./Ship3_Latin-square/2019-09-28_12h10m_Subject 47088.txt","47088",2019-09-28,"12:10",2,85,60,6,19,25,41,2,8,51,60,7,12,79,837,125,188,1150,342.6,216.483333333333,2857.59322033898,1509.23728813559,37,75,112,100
"./Ship3_Latin-square/2019-09-28_12h10m_Subject 47228.txt","47228",2019-09-28,"12:10",0,61,41,0,20,20,33,0,11,44,15,0,92,107,211,0,125,336,778.756097560976,108.756097560976,2999.90243902439,5233.11111111111,0,401,401,35.7142857142857
"./Ship3_Latin-square/2019-09-28_12h10m_Subject 47243.txt","47243",2019-09-28,"12:10",0,81,60,9,12,21,24,1,5,30,34,7,0,41,1042,168,250,1460,106.533333333333,173.35,2999.89830508475,1172.13559322034,81,76,157,100
"./Ship3_Latin-square/2019-09-28_12h10m_Subject 47249.txt","47249",2019-09-28,"12:10",2,79,60,8,11,19,40,7,9,56,91,10,37,138,404,55,76,535,262.15,266.9,2888.10169491525,1513.03389830508,53,79,132,100
"./Ship3_Latin-square/2019-09-28_12h10m_Subject 47649.txt","47649",2019-09-28,"12:10",24,46,35,7,4,11,66,4,14,84,25,4,1,30,92,7,15,114,3239.73529411765,392.705882352941,2011.70588235294,3569.21428571429,43,32,75,82.8571428571429
"./Ship3_Latin-square/2019-09-28_12h10m_Subject 47753.txt","47753",2019-09-28,"12:10",8,84,60,13,11,24,48,1,5,54,24,4,1,29,359,64,80,503,604.533333333333,174.783333333333,2606.74576271186,2183.84090909091,66,123,189,83.6065573770492
"./Ship3_Latin-square/2019-09-28_12h10m_Subject 47758.txt","47758",2019-09-28,"12:10",2,84,60,9,15,24,10,3,1,14,5,8,1,14,983,141,269,1393,113.666666666667,92.1666666666667,2877.89830508475,1645.59322033898,70,102,172,100
"./Ship3_Latin-square/2019-09-28_12h10m_Subject 47759.txt","47759",2019-09-28,"12:10",2,77,60,8,9,17,18,1,2,21,16,13,0,29,789,78,139,1006,155.066666666667,126.833333333333,2898.27118644068,1338.63793103448,36,41,77,98.3606557377049
"./Ship3_Latin-square/2019-09-28_12h10m_Subject 47776.txt","47776",2019-09-28,"12:10",0,84,60,12,12,24,15,2,0,17,49,25,14,88,1197,263,235,1695,80.15,139.55,2999.86440677966,1273.16949152542,39,46,85,100
"./Ship3_Latin-square/2019-09-28_12h10m_Subject 47799.txt","47799",2019-09-28,"12:10",2,79,60,8,11,19,28,2,3,33,48,16,12,76,461,55,87,603,282.116666666667,144.55,2888.06779661017,1723.46428571429,95,35,130,95.0819672131148
"./Ship3_Latin-square/2019-09-28_13h05m_Subject 46888.txt","46888",2019-09-28,"13:05",4,78,60,9,9,18,19,2,2,23,26,24,3,53,794,139,105,1038,118.45,156.7,2782.96610169492,1623.36842105263,46,59,105,96.7213114754098
"./Ship3_Latin-square/2019-09-28_13h05m_Subject 46889.txt","46889",2019-09-28,"13:05",24,81,60,11,10,21,69,8,24,101,50,6,14,70,381,15,85,481,414.866666666667,224.383333333333,1861,1266.2380952381,49,108,157,77.0491803278689
"./Ship3_Latin-square/2019-09-28_13h05m_Subject 46890.txt","46890",2019-09-28,"13:05",8,55,38,6,11,17,23,0,0,23,18,0,97,115,161,41,57,259,1262.97368421053,209.567567567568,2481,2079.2,31,89,120,78.9473684210526
"./Ship3_Latin-square/2019-09-28_13h05m_Subject 46892.txt","46892",2019-09-28,"13:05",0,79,60,7,12,19,27,2,0,29,16,2,9,27,1027,132,180,1339,141.166666666667,116.866666666667,2999.89830508475,1292.79661016949,47,62,109,100
"./Ship3_Latin-square/2019-09-28_13h05m_Subject 46898.txt","46898",2019-09-28,"13:05",2,79,60,8,11,19,31,4,2,37,11,3,2,16,627,67,83,777,157.2,136.683333333333,2891.49152542373,1669.60344827586,37,93,130,100
"./Ship3_Latin-square/2019-09-28_13h05m_Subject 47097.txt","47097",2019-09-28,"13:05",0,76,60,4,12,16,18,0,4,22,62,9,7,78,902,64,218,1184,167.183333333333,169.583333333333,2999.94915254237,1691.5593220339,39,133,172,100
"./Ship3_Latin-square/2019-09-28_13h05m_Subject 47099.txt","47099",2019-09-28,"13:05",0,77,60,6,11,17,7,0,0,7,33,8,31,72,1066,114,140,1320,89.2166666666667,191.816666666667,2999.93220338983,1535.20338983051,55,60,115,96.7213114754098
"./Ship3_Latin-square/2019-09-28_13h05m_Subject 47798.txt","47798",2019-09-28,"13:05",4,82,60,6,16,22,31,3,4,38,15,3,2,20,199,21,64,284,482.95,194.433333333333,2749.10169491525,2053.38888888889,42,115,157,75.4098360655738
"./Ship3_Latin-square/2019-09-28_13h17m_Subject 46876.txt","46876",2019-09-28,"13:17",0,80,60,8,12,20,16,5,2,23,2,2,8,12,843,83,231,1157,400,89.6166666666667,2999.89830508475,1408.54237288136,30,66,96,100
"./Ship3_Latin-square/2019-09-28_13h17m_Subject 46877.txt","46877",2019-09-28,"13:17",4,83,60,10,13,23,20,1,0,21,60,16,29,105,1359,241,296,1896,139.8,221.416666666667,2769.4406779661,1098.43103448276,34,107,141,100
"./Ship3_Latin-square/2019-09-28_13h17m_Subject 46893.txt","46893",2019-09-28,"13:17",0,52,37,15,0,15,117,25,0,142,31,42,0,73,297,193,0,490,3447.94594594595,228.189189189189,2999.86111111111,2879.53333333333,133,9,142,84.2105263157895
"./Ship3_Latin-square/2019-09-28_13h17m_Subject 46895.txt","46895",2019-09-28,"13:17",24,42,30,10,2,12,52,6,4,62,23,47,0,70,76,2,2,80,4098.53333333333,1368.66666666667,2439.86666666667,3809.96153846154,50,20,70,90.3225806451613
"./Ship3_Latin-square/2019-09-28_13h17m_Subject 47638.txt","47638",2019-09-28,"13:17",0,80,57,13,10,23,76,18,16,110,41,9,20,70,242,44,39,325,1021.58928571429,192.178571428571,2999.96428571429,2261.55769230769,64,42,106,94.7368421052632
"./Ship3_Latin-square/2019-09-28_13h17m_Subject 47757.txt","47757",2019-09-28,"13:17",2,68,47,7,14,21,53,8,14,75,19,0,13,32,224,33,70,327,1826.27659574468,208.127659574468,2876.55319148936,3039.85365853659,37,109,146,91.6666666666667
"./Ship3_Latin-square/2019-09-28_13h17m_Subject 47771.txt","47771",2019-09-28,"13:17",2,79,60,9,10,19,18,1,2,21,6,2,0,8,927,135,154,1216,111.7,102.4,2894.89830508475,1388.84745762712,26,76,102,100
"./Ship3_Latin-square/2019-09-28_13h17m_Subject 47775.txt","47775",2019-09-28,"13:17",2,81,60,8,13,21,49,7,26,82,6,3,2,11,443,73,68,584,329.916666666667,92.8333333333333,2884.69491525424,1744.64406779661,37,51,88,100
"./Ship3_Latin-square/2019-09-28_13h17m_Subject 47781.txt","47781",2019-09-28,"13:17",4,78,60,9,9,18,11,1,1,13,20,3,2,25,911,169,182,1262,84.7333333333333,134.55,2796.61016949153,1409.12068965517,55,44,99,98.3606557377049
"./Ship3_Latin-square/2019-09-28_13h17m_Subject 47782.txt","47782",2019-09-28,"13:17",2,79,60,9,10,19,12,3,1,16,12,12,10,34,533,59,88,680,154.5,104.933333333333,2894.84745762712,1293.84745762712,16,42,58,100
"./Ship3_Latin-square/2019-09-28_13h17m_Subject 47783.txt","47783",2019-09-28,"13:17",4,81,60,9,12,21,57,3,18,78,43,10,8,61,549,79,162,790,1035.86666666667,156.233333333333,2789.81355932203,2140.5,43,75,118,100
"./Ship3_Latin-square/2019-09-28_13h17m_Subject 47785.txt","47785",2019-09-28,"13:17",4,80,60,7,13,20,5,0,2,7,55,13,17,85,1300,176,275,1751,194.566666666667,114.533333333333,2762.61016949153,1566.83333333333,51,192,243,93.4426229508197
"./Ship3_Latin-square/2019-09-28_13h17m_Subject 47786.txt","47786",2019-09-28,"13:17",2,78,59,6,13,19,85,28,15,128,12,2,54,68,263,17,90,370,1236.57627118644,106.932203389831,2875.79310344828,2597.53703703704,28,111,139,96.6666666666667
"./Ship3_Latin-square/2019-09-28_13h17m_Subject 47788.txt","47788",2019-09-28,"13:17",2,77,60,8,9,17,36,2,8,46,59,16,9,84,436,60,94,590,432.166666666667,156.716666666667,2901.66101694915,2362.40677966102,63,81,144,100
"./Ship3_Latin-square/2019-09-28_14h10m_Subject 47080.txt","47080",2019-09-28,"14:10",4,76,60,5,11,16,9,0,1,10,31,2,6,39,778,61,130,969,86.9333333333333,121.7,2762.67796610169,1597.01754385965,35,136,171,96.7213114754098
"./Ship3_Latin-square/2019-09-28_14h10m_Subject 47089.txt","47089",2019-09-28,"14:10",0,82,60,11,11,22,49,9,8,66,75,41,18,134,404,74,100,578,422.2,287.283333333333,3000,1590.01694915254,79,29,108,100
"./Ship3_Latin-square/2019-09-28_14h10m_Subject 47762.txt","47762",2019-09-28,"14:10",4,79,60,6,13,19,49,4,6,59,28,4,4,36,262,42,41,345,619.35,300.116666666667,2762.71186440678,2667.96,84,88,172,86.8852459016393
"./Ship3_Latin-square/2019-09-28_14h10m_Subject 47791.txt","47791",2019-09-28,"14:10",24,85,60,13,12,25,19,4,5,28,35,14,14,63,301,12,119,432,177.566666666667,171,1820.25423728814,1288.6,40,70,110,78.6885245901639
"./Ship3_Latin-square/2019-09-29_10h10m_Subject 46878.txt","46878",2019-09-29,"10:10",16,78,60,10,8,18,35,5,3,43,9,6,1,16,612,68,104,784,180.6,115.7,2213.52542372881,1347.06896551724,73,61,134,98.3606557377049
"./Ship3_Latin-square/2019-09-29_10h10m_Subject 46885.txt","46885",2019-09-29,"10:10",8,81,60,11,10,21,48,3,4,55,9,9,2,20,413,79,84,576,428.466666666667,113.1,2647.42372881356,1520.40350877193,69,62,131,98.3606557377049
"./Ship3_Latin-square/2019-09-29_10h10m_Subject 46899.txt","46899",2019-09-29,"10:10",24,76,60,10,6,16,135,6,37,178,57,12,10,79,399,3,75,477,813.183333333333,158.1,1942.27118644068,1101.27118644068,51,32,83,100
"./Ship3_Latin-square/2019-09-29_10h10m_Subject 47081.txt","47081",2019-09-29,"10:10",2,81,60,9,12,21,18,4,1,23,38,13,4,55,553,94,102,749,129.483333333333,191.45,2888.10169491525,1857.96610169492,44,78,122,100
"./Ship3_Latin-square/2019-09-29_10h10m_Subject 47091.txt","47091",2019-09-29,"10:10",24,81,60,9,12,21,38,14,13,65,82,17,36,135,144,11,59,214,464.566666666667,263.416666666667,1657.57627118644,1685.4375,42,99,141,81.9672131147541
"./Ship3_Latin-square/2019-09-29_10h10m_Subject 47095.txt","47095",2019-09-29,"10:10",8,85,60,12,13,25,28,2,5,35,23,4,6,33,496,80,127,703,283.033333333333,152.383333333333,2606.64406779661,1766.28846153846,78,93,171,91.8032786885246
"./Ship3_Latin-square/2019-09-29_10h10m_Subject 47231.txt","47231",2019-09-29,"10:10",16,78,60,14,4,18,62,8,4,74,74,67,3,144,332,51,18,401,626.15,338.2,2457.52542372881,1396.70689655172,74,32,106,98.3606557377049
"./Ship3_Latin-square/2019-09-29_10h10m_Subject 47238.txt","47238",2019-09-29,"10:10",4,83,60,13,10,23,17,2,0,19,50,23,14,87,537,131,115,783,190.816666666667,171.8,2816.83050847458,1252.0350877193,31,53,84,98.3606557377049
"./Ship3_Latin-square/2019-09-29_10h10m_Subject 47242.txt","47242",2019-09-29,"10:10",4,78,60,5,13,18,25,2,5,32,49,6,16,71,759,56,167,982,179.7,196.316666666667,2749.1186440678,1209.37288135593,40,40,80,100
"./Ship3_Latin-square/2019-09-29_10h10m_Subject 47244.txt","47244",2019-09-29,"10:10",8,81,60,12,9,21,18,3,3,24,71,24,19,114,698,137,116,951,167.616666666667,265.533333333333,2620.27118644068,1431.16949152542,66,97,163,100
"./Ship3_Latin-square/2019-09-29_10h10m_Subject 47633.txt","47633",2019-09-29,"10:10",16,80,60,9,11,20,28,3,5,36,74,20,21,115,253,37,75,365,419.233333333333,245.416666666667,2213.50847457627,1706.70909090909,82,75,157,93.4426229508197
"./Ship3_Latin-square/2019-09-29_10h10m_Subject 47636.txt","47636",2019-09-29,"10:10",4,83,60,13,10,23,59,13,10,82,103,24,11,138,406,89,75,570,387.766666666667,239.266666666667,2816.84745762712,2382.96551724138,121,104,225,100
"./Ship3_Latin-square/2019-09-29_10h10m_Subject 47752.txt","47752",2019-09-29,"10:10",24,84,60,14,10,24,40,5,4,49,63,45,24,132,552,22,236,810,169.833333333333,179.65,1942.30508474576,1026.18,41,101,142,85.2459016393443
"./Ship3_Latin-square/2019-09-29_10h10m_Subject 47767.txt","47767",2019-09-29,"10:10",4,81,60,11,10,21,24,5,0,29,28,18,20,66,400,98,68,566,255.016666666667,161.083333333333,2796.5593220339,1636.35185185185,71,55,126,93.4426229508197
"./Ship3_Latin-square/2019-09-29_10h10m_Subject 47768.txt","47768",2019-09-29,"10:10",4,77,60,9,8,17,27,5,4,36,22,2,3,27,512,92,41,645,846.75,122.7,2803.33898305085,2023.59649122807,54,76,130,98.3606557377049
"./Ship3_Latin-square/2019-09-29_10h10m_Subject 47780.txt","47780",2019-09-29,"10:10",8,79,60,8,11,19,58,1,6,65,46,31,20,97,422,66,120,608,437.133333333333,175.033333333333,2566.08474576271,1703.37288135593,58,28,86,100
"./Ship3_Latin-square/2019-09-29_10h16m_Subject 46884.txt","46884",2019-09-29,"10:16",8,79,59,11,9,20,44,6,12,62,147,15,9,171,279,64,44,387,480.01724137931,631.672413793103,2613.74137931034,1905,92,41,133,91.5254237288136
"./Ship3_Latin-square/2019-09-29_10h16m_Subject 47083.txt","47083",2019-09-29,"10:16",24,73,52,12,9,21,120,16,10,146,43,8,15,66,189,15,56,260,1841.44230769231,176.75,1984.5,2332.04545454545,105,68,173,84.9056603773585
"./Ship3_Latin-square/2019-09-29_10h16m_Subject 47086.txt","47086",2019-09-29,"10:16",16,36,26,9,1,10,56,5,2,63,36,169,1,206,69,25,2,96,1387.07692307692,431.653846153846,2630.61538461538,2395.60869565217,43,16,59,88.8888888888889
"./Ship3_Latin-square/2019-09-29_10h16m_Subject 47246.txt","47246",2019-09-29,"10:16",8,80,60,8,12,20,19,1,3,23,12,0,7,19,432,56,118,606,151.916666666667,174.816666666667,2538.93220338983,1427.44230769231,22,99,121,91.8032786885246
"./Ship3_Latin-square/2019-09-29_10h16m_Subject 47635.txt","47635",2019-09-29,"10:16",4,78,60,8,10,18,19,3,2,24,31,6,6,43,579,70,119,768,241.283333333333,150.983333333333,2789.81355932203,1644.05084745763,64,35,99,100
"./Ship3_Latin-square/2019-09-29_10h16m_Subject 47779.txt","47779",2019-09-29,"10:16",4,63,46,10,7,17,37,6,1,44,88,29,4,121,88,16,34,138,2364.28888888889,375.688888888889,2813.28888888889,4033.03125,46,58,104,78.2608695652174
"./Ship3_Latin-square/2019-09-29_10h16m_Subject 47790.txt","47790",2019-09-29,"10:16",8,81,60,9,12,21,42,3,7,52,29,7,7,43,293,91,50,434,371.983333333333,166.783333333333,2566.05084745763,2016.84615384615,50,72,122,93.4426229508197
"./Ship3_Latin-square/2019-09-29_10h16m_Subject 47797.txt","47797",2019-09-29,"10:16",2,80,60,8,12,20,33,2,10,45,23,3,21,47,309,72,47,428,663.316666666667,177.783333333333,2881.32203389831,2268.89473684211,67,181,248,72.1311475409836
"./Ship3_Latin-square/2019-09-29_11h30m_Subject 46900.txt","46900",2019-09-29,"11:30",0,79,60,9,10,19,10,0,0,10,100,9,17,126,1354,222,227,1803,141.716666666667,201.733333333333,2999.94915254237,1081.30508474576,24,44,68,100
"./Ship3_Latin-square/2019-09-29_11h30m_Subject 46986.txt","46986",2019-09-29,"11:30",16,85,60,13,12,25,46,7,10,63,26,5,41,72,270,47,44,361,712.766666666667,174.85,2186.37288135593,1697.50909090909,73,58,131,96.7213114754098
"./Ship3_Latin-square/2019-09-29_11h30m_Subject 47076.txt","47076",2019-09-29,"11:30",4,80,60,10,10,20,7,0,4,11,8,5,11,24,824,131,153,1108,99.3166666666667,86.3833333333333,2803.33898305085,1667.52631578947,57,91,148,96.7213114754098
"./Ship3_Latin-square/2019-09-29_11h30m_Subject 47079.txt","47079",2019-09-29,"11:30",8,79,60,9,10,19,37,4,4,45,66,17,11,94,240,37,34,311,980.983333333333,303.066666666667,2566.05084745763,2320.09090909091,68,61,129,95.0819672131148
"./Ship3_Latin-square/2019-09-29_11h30m_Subject 47082.txt","47082",2019-09-29,"11:30",4,79,60,9,10,19,29,5,4,38,60,7,4,71,361,67,54,482,494.133333333333,201.583333333333,2783.01694915254,1945.65957446809,66,127,193,83.6065573770492
"./Ship3_Latin-square/2019-09-29_11h30m_Subject 47092.txt","47092",2019-09-29,"11:30",8,75,60,6,9,15,15,3,1,19,28,2,2,32,817,69,142,1028,81.7666666666667,166.266666666667,2566.06779661017,1628.52631578947,59,123,182,98.3606557377049
"./Ship3_Latin-square/2019-09-29_11h30m_Subject 47098.txt","47098",2019-09-29,"11:30",4,87,60,14,13,27,20,1,1,22,35,13,67,115,346,78,105,529,337.616666666667,201.8,2803.37288135593,1864.75,43,103,146,93.4426229508197
"./Ship3_Latin-square/2019-09-29_11h30m_Subject 47226.txt","47226",2019-09-29,"11:30",4,74,60,7,7,14,11,1,1,13,50,17,8,75,2157,224,308,2689,102.866666666667,104.6,2803.35593220339,1137.61403508772,15,55,70,98.3606557377049
"./Ship3_Latin-square/2019-09-29_11h30m_Subject 47227.txt","47227",2019-09-29,"11:30",4,79,60,9,10,19,42,2,3,47,25,16,7,48,431,66,50,547,605.833333333333,130.9,2789.81355932203,1916.96226415094,38,110,148,90.1639344262295
"./Ship3_Latin-square/2019-09-29_11h30m_Subject 47250.txt","47250",2019-09-29,"11:30",4,77,60,7,10,17,26,2,1,29,18,9,5,32,699,98,143,940,198.683333333333,81.6833333333333,2783,1425.22413793103,35,75,110,98.3606557377049
"./Ship3_Latin-square/2019-09-29_11h30m_Subject 47645.txt","47645",2019-09-29,"11:30",16,72,55,11,6,17,86,12,14,112,18,5,4,27,262,32,31,325,1309.6,138.181818181818,2330.81818181818,2830.52,103,87,190,94.6428571428571
"./Ship3_Latin-square/2019-09-29_11h30m_Subject 47646.txt","47646",2019-09-29,"11:30",4,78,60,8,10,18,10,2,0,12,101,16,20,137,1963,292,351,2606,111.15,122.85,2783.01694915254,1418.84210526316,84,102,186,98.3606557377049
"./Ship3_Latin-square/2019-09-29_11h30m_Subject 47755.txt","47755",2019-09-29,"11:30",24,86,60,15,11,26,100,8,25,133,60,19,23,102,320,17,88,425,483.35,361.983333333333,1901.62711864407,1640.0612244898,85,134,219,83.6065573770492
"./Ship3_Latin-square/2019-09-29_11h30m_Subject 47760.txt","47760",2019-09-29,"11:30",8,78,60,8,10,18,43,4,9,56,30,9,4,43,644,74,140,858,214.95,155.1,2579.57627118644,1118.03389830508,23,27,50,100
"./Ship3_Latin-square/2019-09-29_11h30m_Subject 47770.txt","47770",2019-09-29,"11:30",16,46,34,6,6,12,55,9,5,69,37,13,11,61,129,16,17,162,3464.08823529412,347.470588235294,2199.97058823529,4136.68965517241,50,65,115,88.5714285714286
"./Ship3_Latin-square/2019-09-29_11h30m_Subject 47795.txt","47795",2019-09-29,"11:30",4,80,60,6,14,20,30,3,9,42,21,6,9,36,502,53,92,647,250.3,175.633333333333,2755.93220338983,1940.03448275862,42,49,91,98.3606557377049
"./Ship3_Latin-square/2019-09-29_11h35m_Subject 47229.txt","47229",2019-09-29,"11:35",4,80,60,7,13,20,25,1,4,30,44,18,3,65,837,130,174,1141,138.6,216.533333333333,2769.42372881356,1492.32203389831,36,99,135,100
"./Ship3_Latin-square/2019-09-29_11h35m_Subject 47233.txt","47233",2019-09-29,"11:35",8,80,60,8,12,20,23,4,4,31,30,6,7,43,382,51,97,530,118.95,129.966666666667,2525.38983050847,1660,37,87,124,100
"./Ship3_Latin-square/2019-09-29_11h35m_Subject 47234.txt","47234",2019-09-29,"11:35",16,79,60,14,5,19,32,5,3,40,88,17,4,109,373,79,50,502,276.2,308.466666666667,2376.20338983051,1465.40350877193,78,45,123,96.7213114754098
"./Ship3_Latin-square/2019-09-29_11h35m_Subject 47237.txt","47237",2019-09-29,"11:35",24,79,58,12,9,21,83,3,24,110,40,12,31,83,286,3,60,349,1012.98245614035,287.368421052632,1989.40350877193,1220.12727272727,62,17,79,96.551724137931
"./Ship3_Latin-square/2019-09-29_11h35m_Subject 47241.txt","47241",2019-09-29,"11:35",2,81,60,7,14,21,12,0,1,13,13,11,2,26,1034,130,244,1408,78.3333333333333,99.7333333333333,2884.74576271186,1361.62068965517,25,100,125,98.3606557377049
"./Ship3_Latin-square/2019-09-29_11h35m_Subject 47247.txt","47247",2019-09-29,"11:35",24,74,60,9,5,14,68,9,5,82,50,13,4,67,191,5,13,209,620.4,253.566666666667,1942.30508474576,1872.11111111111,67,74,141,78.6885245901639
"./Ship3_Latin-square/2019-09-29_11h35m_Subject 47777.txt","47777",2019-09-29,"11:35",0,70,53,7,10,17,39,9,10,58,144,22,20,186,411,96,67,574,601.096153846154,463.961538461538,2999.94230769231,2296.5306122449,42,51,93,98.1132075471698
"./Ship3_Latin-square/2019-09-29_11h35m_Subject 47784.txt","47784",2019-09-29,"11:35",24,80,57,14,9,23,120,18,21,159,75,37,13,125,588,30,86,704,1084.84210526316,234.543859649123,2031.54385964912,1561.91071428571,87,59,146,98.2758620689655
"./Ship3_Latin-square/2019-09-29_12h50m_Subject 46880.txt","46880",2019-09-29,"12:50",4,82,60,8,14,22,12,0,0,12,10,1,5,16,731,95,188,1014,118.733333333333,88.5,2755.91525423729,1944.93181818182,85,265,350,85.2459016393443
"./Ship3_Latin-square/2019-09-29_12h50m_Subject 46882.txt","46882",2019-09-29,"12:50",2,79,60,6,13,19,18,1,0,19,128,14,23,165,1121,156,245,1522,88.7833333333333,205.816666666667,2881.33898305085,1756.60344827586,90,79,169,98.3606557377049
"./Ship3_Latin-square/2019-09-29_12h50m_Subject 46883.txt","46883",2019-09-29,"12:50",24,77,55,13,9,22,127,13,19,159,26,17,20,63,204,0,46,250,1445.03636363636,178.436363636364,2066.62962962963,1706.40816326531,53,51,104,92.7272727272727
"./Ship3_Latin-square/2019-09-29_12h50m_Subject 46894.txt","46894",2019-09-29,"12:50",2,76,60,6,10,16,26,3,1,30,24,1,1,26,660,28,94,782,287.133333333333,200.483333333333,2884.71186440678,1666.86440677966,30,51,81,100
"./Ship3_Latin-square/2019-09-29_12h50m_Subject 46896.txt","46896",2019-09-29,"12:50",2,80,60,6,14,20,22,4,4,30,32,8,5,45,919,83,214,1216,219.133333333333,134.816666666667,2874.52542372881,1257.72413793103,34,34,68,98.3606557377049
"./Ship3_Latin-square/2019-09-29_12h50m_Subject 47088.txt","47088",2019-09-29,"12:50",24,83,60,14,9,23,68,10,8,86,51,13,12,76,420,14,88,522,526.383333333333,200.466666666667,1942.33898305085,999.857142857143,50,93,143,85.2459016393443
"./Ship3_Latin-square/2019-09-29_12h50m_Subject 47228.txt","47228",2019-09-29,"12:50",2,81,60,8,13,21,21,2,10,33,25,2,6,33,519,111,100,730,199.966666666667,86.1666666666667,2884.72881355932,1498.46551724138,36,65,101,98.3606557377049
"./Ship3_Latin-square/2019-09-29_12h50m_Subject 47243.txt","47243",2019-09-29,"12:50",2,83,60,13,10,23,27,1,3,31,21,8,0,29,939,221,205,1365,132.6,135.783333333333,2901.64406779661,1320.42372881356,99,70,169,100
"./Ship3_Latin-square/2019-09-29_12h50m_Subject 47249.txt","47249",2019-09-29,"12:50",24,84,60,16,8,24,97,9,25,131,52,68,12,132,327,16,67,410,512.6,187.133333333333,2064.35593220339,1228.37288135593,69,56,125,100
"./Ship3_Latin-square/2019-09-29_12h50m_Subject 47639.txt","47639",2019-09-29,"12:50",0,82,60,4,18,22,20,0,1,21,12,0,5,17,906,40,201,1147,97.3166666666667,142.7,2999.8813559322,1564.72881355932,30,72,102,100
"./Ship3_Latin-square/2019-09-29_12h50m_Subject 47649.txt","47649",2019-09-29,"12:50",8,84,60,13,11,24,45,8,8,61,23,8,6,37,394,53,141,588,409.233333333333,191.116666666667,2620.32203389831,1570.74418604651,58,117,175,83.6065573770492
"./Ship3_Latin-square/2019-09-29_12h50m_Subject 47753.txt","47753",2019-09-29,"12:50",24,64,47,11,6,17,64,5,11,80,131,75,19,225,219,10,29,258,1183.06382978723,801.695652173913,2008.60869565217,2373.4,78,72,150,87.2340425531915
"./Ship3_Latin-square/2019-09-29_12h50m_Subject 47758.txt","47758",2019-09-29,"12:50",24,86,60,14,12,26,51,0,23,74,46,10,47,103,436,6,133,575,212.833333333333,182.716666666667,1820.25423728814,995.754716981132,61,68,129,90.1639344262295
"./Ship3_Latin-square/2019-09-29_12h50m_Subject 47759.txt","47759",2019-09-29,"12:50",24,85,60,15,10,25,78,4,27,109,64,12,37,113,270,1,84,355,496.55,241.883333333333,1860.94915254237,1153.73684210526,38,53,91,96.7213114754098
"./Ship3_Latin-square/2019-09-29_12h50m_Subject 47776.txt","47776",2019-09-29,"12:50",2,79,60,9,10,19,15,1,1,17,49,16,6,71,1208,170,215,1593,94.4166666666667,130.966666666667,2898.27118644068,1293.54237288136,58,39,97,100
"./Ship3_Latin-square/2019-09-29_12h50m_Subject 47799.txt","47799",2019-09-29,"12:50",24,71,52,13,6,19,80,16,16,112,72,104,4,180,124,4,22,150,818.980769230769,784.764705882353,2058.70588235294,1852.86956521739,48,38,86,92.3076923076923
"./Ship3_Latin-square/2019-09-29_12h53m_Subject 46881.txt","46881",2019-09-29,"12:53",4,80,60,8,12,20,22,4,3,29,31,8,29,68,799,108,157,1064,204.333333333333,141.083333333333,2776.23728813559,1639.98148148148,46,110,156,95.0819672131148
"./Ship3_Latin-square/2019-09-29_12h53m_Subject 47087.txt","47087",2019-09-29,"12:53",4,77,60,8,9,17,34,3,7,44,33,11,3,47,300,53,49,402,326.05,114.05,2783.05084745763,1769.27586206897,59,32,91,98.3606557377049
"./Ship3_Latin-square/2019-09-29_12h53m_Subject 47626.txt","47626",2019-09-29,"12:53",0,83,60,6,17,23,14,6,1,21,14,3,43,60,375,39,143,557,162.516666666667,124.316666666667,2999.89830508475,1943.69230769231,60,107,167,91.8032786885246
"./Ship3_Latin-square/2019-09-29_12h53m_Subject 47632.txt","47632",2019-09-29,"12:53",0,79,60,10,9,19,10,1,0,11,39,13,0,52,1310,246,196,1752,73.15,182.2,2999.8813559322,1258.40677966102,33,79,112,100
"./Ship3_Latin-square/2019-09-29_12h53m_Subject 47634.txt","47634",2019-09-29,"12:53",4,85,60,13,12,25,30,4,7,41,20,10,8,38,393,75,114,582,308.216666666667,124.3,2803.32203389831,1889.30769230769,85,57,142,93.4426229508197
"./Ship3_Latin-square/2019-09-29_12h53m_Subject 47640.txt","47640",2019-09-29,"12:53",4,83,60,9,14,23,35,11,9,55,33,11,6,50,432,84,106,622,523.966666666667,178.083333333333,2769.47457627119,1817.68421052632,32,39,71,98.3606557377049
"./Ship3_Latin-square/2019-09-29_12h53m_Subject 47754.txt","47754",2019-09-29,"12:53",0,75,60,4,11,15,40,5,3,48,87,0,48,135,429,50,71,550,1308.2,254.716666666667,2999.8813559322,2702.70588235294,20,216,236,88.5245901639344
"./Ship3_Latin-square/2019-09-29_12h53m_Subject 47800.txt","47800",2019-09-29,"12:53",2,75,60,3,12,15,24,0,5,29,60,3,9,72,394,37,82,513,320.933333333333,169.566666666667,2867.77966101695,1933.46551724138,48,104,152,100
"./Ship3_Latin-square/2019-09-29_14h04m_Subject 46876.txt","46876",2019-09-29,"14:04",4,82,60,11,11,22,23,4,5,32,4,3,2,9,642,104,139,885,220.533333333333,95.6333333333333,2803.35593220339,1629.27118644068,49,37,86,100
"./Ship3_Latin-square/2019-09-29_14h04m_Subject 46877.txt","46877",2019-09-29,"14:04",16,81,60,10,11,21,17,1,3,21,34,13,51,98,836,91,250,1177,91.6833333333333,156.5,2186.40677966102,1316.96226415094,51,190,241,90.1639344262295
"./Ship3_Latin-square/2019-09-29_14h04m_Subject 46893.txt","46893",2019-09-29,"14:04",2,77,60,5,12,17,6,1,1,8,96,11,6,113,1568,147,353,2068,53.7333333333333,237.933333333333,2877.91525423729,1468.33898305085,116,145,261,100
"./Ship3_Latin-square/2019-09-29_14h04m_Subject 46895.txt","46895",2019-09-29,"14:04",8,40,27,8,5,13,28,10,14,52,49,48,93,190,91,31,17,139,2104.51851851852,521.444444444444,2674.03703703704,3447.95833333333,31,74,105,89.2857142857143
"./Ship3_Latin-square/2019-09-29_14h04m_Subject 47638.txt","47638",2019-09-29,"14:04",2,77,60,8,9,17,47,3,4,54,20,0,13,33,454,65,54,573,422.733333333333,133.25,2891.49152542373,1797.54237288136,56,36,92,100
"./Ship3_Latin-square/2019-09-29_14h04m_Subject 47757.txt","47757",2019-09-29,"14:04",24,50,35,12,3,15,103,61,12,176,48,17,3,68,133,16,15,164,1875.08823529412,552.647058823529,2435.20588235294,1318.9375,48,42,90,94.2857142857143
"./Ship3_Latin-square/2019-09-29_14h04m_Subject 47769.txt","47769",2019-09-29,"14:04",0,84,60,13,11,24,13,2,0,15,40,14,9,63,892,213,247,1352,117.45,147.283333333333,2999.91525423729,1524.74576271186,71,78,149,100
"./Ship3_Latin-square/2019-09-29_14h04m_Subject 47771.txt","47771",2019-09-29,"14:04",0,79,60,7,12,19,13,1,2,16,9,1,8,18,1111,142,183,1436,108.1,111.466666666667,2999.89830508475,1299.94915254237,24,55,79,100
"./Ship3_Latin-square/2019-09-29_14h04m_Subject 47775.txt","47775",2019-09-29,"14:04",0,78,60,9,9,18,63,10,12,85,8,1,4,13,336,50,56,442,451.866666666667,103.666666666667,2999.93220338983,1717.40677966102,41,41,82,100
"./Ship3_Latin-square/2019-09-29_14h04m_Subject 47781.txt","47781",2019-09-29,"14:04",2,80,60,10,10,20,9,0,0,9,20,9,7,36,1138,187,172,1497,100.7,135.983333333333,2898.28813559322,1574.81355932203,78,30,108,100
"./Ship3_Latin-square/2019-09-29_14h04m_Subject 47782.txt","47782",2019-09-29,"14:04",24,81,60,9,12,21,25,5,6,36,12,6,10,28,322,12,93,427,133.466666666667,97.5166666666667,1698.27118644068,1211.2380952381,34,70,104,78.6885245901639
"./Ship3_Latin-square/2019-09-29_14h04m_Subject 47783.txt","47783",2019-09-29,"14:04",2,80,60,6,14,20,46,6,5,57,56,6,46,108,583,53,146,782,653.816666666667,174.75,2877.94915254237,2149.26315789474,34,143,177,98.3606557377049
"./Ship3_Latin-square/2019-09-29_14h04m_Subject 47785.txt","47785",2019-09-29,"14:04",2,83,60,11,12,23,17,2,3,22,69,12,37,118,1433,300,257,1990,198.45,106.383333333333,2894.86440677966,1566.68965517241,55,120,175,98.3606557377049
"./Ship3_Latin-square/2019-09-29_14h04m_Subject 47786.txt","47786",2019-09-29,"14:04",8,78,60,9,9,18,69,4,8,81,22,4,5,31,270,32,46,348,766.716666666667,106.933333333333,2606.72881355932,2335.14285714286,60,50,110,96.7213114754098
"./Ship3_Latin-square/2019-09-29_14h04m_Subject 47788.txt","47788",2019-09-29,"14:04",24,81,59,12,10,22,97,14,26,137,77,24,25,126,175,13,44,232,1003.15254237288,309.64406779661,1882.74137931034,1916.40350877193,49,60,109,96.6666666666667
"./Ship3_Latin-square/2019-09-29_14h07m_Subject 46888.txt","46888",2019-09-29,"14:07",2,80,60,9,11,20,14,0,1,15,99,9,2,110,752,107,166,1025,96.35,261.85,2891.49152542373,1908.7962962963,79,91,170,93.4426229508197
"./Ship3_Latin-square/2019-09-29_14h07m_Subject 46889.txt","46889",2019-09-29,"14:07",8,77,60,6,11,17,19,1,0,20,28,5,8,41,955,82,202,1239,91.85,176.466666666667,2538.94915254237,1335.14035087719,45,206,251,96.7213114754098
"./Ship3_Latin-square/2019-09-29_14h07m_Subject 46890.txt","46890",2019-09-29,"14:07",16,64,47,5,12,17,33,2,2,37,8,0,84,92,190,15,98,303,1094.17391304348,136.130434782609,1991.26086956522,2066.89655172414,31,95,126,74.468085106383
"./Ship3_Latin-square/2019-09-29_14h07m_Subject 46892.txt","46892",2019-09-29,"14:07",2,75,60,5,10,15,19,1,2,22,7,2,5,14,1127,94,149,1370,78.3666666666667,84.3833333333333,2891.49152542373,1315.59322033898,40,66,106,100
"./Ship3_Latin-square/2019-09-29_14h07m_Subject 46898.txt","46898",2019-09-29,"14:07",8,72,54,10,8,18,34,6,4,44,36,10,9,55,396,65,99,560,1622.50943396226,204.094339622642,2637.71698113208,2240.88,45,57,102,96.2962962962963
"./Ship3_Latin-square/2019-09-29_14h07m_Subject 47097.txt","47097",2019-09-29,"14:07",4,80,60,10,10,20,12,1,6,19,59,11,9,79,821,123,136,1080,122.216666666667,189.133333333333,2803.28813559322,1386.08620689655,57,78,135,98.3606557377049
"./Ship3_Latin-square/2019-09-29_14h07m_Subject 47099.txt","47099",2019-09-29,"14:07",2,83,60,9,14,23,3,0,1,4,40,14,23,77,993,140,230,1363,58.0666666666667,163,2888.08474576271,1444.91379310345,40,74,114,100
"./Ship3_Latin-square/2019-09-29_14h07m_Subject 47798.txt","47798",2019-09-29,"14:07",16,76,60,6,10,16,27,3,5,35,16,3,0,19,192,15,36,243,581.916666666667,179.166666666667,2132.18644067797,1741.60465116279,31,95,126,81.9672131147541
"./Ship3_Latin-square/2019-09-29_15h10m_Subject 47080.txt","47080",2019-09-29,"15:10",2,80,60,7,13,20,14,3,3,20,20,2,13,35,867,101,156,1124,115.183333333333,111.7,2884.74576271186,1551.08620689655,34,108,142,100
"./Ship3_Latin-square/2019-09-29_15h10m_Subject 47089.txt","47089",2019-09-29,"15:10",4,81,60,11,10,21,58,8,13,79,70,12,19,101,288,45,57,390,1009.53333333333,201.566666666667,2796.5593220339,2037.8,74,49,123,93.4426229508197
"./Ship3_Latin-square/2019-09-29_15h10m_Subject 47762.txt","47762",2019-09-29,"15:10",16,82,60,12,10,22,68,10,11,89,42,23,6,71,182,27,38,247,577.406779661017,318.152542372881,2213.54237288136,2262.39215686275,90,56,146,90
"./Ship3_Latin-square/2019-09-29_15h10m_Subject 47791.txt","47791",2019-09-29,"15:10",8,75,60,8,7,15,14,1,0,15,23,2,1,26,688,83,113,884,118.033333333333,127.333333333333,2593.16949152542,1334.84745762712,26,13,39,100
"./Ship3_Latin-square/2019-09-30_10h20m_Subject 46878.txt","46878",2019-09-30,"10:20",24,81,60,10,11,21,24,2,5,31,16,10,25,51,514,12,137,663,131.183333333333,127,1820.32203389831,1106.02222222222,59,71,130,81.9672131147541
"./Ship3_Latin-square/2019-09-30_10h20m_Subject 46885.txt","46885",2019-09-30,"10:20",0,81,60,10,11,21,33,7,5,45,18,7,8,33,558,93,99,750,253,104.233333333333,2999.94915254237,1515.80701754386,71,58,129,96.7213114754098
"./Ship3_Latin-square/2019-09-30_10h20m_Subject 46899.txt","46899",2019-09-30,"10:20",8,78,60,8,10,18,17,1,2,20,25,5,10,40,928,85,213,1226,158.216666666667,128.383333333333,2593.15254237288,957.830508474576,23,31,54,100
"./Ship3_Latin-square/2019-09-30_10h20m_Subject 47081.txt","47081",2019-09-30,"10:20",8,75,60,5,10,15,19,2,1,22,23,2,5,30,616,53,117,786,74.2166666666667,132.066666666667,2552.50847457627,1386.96610169492,45,63,108,98.3606557377049
"./Ship3_Latin-square/2019-09-30_10h20m_Subject 47091.txt","47091",2019-09-30,"10:20",8,80,60,7,13,20,21,4,5,30,64,16,14,94,341,40,101,482,259.433333333333,200.716666666667,2552.47457627119,1476.28813559322,49,40,89,98.3606557377049
"./Ship3_Latin-square/2019-09-30_10h20m_Subject 47095.txt","47095",2019-09-30,"10:20",24,76,55,13,8,21,65,8,18,91,71,23,36,130,243,5,33,281,955.745454545455,407.018181818182,2083.52727272727,2262.26666666667,60,92,152,82.1428571428571
"./Ship3_Latin-square/2019-09-30_10h20m_Subject 47231.txt","47231",2019-09-30,"10:20",24,68,50,14,4,18,75,12,5,92,75,73,2,150,247,24,18,289,983.44,798.04,2279.98,1391.40816326531,62,31,93,98.0392156862745
"./Ship3_Latin-square/2019-09-30_10h20m_Subject 47238.txt","47238",2019-09-30,"10:20",2,80,60,11,9,20,11,0,1,12,43,13,10,66,534,109,75,718,141.633333333333,402.466666666667,2905.05084745763,1342.06779661017,52,34,86,100
"./Ship3_Latin-square/2019-09-30_10h20m_Subject 47242.txt","47242",2019-09-30,"10:20",2,82,60,10,12,22,42,5,5,52,18,18,17,53,753,129,157,1039,161.433333333333,111.433333333333,2894.86440677966,1289.35593220339,54,36,90,100
"./Ship3_Latin-square/2019-09-30_10h20m_Subject 47244.txt","47244",2019-09-30,"10:20",0,78,60,6,12,18,13,2,2,17,45,7,12,64,1047,112,164,1323,137.633333333333,205.966666666667,2999.89830508475,1310.36206896552,80,67,147,98.3606557377049
"./Ship3_Latin-square/2019-09-30_10h20m_Subject 47633.txt","47633",2019-09-30,"10:20",24,80,60,13,7,20,62,14,17,93,56,25,12,93,264,13,56,333,574.983333333333,241.333333333333,2023.71186440678,1614.44897959184,128,85,213,83.6065573770492
"./Ship3_Latin-square/2019-09-30_10h20m_Subject 47636.txt","47636",2019-09-30,"10:20",16,82,58,12,12,24,67,8,24,99,98,20,39,157,341,54,51,446,634.155172413793,495.534482758621,2185.91228070175,2289.25,91,149,240,91.3793103448276
"./Ship3_Latin-square/2019-09-30_10h20m_Subject 47752.txt","47752",2019-09-30,"10:20",8,79,60,9,10,19,37,9,4,50,29,14,5,48,669,93,131,893,292.166666666667,123.416666666667,2593.22033898305,1331.27586206897,54,55,109,98.3606557377049
"./Ship3_Latin-square/2019-09-30_10h20m_Subject 47767.txt","47767",2019-09-30,"10:20",2,86,60,13,13,26,38,0,5,43,28,18,13,59,341,87,58,486,495.216666666667,150.966666666667,2901.64406779661,1986.15094339623,65,47,112,93.4426229508197
"./Ship3_Latin-square/2019-09-30_10h20m_Subject 47768.txt","47768",2019-09-30,"10:20",16,82,60,13,9,22,25,1,11,37,38,20,3,61,441,50,116,607,425.166666666667,189.616666666667,2240.66101694915,1944.25454545455,58,85,143,96.7213114754098
"./Ship3_Latin-square/2019-09-30_10h20m_Subject 47780.txt","47780",2019-09-30,"10:20",4,82,60,11,11,22,76,7,13,96,61,14,15,90,337,55,99,491,765.033333333333,332.133333333333,2803.33898305085,1884.43859649123,57,54,111,96.7213114754098
"./Ship3_Latin-square/2019-09-30_10h25m_Subject 46884.txt","46884",2019-09-30,"10:25",0,79,60,10,9,19,15,0,7,22,25,6,15,46,536,130,79,745,158.15,226.183333333333,2999.84745762712,2003.02083333333,122,86,208,85.2459016393443
"./Ship3_Latin-square/2019-09-30_10h25m_Subject 47083.txt","47083",2019-09-30,"10:25",8,82,60,8,14,22,57,4,6,67,61,10,17,88,485,51,151,687,638.416666666667,221.983333333333,2525.32203389831,2016.48214285714,98,96,194,95.0819672131148
"./Ship3_Latin-square/2019-09-30_10h25m_Subject 47086.txt","47086",2019-09-30,"10:25",2,80,60,10,10,20,9,3,0,12,6,2,2,10,493,75,94,662,173.383333333333,106.833333333333,2905.01694915254,1473.32142857143,69,42,111,96.7213114754098
"./Ship3_Latin-square/2019-09-30_10h25m_Subject 47246.txt","47246",2019-09-30,"10:25",0,79,60,3,16,19,16,0,2,18,9,1,8,18,564,27,107,698,118.633333333333,132.4,2999.89830508475,1760.8275862069,32,103,135,98.3606557377049
"./Ship3_Latin-square/2019-09-30_10h25m_Subject 47635.txt","47635",2019-09-30,"10:25",16,81,60,12,9,21,21,2,1,24,36,34,8,78,506,58,88,652,176.283333333333,156.033333333333,2294.89830508475,1649.77192982456,94,59,153,96.7213114754098
"./Ship3_Latin-square/2019-09-30_10h25m_Subject 47779.txt","47779",2019-09-30,"10:25",16,52,37,9,6,15,18,7,2,27,35,17,10,62,77,20,9,106,2557.64864864865,245.135135135135,2307.97297297297,4933.71428571429,81,47,128,60.5263157894737
"./Ship3_Latin-square/2019-09-30_10h25m_Subject 47790.txt","47790",2019-09-30,"10:25",24,81,59,16,6,22,41,10,5,56,34,24,4,62,249,19,30,298,1226.49152542373,236.559322033898,2130.91379310345,2754.79487179487,65,72,137,77.9661016949153
"./Ship3_Latin-square/2019-09-30_10h25m_Subject 47797.txt","47797",2019-09-30,"10:25",8,72,50,8,14,22,41,2,12,55,83,23,21,127,228,30,45,303,1184.56,750.86,2519.98,2320.63414634146,22,118,140,84.3137254901961
"./Ship3_Latin-square/2019-09-30_11h40m_Subject 46900.txt","46900",2019-09-30,"11:40",4,81,60,7,14,21,7,0,0,7,123,19,34,176,1173,133,329,1635,72.2833333333333,257.3,2776.20338983051,943.440677966102,16,87,103,100
"./Ship3_Latin-square/2019-09-30_11h40m_Subject 46986.txt","46986",2019-09-30,"11:40",2,80,60,9,11,20,36,5,3,44,12,2,10,24,367,51,60,478,783.566666666667,139.133333333333,2894.83050847458,2064.75,53,59,112,98.3606557377049
"./Ship3_Latin-square/2019-09-30_11h40m_Subject 47076.txt","47076",2019-09-30,"11:40",2,79,60,9,10,19,6,1,1,8,10,26,5,41,1030,162,185,1377,65.4166666666667,95.1333333333333,2898.25423728814,1778.03448275862,85,125,210,98.3606557377049
"./Ship3_Latin-square/2019-09-30_11h40m_Subject 47079.txt","47079",2019-09-30,"11:40",0,77,60,9,8,17,18,4,6,28,52,12,15,79,365,67,36,468,275.95,222.65,2999.89830508475,2072.3275862069,46,50,96,98.3606557377049
"./Ship3_Latin-square/2019-09-30_11h40m_Subject 47082.txt","47082",2019-09-30,"11:40",2,75,60,7,8,15,38,4,9,51,48,7,10,65,266,35,25,326,797.816666666667,155.383333333333,2894.8813559322,2918.39655172414,59,49,108,98.3606557377049
"./Ship3_Latin-square/2019-09-30_11h40m_Subject 47092.txt","47092",2019-09-30,"11:40",0,79,60,8,11,19,13,0,0,13,25,2,5,32,1008,141,164,1313,96.8666666666667,184.716666666667,2999.91525423729,1784,79,131,210,98.3606557377049
"./Ship3_Latin-square/2019-09-30_11h40m_Subject 47098.txt","47098",2019-09-30,"11:40",24,83,57,16,10,26,106,8,21,135,44,19,23,86,186,2,29,217,802.232142857143,308.053571428571,2014.21428571429,1942.42553191489,66,89,155,87.719298245614
"./Ship3_Latin-square/2019-09-30_11h40m_Subject 47226.txt","47226",2019-09-30,"11:40",2,78,60,8,10,18,10,2,1,13,43,6,12,61,2595,240,374,3209,78.4833333333333,106.216666666667,2894.86440677966,1187.38888888889,18,225,243,95.0819672131148
"./Ship3_Latin-square/2019-09-30_11h40m_Subject 47227.txt","47227",2019-09-30,"11:40",2,84,59,7,18,25,53,2,26,81,27,8,13,48,367,51,76,494,1066.67796610169,155.966101694915,2860.96610169492,2035.17777777778,24,154,178,78.3333333333333
"./Ship3_Latin-square/2019-09-30_11h40m_Subject 47250.txt","47250",2019-09-30,"11:40",2,81,60,12,9,21,12,6,0,18,13,5,8,26,791,130,125,1046,148.816666666667,87.85,2905.06779661017,1419.3275862069,44,59,103,98.3606557377049
"./Ship3_Latin-square/2019-09-30_11h40m_Subject 47645.txt","47645",2019-09-30,"11:40",2,79,57,10,12,22,60,5,17,82,16,1,8,25,360,65,54,479,1226.21052631579,140.684210526316,2894.70175438596,2745.80769230769,65,75,140,93.1034482758621
"./Ship3_Latin-square/2019-09-30_11h40m_Subject 47646.txt","47646",2019-09-30,"11:40",2,82,60,9,13,22,15,2,0,17,90,22,39,151,1669,309,421,2399,180.516666666667,142.066666666667,2884.72881355932,1797.75862068966,30,57,87,98.3606557377049
"./Ship3_Latin-square/2019-09-30_11h40m_Subject 47755.txt","47755",2019-09-30,"11:40",8,81,60,12,9,21,41,12,9,62,33,18,4,55,570,84,95,749,212.133333333333,194.816666666667,2606.74576271186,1802.6724137931,90,133,223,98.3606557377049
"./Ship3_Latin-square/2019-09-30_11h40m_Subject 47760.txt","47760",2019-09-30,"11:40",0,77,60,8,9,17,23,0,10,33,36,12,7,55,1058,219,144,1421,102.6,187.766666666667,2999.93220338983,1300.72881355932,49,47,96,100
"./Ship3_Latin-square/2019-09-30_11h40m_Subject 47770.txt","47770",2019-09-30,"11:40",24,38,29,7,2,9,93,15,5,113,34,13,2,49,67,4,4,75,6245.39285714286,620.928571428571,2228.53571428571,4839.125,55,53,108,86.2068965517241
"./Ship3_Latin-square/2019-09-30_11h40m_Subject 47795.txt","47795",2019-09-30,"11:40",2,80,60,9,11,20,29,6,4,39,46,6,6,58,342,76,62,480,207.483333333333,164.2,2894.91525423729,2218.26315789474,35,30,65,96.7213114754098
"./Ship3_Latin-square/2019-09-30_11h43m_Subject 47229.txt","47229",2019-09-30,"11:43",2,79,60,8,11,19,14,0,4,18,40,5,5,50,798,90,83,971,111.683333333333,213.8,2891.49152542373,1599.67857142857,27,80,107,95.0819672131148
"./Ship3_Latin-square/2019-09-30_11h43m_Subject 47233.txt","47233",2019-09-30,"11:43",0,80,60,5,15,20,24,0,2,26,21,2,7,30,483,48,82,613,152.966666666667,118.166666666667,2999.89830508475,2063.27272727273,31,110,141,95.0819672131148
"./Ship3_Latin-square/2019-09-30_11h43m_Subject 47234.txt","47234",2019-09-30,"11:43",2,81,60,12,9,21,23,22,4,49,83,9,79,171,460,143,92,695,276.35,393.916666666667,2905.08474576271,1598.28301886792,75,54,129,93.4426229508197
"./Ship3_Latin-square/2019-09-30_11h43m_Subject 47237.txt","47237",2019-09-30,"11:43",2,77,60,10,7,17,37,1,1,39,18,5,7,30,676,84,93,853,626.866666666667,145.033333333333,2908.42372881356,1167.13559322034,46,17,63,100
"./Ship3_Latin-square/2019-09-30_11h43m_Subject 47241.txt","47241",2019-09-30,"11:43",8,80,60,8,12,20,16,1,3,20,5,8,2,15,874,113,215,1202,99.4,87.4166666666667,2593.16949152542,1493.81034482759,41,57,98,98.3606557377049
"./Ship3_Latin-square/2019-09-30_11h43m_Subject 47247.txt","47247",2019-09-30,"11:43",8,73,60,6,7,13,25,2,0,27,42,4,4,50,338,33,41,412,433.933333333333,193.616666666667,2566.08474576271,2277.97777777778,63,157,220,80.327868852459
"./Ship3_Latin-square/2019-09-30_11h43m_Subject 47777.txt","47777",2019-09-30,"11:43",4,82,60,10,12,22,44,10,6,60,19,3,17,39,361,71,93,525,427.5,200.683333333333,2789.76271186441,2432.36363636364,50,48,98,96.7213114754098
"./Ship3_Latin-square/2019-09-30_11h43m_Subject 47784.txt","47784",2019-09-30,"11:43",8,81,60,11,10,21,43,15,16,74,94,40,36,170,964,151,143,1258,191.95,245.8,2593.13559322034,1057.37288135593,61,86,147,100
"./Ship3_Latin-square/2019-09-30_12h51m_Subject 46881.txt","46881",2019-09-30,"12:51",2,77,60,8,9,17,16,1,3,20,56,8,4,68,854,118,156,1128,181.2,188.183333333333,2894.86440677966,1862.08620689655,52,86,138,98.3606557377049
"./Ship3_Latin-square/2019-09-30_12h51m_Subject 47087.txt","47087",2019-09-30,"12:51",2,80,60,9,11,20,20,0,2,22,47,7,4,58,430,73,71,574,166.416666666667,134.65,2891.47457627119,1708.03389830508,69,34,103,100
"./Ship3_Latin-square/2019-09-30_12h51m_Subject 47626.txt","47626",2019-09-30,"12:51",4,74,60,5,9,14,14,1,1,16,30,9,6,45,361,42,51,454,332.216666666667,150.35,2769.40677966102,1921.32075471698,59,86,145,93.4426229508197
"./Ship3_Latin-square/2019-09-30_12h51m_Subject 47632.txt","47632",2019-09-30,"12:51",24,77,60,10,7,17,26,1,1,28,20,10,13,43,507,6,104,617,126.766666666667,150.55,1820.32203389831,980.488888888889,36,72,108,77.0491803278689
"./Ship3_Latin-square/2019-09-30_12h51m_Subject 47634.txt","47634",2019-09-30,"12:51",2,76,60,5,11,16,40,5,10,55,16,3,11,30,366,28,82,476,368.266666666667,122.516666666667,2884.69491525424,2175.87037037037,73,72,145,93.4426229508197
"./Ship3_Latin-square/2019-09-30_12h51m_Subject 47640.txt","47640",2019-09-30,"12:51",2,80,59,9,12,21,54,7,9,70,30,12,5,47,364,23,104,491,1117.32203389831,156.28813559322,2893.03448275862,2503.36538461538,38,55,93,93.3333333333333
"./Ship3_Latin-square/2019-09-30_12h51m_Subject 47754.txt","47754",2019-09-30,"12:51",2,72,52,11,9,20,36,5,2,43,110,13,34,157,294,68,39,401,1500.43137254902,338.56862745098,2901.92156862745,3397.09302325581,27,125,152,88.4615384615385
"./Ship3_Latin-square/2019-09-30_12h51m_Subject 47800.txt","47800",2019-09-30,"12:51",0,77,60,3,14,17,31,3,7,41,42,7,10,59,370,25,92,487,325,139.5,2999.94915254237,2075.57894736842,40,104,144,96.7213114754098
"./Ship3_Latin-square/2019-09-30_12h54m_Subject 46880.txt","46880",2019-09-30,"12:54",2,78,60,6,12,18,6,0,0,6,29,0,2,31,873,69,210,1152,105.816666666667,166.816666666667,2874.57627118644,2003.95744680851,70,279,349,81.9672131147541
"./Ship3_Latin-square/2019-09-30_12h54m_Subject 46882.txt","46882",2019-09-30,"12:54",0,84,60,11,13,24,13,16,0,29,96,8,18,122,1110,249,281,1640,109.416666666667,186.033333333333,2999.8813559322,1771.80357142857,122,66,188,98.3606557377049
"./Ship3_Latin-square/2019-09-30_12h54m_Subject 46883.txt","46883",2019-09-30,"12:54",8,82,60,11,11,22,34,3,6,43,14,19,17,50,425,82,116,623,270.233333333333,117.316666666667,2606.69491525424,1424.74576271186,35,41,76,100
"./Ship3_Latin-square/2019-09-30_12h54m_Subject 46894.txt","46894",2019-09-30,"12:54",24,84,60,14,10,24,57,8,28,93,36,25,12,73,194,20,45,259,607.533333333333,167.5,1942.28813559322,2118.12244897959,96,56,152,86.8852459016393
"./Ship3_Latin-square/2019-09-30_12h54m_Subject 46896.txt","46896",2019-09-30,"12:54",0,80,60,7,13,20,21,1,2,24,29,2,9,40,1034,143,241,1418,184.216666666667,126,2999.89830508475,1131.72413793103,24,35,59,100
"./Ship3_Latin-square/2019-09-30_12h54m_Subject 47088.txt","47088",2019-09-30,"12:54",4,48,38,5,5,10,31,3,4,38,68,10,143,221,425,42,66,533,324.421052631579,296.368421052632,2778.86842105263,1298,22,46,68,100
"./Ship3_Latin-square/2019-09-30_12h54m_Subject 47228.txt","47228",2019-09-30,"12:54",24,80,60,10,10,20,43,2,8,53,15,7,5,27,309,21,64,394,306.916666666667,97.5166666666667,1820.32203389831,1519.67924528302,45,56,101,95.0819672131148
"./Ship3_Latin-square/2019-09-30_12h54m_Subject 47243.txt","47243",2019-09-30,"12:54",24,82,60,11,11,22,91,12,17,120,45,14,15,74,424,14,134,572,306.4,221.033333333333,1860.94915254237,1376.17647058824,94,94,188,88.5245901639344
"./Ship3_Latin-square/2019-09-30_12h54m_Subject 47249.txt","47249",2019-09-30,"12:54",4,81,60,8,13,21,13,6,3,22,60,22,24,106,652,100,205,957,137.966666666667,174.733333333333,2762.67796610169,1204.98305084746,54,60,114,100
"./Ship3_Latin-square/2019-09-30_12h54m_Subject 47639.txt","47639",2019-09-30,"12:54",2,80,60,11,9,20,19,3,3,25,7,4,4,15,760,138,119,1017,137.366666666667,120.583333333333,2901.64406779661,1721.30508474576,70,57,127,100
"./Ship3_Latin-square/2019-09-30_12h54m_Subject 47649.txt","47649",2019-09-30,"12:54",0,80,60,7,13,20,29,8,6,43,7,3,2,12,583,67,166,816,523.516666666667,105.833333333333,2999.91525423729,1795.83333333333,68,266,334,77.0491803278689
"./Ship3_Latin-square/2019-09-30_12h54m_Subject 47753.txt","47753",2019-09-30,"12:54",16,80,60,10,10,20,58,27,15,100,40,28,9,77,386,32,77,495,702.366666666667,217.633333333333,2186.40677966102,1923.76,90,104,194,86.8852459016393
"./Ship3_Latin-square/2019-09-30_12h54m_Subject 47758.txt","47758",2019-09-30,"12:54",4,82,60,11,11,22,9,1,1,11,15,0,16,31,945,181,259,1385,81.7333333333333,104.183333333333,2803.33898305085,1526.15254237288,77,65,142,100
"./Ship3_Latin-square/2019-09-30_12h54m_Subject 47759.txt","47759",2019-09-30,"12:54",4,78,60,8,10,18,20,2,3,25,23,2,13,38,622,59,155,836,300.683333333333,148.366666666667,2796.59322033898,1253.61016949153,35,40,75,100
"./Ship3_Latin-square/2019-09-30_12h54m_Subject 47776.txt","47776",2019-09-30,"12:54",24,80,60,11,9,20,35,1,9,45,54,22,6,82,743,18,160,921,181.683333333333,157.966666666667,1942.30508474576,846.518518518518,42,28,70,93.4426229508197
"./Ship3_Latin-square/2019-09-30_12h54m_Subject 47799.txt","47799",2019-09-30,"12:54",4,81,60,9,12,21,28,3,4,35,109,54,27,190,534,73,119,726,265.266666666667,243.65,2776.25423728814,1291.05172413793,51,28,79,98.3606557377049
"./Ship3_Latin-square/2019-09-30_14h02m_Subject 46876.txt","46876",2019-09-30,"14:02",2,77,60,7,10,17,26,2,4,32,3,1,3,7,676,80,121,877,162.083333333333,91,2891.47457627119,1595.72413793103,39,58,97,98.3606557377049
"./Ship3_Latin-square/2019-09-30_14h02m_Subject 46877.txt","46877",2019-09-30,"14:02",24,85,60,15,10,25,14,4,3,21,40,31,18,89,648,31,190,869,85.65,201.55,1982.98305084746,1099.88888888889,47,93,140,80.327868852459
"./Ship3_Latin-square/2019-09-30_14h02m_Subject 46893.txt","46893",2019-09-30,"14:02",24,78,60,11,7,18,49,0,8,57,109,36,4,149,762,21,124,907,154.716666666667,376.016666666667,1942.30508474576,763.052631578947,42,50,92,96.7213114754098
"./Ship3_Latin-square/2019-09-30_14h02m_Subject 46895.txt","46895",2019-09-30,"14:02",0,81,58,8,15,23,31,7,7,45,18,35,9,62,250,42,82,374,907.034482758621,176.310344827586,2999.87719298246,2356.575,35,136,171,86.4406779661017
"./Ship3_Latin-square/2019-09-30_14h02m_Subject 47638.txt","47638",2019-09-30,"14:02",24,77,57,14,6,20,99,18,13,130,51,26,7,84,221,14,20,255,1203,285.614035087719,2142.80357142857,1486.48148148148,99,16,115,94.8275862068966
"./Ship3_Latin-square/2019-09-30_14h02m_Subject 47757.txt","47757",2019-09-30,"14:02",4,80,60,12,8,20,67,12,9,88,55,11,5,71,305,58,57,420,1044.06666666667,242.75,2823.69491525424,2106.26785714286,72,92,164,95.0819672131148
"./Ship3_Latin-square/2019-09-30_14h02m_Subject 47769.txt","47769",2019-09-30,"14:02",2,81,60,10,11,21,17,2,2,21,57,14,11,82,711,114,135,960,213.083333333333,208.1,2894.8813559322,1833.62711864407,66,95,161,100
"./Ship3_Latin-square/2019-09-30_14h02m_Subject 47771.txt","47771",2019-09-30,"14:02",2,77,60,9,8,17,10,1,2,13,13,2,1,16,1143,167,168,1478,82.0166666666667,117.2,2898.22033898305,1266.52542372881,22,65,87,100
"./Ship3_Latin-square/2019-09-30_14h02m_Subject 47775.txt","47775",2019-09-30,"14:02",2,76,60,6,10,16,56,3,6,65,29,4,0,33,383,42,74,499,378.033333333333,135.6,2888.06779661017,1582.03448275862,43,46,89,98.3606557377049
"./Ship3_Latin-square/2019-09-30_14h02m_Subject 47781.txt","47781",2019-09-30,"14:02",0,80,60,10,10,20,5,0,0,5,53,9,4,66,1330,281,238,1849,59.0333333333333,160.166666666667,2999.93220338983,1434.86206896552,79,23,102,98.3606557377049
"./Ship3_Latin-square/2019-09-30_14h02m_Subject 47782.txt","47782",2019-09-30,"14:02",4,84,60,12,12,24,12,0,4,16,3,16,4,23,659,151,139,949,83.5166666666667,109.616666666667,2796.5593220339,1200.74576271186,23,41,64,100
"./Ship3_Latin-square/2019-09-30_14h02m_Subject 47783.txt","47783",2019-09-30,"14:02",0,80,60,10,10,20,57,10,9,76,37,9,7,53,481,65,79,625,996.633333333333,145.533333333333,2999.93220338983,2372.43103448276,45,52,97,98.3606557377049
"./Ship3_Latin-square/2019-09-30_14h02m_Subject 47785.txt","47785",2019-09-30,"14:02",0,80,60,7,13,20,8,0,3,11,82,3,8,93,1903,287,324,2514,138.733333333333,117.25,2999.96610169492,1734.84210526316,77,259,336,96.7213114754098
"./Ship3_Latin-square/2019-09-30_14h02m_Subject 47786.txt","47786",2019-09-30,"14:02",4,77,60,8,9,17,77,8,9,94,39,6,4,49,340,33,54,427,689.1,138.15,2789.76271186441,2389.74074074074,52,99,151,95.0819672131148
"./Ship3_Latin-square/2019-09-30_14h02m_Subject 47788.txt","47788",2019-09-30,"14:02",4,49,36,4,9,13,13,1,4,18,45,185,10,240,334,29,85,448,168.75,237.083333333333,2748.57142857143,1669.58333333333,22,58,80,100
"./Ship3_Latin-square/2019-09-30_14h06m_Subject 46888.txt","46888",2019-09-30,"14:06",0,80,60,9,11,20,7,0,0,7,60,9,3,72,937,136,177,1250,73.2833333333333,186.266666666667,2999.94915254237,1697.18965517241,45,74,119,98.3606557377049
"./Ship3_Latin-square/2019-09-30_14h06m_Subject 46889.txt","46889",2019-09-30,"14:06",0,77,60,4,13,17,10,0,2,12,20,2,19,41,1297,89,250,1636,74.6,143.9,2999.83050847458,1390.27586206897,43,142,185,98.3606557377049
"./Ship3_Latin-square/2019-09-30_14h06m_Subject 46890.txt","46890",2019-09-30,"14:06",4,82,59,10,13,23,33,2,2,37,1,1,4,6,365,93,75,533,960.655172413793,81.051724137931,2779.31034482759,2500.28205128205,48,118,166,79.6610169491525
"./Ship3_Latin-square/2019-09-30_14h06m_Subject 46892.txt","46892",2019-09-30,"14:06",24,76,53,15,8,23,70,18,58,146,47,28,7,82,310,22,57,389,835.320754716981,328.358490566038,2139.49056603774,2472.72727272727,68,101,169,85.1851851851852
"./Ship3_Latin-square/2019-09-30_14h06m_Subject 46898.txt","46898",2019-09-30,"14:06",4,75,60,6,9,15,34,0,5,39,24,2,5,31,701,65,81,847,232.883333333333,154.1,2776.15254237288,1621.13793103448,37,85,122,98.3606557377049
"./Ship3_Latin-square/2019-09-30_14h06m_Subject 47097.txt","47097",2019-09-30,"14:06",2,83,60,10,13,23,19,2,1,22,54,14,9,77,1018,138,237,1393,106.683333333333,190.95,2894.89830508475,1409.35593220339,52,82,134,100
"./Ship3_Latin-square/2019-09-30_14h06m_Subject 47099.txt","47099",2019-09-30,"14:06",24,81,60,15,6,21,60,13,3,76,33,36,16,85,549,5,72,626,376.666666666667,175.9,2105,1244.34782608696,32,64,96,83.6065573770492
"./Ship3_Latin-square/2019-09-30_14h06m_Subject 47798.txt","47798",2019-09-30,"14:06",24,67,48,13,6,19,43,8,4,55,16,16,2,34,124,1,33,158,917.765957446809,171.723404255319,2182.93617021277,4744.41176470588,59,39,98,77.0833333333333
"./Ship3_Latin-square/2019-09-30_15h13m_Subject 47080.txt","47080",2019-09-30,"15:13",0,81,60,7,14,21,9,0,2,11,22,2,4,28,1063,135,218,1416,73.35,103.283333333333,2999.89830508475,1344.375,41,98,139,96.7213114754098
"./Ship3_Latin-square/2019-09-30_15h13m_Subject 47089.txt","47089",2019-09-30,"15:13",2,82,60,13,9,22,28,2,2,32,70,16,18,104,375,71,49,495,801.45,208,2908.42372881356,1509.21818181818,56,41,97,95.0819672131148
"./Ship3_Latin-square/2019-09-30_15h13m_Subject 47762.txt","47762",2019-09-30,"15:13",24,67,49,13,5,18,49,11,10,70,37,21,6,64,148,9,19,176,1604.36734693878,478.102040816327,2167.32653061224,3371.52777777778,103,43,146,78
"./Ship3_Latin-square/2019-09-30_15h13m_Subject 47791.txt","47791",2019-09-30,"15:13",0,82,60,6,16,22,11,0,3,14,12,1,5,18,1013,142,273,1428,86.5166666666667,105.583333333333,2999.83050847458,1492.79661016949,53,32,85,100
"./Ship3_Latin-square/2019-10-01_10h03m_Subject 46884.txt","46884",2019-10-01,"10:03",4,70,52,11,7,18,46,8,6,60,41,13,1,55,207,29,23,259,1705.03846153846,290.192307692308,2830.73076923077,3269.25,87,63,150,71.6981132075472
"./Ship3_Latin-square/2019-10-01_10h03m_Subject 47083.txt","47083",2019-10-01,"10:03",0,79,59,6,14,20,59,1,12,72,33,8,15,56,376,32,94,502,1204.08474576271,166.067796610169,2999.87931034483,2517.625,78,78,156,96.6666666666667
"./Ship3_Latin-square/2019-10-01_10h03m_Subject 47086.txt","47086",2019-10-01,"10:03",8,79,60,10,9,19,17,4,0,21,1,0,1,2,483,74,89,646,301.15,88.8333333333333,2620.32203389831,1420.50877192982,92,53,145,100
"./Ship3_Latin-square/2019-10-01_10h03m_Subject 47246.txt","47246",2019-10-01,"10:03",4,77,60,7,10,17,7,4,3,14,11,1,0,12,455,49,88,592,145.566666666667,150.866666666667,2769.47457627119,2002.69642857143,45,106,151,98.3606557377049
"./Ship3_Latin-square/2019-10-01_10h03m_Subject 47635.txt","47635",2019-10-01,"10:03",24,86,60,13,13,26,82,6,26,114,43,16,14,73,280,1,129,410,352.016666666667,194.583333333333,1820.27118644068,1460.74576271186,67,25,92,100
"./Ship3_Latin-square/2019-10-01_10h03m_Subject 47779.txt","47779",2019-10-01,"10:03",24,37,27,7,3,10,61,7,7,75,24,21,3,48,36,7,4,47,5602.03846153846,250.192307692308,2261.5,6651.82608695652,52,19,71,88.8888888888889
"./Ship3_Latin-square/2019-10-01_10h03m_Subject 47790.txt","47790",2019-10-01,"10:03",16,60,43,11,6,17,58,10,39,107,25,11,3,39,189,26,13,228,2788.52380952381,235.190476190476,2314.19047619048,3501.05555555556,44,85,129,90.6976744186046
"./Ship3_Latin-square/2019-10-01_10h03m_Subject 47797.txt","47797",2019-10-01,"10:03",4,77,55,10,12,22,35,10,15,60,47,27,9,83,231,60,85,376,918.236363636364,321.6,2785.09259259259,2250.59183673469,19,111,130,91.0714285714286
"./Ship3_Latin-square/2019-10-01_10h06m_Subject 46878.txt","46878",2019-10-01,"10:06",8,80,60,9,11,20,11,2,3,16,4,11,8,23,846,140,147,1133,87.2,108.65,2579.54237288136,1450.22413793103,70,77,147,98.3606557377049
"./Ship3_Latin-square/2019-10-01_10h06m_Subject 46885.txt","46885",2019-10-01,"10:06",4,77,60,8,9,17,27,4,6,37,11,4,3,18,421,51,59,531,341.3,97.45,2803.38983050847,1907.32203389831,65,54,119,100
"./Ship3_Latin-square/2019-10-01_10h06m_Subject 46899.txt","46899",2019-10-01,"10:06",0,81,60,8,13,21,12,1,1,14,19,3,7,29,1069,150,250,1469,101.466666666667,106.916666666667,2999.89830508475,1019.5593220339,32,40,72,100
"./Ship3_Latin-square/2019-10-01_10h06m_Subject 47081.txt","47081",2019-10-01,"10:06",4,80,60,7,13,20,16,1,6,23,28,3,11,42,564,67,121,752,139.5,137.016666666667,2762.66101694915,1743.44827586207,56,84,140,98.3333333333333
"./Ship3_Latin-square/2019-10-01_10h06m_Subject 47091.txt","47091",2019-10-01,"10:06",0,77,60,5,12,17,22,1,2,25,52,7,6,65,348,28,76,452,316.45,161.483333333333,2999.93220338983,1886.62711864407,43,54,97,98.3606557377049
"./Ship3_Latin-square/2019-10-01_10h06m_Subject 47095.txt","47095",2019-10-01,"10:06",16,71,50,13,8,21,34,9,4,47,53,10,34,97,276,39,64,379,875.28,404.54,2295.94,2258.45652173913,39,55,94,92.156862745098
"./Ship3_Latin-square/2019-10-01_10h06m_Subject 47231.txt","47231",2019-10-01,"10:06",8,76,60,9,7,16,60,8,6,74,116,18,2,136,258,37,41,336,1187.06666666667,308.666666666667,2633.86440677966,1787.67924528302,49,58,107,90.1639344262295
"./Ship3_Latin-square/2019-10-01_10h06m_Subject 47238.txt","47238",2019-10-01,"10:06",0,81,60,10,11,21,13,1,0,14,41,13,10,64,664,120,102,886,138.516666666667,152.866666666667,2999.84745762712,1433.86206896552,26,53,79,98.3606557377049
"./Ship3_Latin-square/2019-10-01_10h06m_Subject 47242.txt","47242",2019-10-01,"10:06",0,80,60,6,14,20,28,2,9,39,24,5,36,65,636,66,165,867,165.566666666667,135.516666666667,2999.96610169492,1558.72413793103,73,49,122,98.3606557377049
"./Ship3_Latin-square/2019-10-01_10h06m_Subject 47244.txt","47244",2019-10-01,"10:06",4,78,60,7,11,18,11,1,0,12,58,10,11,79,741,100,151,992,149.633333333333,256.516666666667,2783.03389830508,1595.71186440678,70,108,178,100
"./Ship3_Latin-square/2019-10-01_10h06m_Subject 47633.txt","47633",2019-10-01,"10:06",8,80,60,12,8,20,28,23,5,56,55,21,10,86,466,64,77,607,600.333333333333,177.183333333333,2660.98305084746,1568.85714285714,89,110,199,96.7213114754098
"./Ship3_Latin-square/2019-10-01_10h06m_Subject 47636.txt","47636",2019-10-01,"10:06",24,52,38,12,2,14,101,31,6,138,100,28,2,130,140,19,7,166,2546.62162162162,833.837837837838,2416.16216216216,3207.7027027027,94,26,120,100
"./Ship3_Latin-square/2019-10-01_10h06m_Subject 47752.txt","47752",2019-10-01,"10:06",0,80,60,9,11,20,45,5,4,54,16,9,8,33,939,119,205,1263,292.816666666667,89.9166666666667,2999.8813559322,1325.13559322034,46,55,101,100
"./Ship3_Latin-square/2019-10-01_10h06m_Subject 47767.txt","47767",2019-10-01,"10:06",0,83,60,10,13,23,25,0,2,27,70,6,9,85,371,77,73,521,449.616666666667,198.65,2999.89830508475,1649.2,41,61,102,95.0819672131148
"./Ship3_Latin-square/2019-10-01_10h06m_Subject 47768.txt","47768",2019-10-01,"10:06",24,73,53,12,8,20,67,11,12,90,48,19,10,77,153,5,36,194,1068.33962264151,182.057692307692,1984.55769230769,2316.08888888889,47,65,112,88.6792452830189
"./Ship3_Latin-square/2019-10-01_10h06m_Subject 47780.txt","47780",2019-10-01,"10:06",16,79,60,8,11,19,54,13,5,72,79,12,8,99,251,18,95,364,590.533333333333,420.433333333333,2159.32203389831,1808.03703703704,60,57,117,95.0819672131148
"./Ship3_Latin-square/2019-10-01_11h15m_Subject 46900.txt","46900",2019-10-01,"11:15",2,79,60,5,14,19,6,0,3,9,111,11,23,145,1127,108,311,1546,90.5166666666667,195.016666666667,2871.10169491525,1214,21,85,106,100
"./Ship3_Latin-square/2019-10-01_11h15m_Subject 46986.txt","46986",2019-10-01,"11:15",8,80,60,11,9,20,40,1,9,50,16,2,2,20,311,43,50,404,717.65,162.95,2633.8813559322,1861.58695652174,96,82,178,86.8852459016393
"./Ship3_Latin-square/2019-10-01_11h15m_Subject 47076.txt","47076",2019-10-01,"11:15",0,81,60,9,12,21,4,0,2,6,15,0,3,18,1289,208,275,1772,46.5666666666667,103.05,2999.93220338983,1452.55172413793,52,104,156,98.3606557377049
"./Ship3_Latin-square/2019-10-01_11h15m_Subject 47079.txt","47079",2019-10-01,"11:15",4,75,60,8,7,15,21,3,2,26,45,12,4,61,321,57,23,401,444.333333333333,207.616666666667,2796.5593220339,1970.39655172414,53,37,90,100
"./Ship3_Latin-square/2019-10-01_11h15m_Subject 47082.txt","47082",2019-10-01,"11:15",0,79,60,8,11,19,38,2,1,41,24,5,14,43,293,36,56,385,525.7,127.333333333333,2999.89830508475,2186.41509433962,52,73,125,93.4426229508197
"./Ship3_Latin-square/2019-10-01_11h15m_Subject 47092.txt","47092",2019-10-01,"11:15",4,80,60,9,11,20,17,5,2,24,25,5,2,32,979,160,189,1328,85.7333333333333,165.066666666667,2789.76271186441,1510.72881355932,73,95,168,100
"./Ship3_Latin-square/2019-10-01_11h15m_Subject 47098.txt","47098",2019-10-01,"11:15",2,86,60,12,14,26,18,4,1,23,11,45,21,77,369,57,112,538,256.666666666667,148.916666666667,2894.84745762712,1401.12280701754,34,52,86,98.3606557377049
"./Ship3_Latin-square/2019-10-01_11h15m_Subject 47226.txt","47226",2019-10-01,"11:15",0,79,60,8,11,19,14,1,0,15,35,8,11,54,2970,423,408,3801,126.183333333333,90.55,2999.89830508475,1249.50847457627,25,34,59,100
"./Ship3_Latin-square/2019-10-01_11h15m_Subject 47227.txt","47227",2019-10-01,"11:15",0,79,60,4,15,19,30,1,5,36,12,3,8,23,502,60,114,676,426.7,106.583333333333,2999.91525423729,1906.73076923077,33,126,159,88.5245901639344
"./Ship3_Latin-square/2019-10-01_11h15m_Subject 47250.txt","47250",2019-10-01,"11:15",0,80,60,8,12,20,17,3,1,21,7,5,5,17,1045,147,230,1422,102.05,85.8833333333333,2999.86440677966,1436.38983050847,50,41,91,100
"./Ship3_Latin-square/2019-10-01_11h15m_Subject 47645.txt","47645",2019-10-01,"11:15",8,79,58,11,10,21,71,10,17,98,15,13,5,33,286,42,73,401,830.362068965517,146.758620689655,2592.94736842105,2507.01960784314,96,78,174,91.5254237288136
"./Ship3_Latin-square/2019-10-01_11h15m_Subject 47646.txt","47646",2019-10-01,"11:15",0,79,60,5,14,19,27,0,0,27,54,16,22,92,1890,116,357,2363,353.133333333333,113.366666666667,2999.93220338983,1800,16,154,170,95.0819672131148
"./Ship3_Latin-square/2019-10-01_11h15m_Subject 47755.txt","47755",2019-10-01,"11:15",0,82,60,12,10,22,25,5,6,36,33,18,7,58,742,136,112,990,149.666666666667,237.833333333333,2999.86440677966,1952.69491525424,105,132,237,100
"./Ship3_Latin-square/2019-10-01_11h15m_Subject 47760.txt","47760",2019-10-01,"11:15",4,80,60,9,11,20,15,6,3,24,28,15,8,51,1051,141,219,1411,92.4166666666667,154.766666666667,2796.5593220339,1213.08474576271,31,63,94,100
"./Ship3_Latin-square/2019-10-01_11h15m_Subject 47770.txt","47770",2019-10-01,"11:15",8,44,33,7,4,11,53,10,7,70,73,9,2,84,129,22,13,164,3453.65625,607.40625,2674.96875,6195.1724137931,76,49,125,90.9090909090909
"./Ship3_Latin-square/2019-10-01_11h15m_Subject 47795.txt","47795",2019-10-01,"11:15",0,81,60,8,13,21,25,3,3,31,21,15,11,47,485,44,86,615,195.85,134.466666666667,2999.86440677966,2303.54385964912,43,55,98,96.7213114754098
"./Ship3_Latin-square/2019-10-01_11h19m_Subject 47229.txt","47229",2019-10-01,"11:19",0,75,60,3,12,15,16,1,0,17,26,1,1,28,1011,33,177,1221,78.4166666666667,162.016666666667,2999.83050847458,1437.62068965517,35,100,135,98.3606557377049
"./Ship3_Latin-square/2019-10-01_11h19m_Subject 47233.txt","47233",2019-10-01,"11:19",4,82,60,10,12,22,14,3,7,24,35,10,8,53,415,71,86,572,124.75,157.083333333333,2783,1527.41818181818,44,99,143,93.4426229508197
"./Ship3_Latin-square/2019-10-01_11h19m_Subject 47234.txt","47234",2019-10-01,"11:19",8,82,60,13,9,22,40,3,5,48,26,11,6,43,523,89,96,708,216.65,170.266666666667,2633.8813559322,1411.14545454545,57,68,125,95.0819672131148
"./Ship3_Latin-square/2019-10-01_11h19m_Subject 47237.txt","47237",2019-10-01,"11:19",0,78,60,8,10,18,10,0,3,13,13,0,17,30,795,106,154,1055,94.2833333333333,151.233333333333,2999.94915254237,1040,28,16,44,100
"./Ship3_Latin-square/2019-10-01_11h19m_Subject 47241.txt","47241",2019-10-01,"11:19",4,79,60,8,11,19,15,1,5,21,7,11,1,19,1049,144,157,1350,82.7166666666667,89.35,2769.45762711864,1431.23728813559,35,75,110,100
"./Ship3_Latin-square/2019-10-01_11h19m_Subject 47247.txt","47247",2019-10-01,"11:19",0,78,60,9,9,18,18,1,0,19,26,1,0,27,397,62,57,516,265.916666666667,177.783333333333,2999.93220338983,1782.86538461538,62,81,143,95.0819672131148
"./Ship3_Latin-square/2019-10-01_11h19m_Subject 47777.txt","47777",2019-10-01,"11:19",2,77,60,5,12,17,36,2,33,71,66,14,7,87,453,23,89,565,350.25,268.5,2881.32203389831,2281.625,46,126,172,96.7213114754098
"./Ship3_Latin-square/2019-10-01_11h19m_Subject 47784.txt","47784",2019-10-01,"11:19",0,76,60,3,13,16,26,5,7,38,67,1,25,93,1441,124,246,1811,96.5666666666667,223.75,2999.8813559322,1248.35593220339,42,129,171,100
"./Ship3_Latin-square/2019-10-01_12h26m_Subject 46881.txt","46881",2019-10-01,"12:26",0,74,60,4,10,14,7,3,0,10,43,4,4,51,1018,72,201,1291,142.716666666667,153.366666666667,2999.89830508475,1812.07142857143,40,120,160,96.7213114754098
"./Ship3_Latin-square/2019-10-01_12h26m_Subject 47087.txt","47087",2019-10-01,"12:26",0,81,60,9,12,21,28,2,2,32,29,12,5,46,358,49,67,474,175.216666666667,136.233333333333,2999.89830508475,1775.61016949153,38,41,79,100
"./Ship3_Latin-square/2019-10-01_12h26m_Subject 47626.txt","47626",2019-10-01,"12:26",2,80,60,6,14,20,11,0,3,14,56,10,6,72,310,36,93,439,230.583333333333,190.133333333333,2874.57627118644,2238.48936170213,75,96,171,90.1639344262295
"./Ship3_Latin-square/2019-10-01_12h26m_Subject 47632.txt","47632",2019-10-01,"12:26",0,80,60,7,13,20,20,1,6,27,15,6,8,29,1097,127,224,1448,340.633333333333,114.3,2999.89830508475,1336.89830508475,34,59,93,100
"./Ship3_Latin-square/2019-10-01_12h26m_Subject 47634.txt","47634",2019-10-01,"12:26",0,81,60,11,10,21,36,5,6,47,25,4,1,30,384,67,55,506,417.7,160.033333333333,2999.91525423729,2128.13725490196,105,30,135,90.1639344262295
"./Ship3_Latin-square/2019-10-01_12h26m_Subject 47640.txt","47640",2019-10-01,"12:26",0,81,60,10,11,21,30,4,6,40,12,6,7,25,622,69,119,810,507.983333333333,132.6,2999.94915254237,1950.56363636364,20,49,69,93.4426229508197
"./Ship3_Latin-square/2019-10-01_12h26m_Subject 47800.txt","47800",2019-10-01,"12:26",2,82,60,8,14,22,43,6,6,55,42,7,15,64,304,38,57,399,527.85,187.5,2881.35593220339,2412.89830508475,54,78,132,100
"./Ship3_Latin-square/2019-10-01_12h32m_Subject 46880.txt","46880",2019-10-01,"12:32",0,81,60,2,19,21,15,0,0,15,15,0,15,30,964,27,299,1290,98.6,121.05,2999.8813559322,2153.15384615385,55,464,519,73.7704918032787
"./Ship3_Latin-square/2019-10-01_12h32m_Subject 46882.txt","46882",2019-10-01,"12:32",2,80,60,6,14,20,27,1,1,29,80,4,41,125,857,101,270,1228,187.433333333333,186.366666666667,2874.5593220339,2206.23404255319,44,299,343,86.8852459016393
"./Ship3_Latin-square/2019-10-01_12h32m_Subject 46883.txt","46883",2019-10-01,"12:32",0,80,60,7,13,20,25,2,1,28,18,4,6,28,607,65,134,806,126.15,138.933333333333,2999.8813559322,1483.22413793103,18,67,85,100
"./Ship3_Latin-square/2019-10-01_12h32m_Subject 46894.txt","46894",2019-10-01,"12:32",4,80,60,9,11,20,31,2,4,37,14,2,5,21,533,95,79,707,521.45,109.35,2783.01694915254,1890.11111111111,71,38,109,93.4426229508197
"./Ship3_Latin-square/2019-10-01_12h32m_Subject 46896.txt","46896",2019-10-01,"12:32",24,76,60,8,8,16,22,3,4,29,28,18,7,53,476,14,101,591,149.55,128.483333333333,1820.30508474576,1037.60714285714,28,37,65,95.0819672131148
"./Ship3_Latin-square/2019-10-01_12h32m_Subject 47088.txt","47088",2019-10-01,"12:32",16,78,60,9,9,18,41,7,12,60,82,22,20,124,390,69,90,549,398.116666666667,328.033333333333,2186.35593220339,1261.89285714286,31,79,110,95.0819672131148
"./Ship3_Latin-square/2019-10-01_12h32m_Subject 47228.txt","47228",2019-10-01,"12:32",4,77,60,9,8,17,20,0,4,24,18,7,6,31,532,96,76,704,185.4,90.8666666666667,2796.61016949153,1529.75,39,69,108,96.7213114754098
"./Ship3_Latin-square/2019-10-01_12h32m_Subject 47243.txt","47243",2019-10-01,"12:32",4,78,60,9,9,18,27,7,4,38,28,10,4,42,918,126,173,1217,107.7,191.5,2796.54237288136,1266.05084745763,91,76,167,100
"./Ship3_Latin-square/2019-10-01_12h32m_Subject 47249.txt","47249",2019-10-01,"12:32",16,78,60,11,7,18,58,3,14,75,69,36,14,119,245,34,33,312,533.766666666667,328.05,2321.91525423729,1761.80701754386,60,50,110,96.7213114754098
"./Ship3_Latin-square/2019-10-01_12h32m_Subject 47639.txt","47639",2019-10-01,"12:32",24,62,48,10,4,14,63,7,6,76,59,22,6,87,194,4,10,208,1824.35416666667,1014.35416666667,2131.91489361702,2287.025,66,35,101,85.4166666666667
"./Ship3_Latin-square/2019-10-01_12h32m_Subject 47649.txt","47649",2019-10-01,"12:32",4,77,58,7,12,19,51,3,4,58,12,6,5,23,431,36,155,622,1007.66666666667,118.701754385965,2768.35087719298,2108.55882352941,120,144,264,77.5862068965517
"./Ship3_Latin-square/2019-10-01_12h32m_Subject 47753.txt","47753",2019-10-01,"12:32",8,82,60,11,11,22,40,29,7,76,22,7,7,36,474,57,138,669,459.133333333333,228.7,2606.72881355932,1772.0612244898,73,156,229,88.5245901639344
"./Ship3_Latin-square/2019-10-01_12h32m_Subject 47758.txt","47758",2019-10-01,"12:32",16,85,60,14,11,25,8,0,2,10,18,3,4,25,790,92,201,1083,74.5333333333333,115.516666666667,2294.8813559322,949.220338983051,54,41,95,100
"./Ship3_Latin-square/2019-10-01_12h32m_Subject 47759.txt","47759",2019-10-01,"12:32",16,81,60,14,7,21,60,11,1,72,48,19,4,71,396,34,119,549,456.966666666667,206.283333333333,2349.08474576271,1343.50877192982,43,45,88,96.7213114754098
"./Ship3_Latin-square/2019-10-01_12h32m_Subject 47776.txt","47776",2019-10-01,"12:32",4,81,60,12,9,21,14,4,1,19,52,18,9,79,1044,180,173,1397,88.4333333333333,158.266666666667,2823.67796610169,1171.62711864407,33,27,60,100
"./Ship3_Latin-square/2019-10-01_12h32m_Subject 47799.txt","47799",2019-10-01,"12:32",16,78,57,10,11,21,55,8,12,75,79,34,13,126,140,16,39,195,877.789473684211,547.105263157895,2157.85964912281,2843.65306122449,71,47,118,89.6551724137931
"./Ship3_Latin-square/2019-10-01_13h39m_Subject 46888.txt","46888",2019-10-01,"13:39",2,80,60,9,11,20,8,0,4,12,57,17,8,82,752,123,135,1010,114.05,179.45,2898.28813559322,1767.44827586207,55,58,113,98.3606557377049
"./Ship3_Latin-square/2019-10-01_13h39m_Subject 46889.txt","46889",2019-10-01,"13:39",4,80,60,5,15,20,11,0,1,12,15,0,12,27,1005,102,276,1383,99.9833333333333,120.883333333333,2749.10169491525,1689.01785714286,60,142,202,96.7213114754098
"./Ship3_Latin-square/2019-10-01_13h39m_Subject 46890.txt","46890",2019-10-01,"13:39",24,83,60,14,9,23,51,2,5,58,12,2,6,20,181,2,53,236,1017.41666666667,149.683333333333,1901.67796610169,2559.73684210526,54,55,109,72.1311475409836
"./Ship3_Latin-square/2019-10-01_13h39m_Subject 46892.txt","46892",2019-10-01,"13:39",4,78,60,5,13,18,11,1,1,13,3,0,2,5,939,69,224,1232,84.7,90.7333333333333,2749.13559322034,1244.86440677966,64,66,130,100
"./Ship3_Latin-square/2019-10-01_13h39m_Subject 46898.txt","46898",2019-10-01,"13:39",16,84,59,14,11,25,46,9,5,60,35,8,7,50,467,60,67,594,793.813559322034,308.457627118644,2267.74576271186,2043.52,32,101,133,91.6666666666667
"./Ship3_Latin-square/2019-10-01_13h39m_Subject 47097.txt","47097",2019-10-01,"13:39",0,78,60,8,10,18,10,0,0,10,57,11,10,78,866,129,128,1123,70.8333333333333,192.266666666667,2999.76271186441,1562.75862068966,49,86,135,98.3606557377049
"./Ship3_Latin-square/2019-10-01_13h39m_Subject 47099.txt","47099",2019-10-01,"13:39",4,79,60,9,10,19,5,2,1,8,86,9,11,106,1185,151,208,1544,53.1833333333333,237.233333333333,2796.5593220339,1082.54237288136,32,89,121,100
"./Ship3_Latin-square/2019-10-01_13h39m_Subject 47798.txt","47798",2019-10-01,"13:39",8,81,60,8,13,21,17,3,5,25,15,5,1,21,247,27,44,318,320.933333333333,121.4,2525.35593220339,1662.45945945946,44,104,148,83.6065573770492
"./Ship3_Latin-square/2019-10-01_13h42m_Subject 46876.txt","46876",2019-10-01,"13:42",0,75,60,5,10,15,15,0,1,16,9,2,6,17,883,78,130,1091,118.583333333333,91.35,2999.89830508475,1542.94736842105,29,113,142,100
"./Ship3_Latin-square/2019-10-01_13h42m_Subject 46877.txt","46877",2019-10-01,"13:42",8,80,60,10,10,20,19,5,2,26,47,18,8,73,1193,187,244,1624,68.5666666666667,195.5,2593.16949152542,1032.81355932203,43,72,115,100
"./Ship3_Latin-square/2019-10-01_13h42m_Subject 46893.txt","46893",2019-10-01,"13:42",4,75,60,7,8,15,9,0,1,10,76,13,9,98,1437,158,194,1789,43,174.283333333333,2796.59322033898,1301.98305084746,110,118,228,100
"./Ship3_Latin-square/2019-10-01_13h42m_Subject 46895.txt","46895",2019-10-01,"13:42",4,82,60,12,10,22,36,6,8,50,18,5,4,27,166,43,27,236,865.55,156.933333333333,2816.89830508475,2448.84782608696,39,63,102,86.8852459016393
"./Ship3_Latin-square/2019-10-01_13h42m_Subject 47638.txt","47638",2019-10-01,"13:42",4,78,60,11,7,18,52,8,3,63,22,4,1,27,425,65,43,533,481.266666666667,119.083333333333,2810.06779661017,1830.15254237288,55,20,75,98.3606557377049
"./Ship3_Latin-square/2019-10-01_13h42m_Subject 47757.txt","47757",2019-10-01,"13:42",16,60,45,10,5,15,96,22,8,126,64,34,5,103,185,32,35,252,1773.04545454545,320.636363636364,2381.81818181818,2184.29268292683,52,74,126,93.3333333333333
"./Ship3_Latin-square/2019-10-01_13h42m_Subject 47769.txt","47769",2019-10-01,"13:42",24,87,60,17,10,27,98,10,26,134,56,37,17,110,424,21,55,500,652.65,260.5,2064.30508474576,1464.32692307692,72,87,159,88.5245901639344
"./Ship3_Latin-square/2019-10-01_13h42m_Subject 47771.txt","47771",2019-10-01,"13:42",24,83,60,13,10,23,33,5,10,48,33,23,28,84,399,7,87,493,147.083333333333,152.866666666667,1860.98305084746,1223.325,34,96,130,73.7704918032787
"./Ship3_Latin-square/2019-10-01_13h42m_Subject 47775.txt","47775",2019-10-01,"13:42",24,81,60,13,8,21,109,30,20,159,70,16,5,91,205,8,45,258,787.283333333333,237.966666666667,2023.69491525424,1949.62745098039,76,69,145,88.5245901639344
"./Ship3_Latin-square/2019-10-01_13h42m_Subject 47781.txt","47781",2019-10-01,"13:42",2,82,60,9,13,22,8,0,0,8,39,12,14,65,1214,191,355,1760,92.0166666666667,203.55,2888.1186440678,1417.72413793103,53,79,132,98.3606557377049
"./Ship3_Latin-square/2019-10-01_13h42m_Subject 47782.txt","47782",2019-10-01,"13:42",16,82,60,10,12,22,15,1,2,18,4,4,1,9,600,61,106,767,128.783333333333,92.5,2186.35593220339,1233.43636363636,41,87,128,96.7213114754098
"./Ship3_Latin-square/2019-10-01_13h42m_Subject 47783.txt","47783",2019-10-01,"13:42",2,81,60,9,12,21,47,13,12,72,48,6,8,62,846,90,216,1152,715.416666666667,144.416666666667,2891.47457627119,2144.32203389831,48,111,159,100
"./Ship3_Latin-square/2019-10-01_13h42m_Subject 47785.txt","47785",2019-10-01,"13:42",2,82,60,10,12,22,26,0,2,28,49,21,32,102,1604,250,255,2109,166.033333333333,112.55,2894.89830508475,1570.52542372881,54,117,171,98.3606557377049
"./Ship3_Latin-square/2019-10-01_13h42m_Subject 47786.txt","47786",2019-10-01,"13:42",16,81,60,13,8,21,77,10,7,94,68,19,3,90,161,14,35,210,975.677966101695,228.101694915254,2294.81355932203,3164.61363636364,85,63,148,80
"./Ship3_Latin-square/2019-10-01_13h42m_Subject 47788.txt","47788",2019-10-01,"13:42",16,79,60,8,11,19,63,4,11,78,61,20,15,96,361,47,87,495,648.5,196.716666666667,2159.28813559322,1678.85454545455,32,89,121,95.0819672131148
"./Ship3_Latin-square/2019-10-01_14h44m_Subject 47080.txt","47080",2019-10-01,"14:44",2,80,60,9,11,20,11,0,1,12,20,28,3,51,904,141,138,1183,85.5,135.083333333333,2891.4406779661,1480.82142857143,46,102,148,98.3606557377049
"./Ship3_Latin-square/2019-10-01_14h44m_Subject 47089.txt","47089",2019-10-01,"14:44",0,80,60,9,11,20,22,1,1,24,52,8,16,76,489,72,109,670,168.7,181.85,2999.8813559322,1219,51,28,79,98.3606557377049
"./Ship3_Latin-square/2019-10-01_14h44m_Subject 47762.txt","47762",2019-10-01,"14:44",8,79,60,10,9,19,35,2,3,40,21,4,1,26,303,36,70,409,420.883333333333,181.833333333333,2620.30508474576,1819.13636363636,67,107,174,90.1639344262295
"./Ship3_Latin-square/2019-10-01_14h44m_Subject 47791.txt","47791",2019-10-01,"14:44",4,80,60,7,13,20,4,0,0,4,21,17,2,40,890,114,186,1190,52.4166666666667,150.833333333333,2762.69491525424,1234.96610169492,38,21,59,100
"./Ship3_Latin-square/2019-10-02_10h08m_Subject 46878.txt","46878",2019-10-02,"10:08",0,77,60,6,11,17,8,0,1,9,8,5,7,20,1102,112,170,1384,83.75,131.7,2999.93220338983,1577.57627118644,68,58,126,100
"./Ship3_Latin-square/2019-10-02_10h08m_Subject 46885.txt","46885",2019-10-02,"10:08",2,78,60,8,10,18,56,4,4,64,25,8,2,35,330,35,51,416,662.6,147.716666666667,2894.86440677966,2067.43859649123,62,81,143,96.7213114754098
"./Ship3_Latin-square/2019-10-02_10h08m_Subject 46899.txt","46899",2019-10-02,"10:08",4,78,60,8,10,18,6,0,2,8,26,13,3,42,847,132,171,1150,84.7666666666667,123.983333333333,2796.5593220339,1091.25423728814,36,39,75,100
"./Ship3_Latin-square/2019-10-02_10h08m_Subject 47081.txt","47081",2019-10-02,"10:08",16,81,60,12,9,21,17,5,6,28,26,12,19,57,527,38,93,658,131.5,179.216666666667,2321.96610169492,1304.83928571429,45,89,134,96.7213114754098
"./Ship3_Latin-square/2019-10-02_10h08m_Subject 47091.txt","47091",2019-10-02,"10:08",4,82,60,9,13,22,13,1,1,15,62,13,11,86,336,49,72,457,173.916666666667,206.9,2783,1666.08771929825,38,48,86,96.7213114754098
"./Ship3_Latin-square/2019-10-02_10h08m_Subject 47095.txt","47095",2019-10-02,"10:08",8,80,59,13,8,21,27,7,5,39,31,15,27,73,323,62,58,443,675.913793103448,184.034482758621,2655.12068965517,2264.64912280702,42,44,86,98.3050847457627
"./Ship3_Latin-square/2019-10-02_10h08m_Subject 47231.txt","47231",2019-10-02,"10:08",0,80,60,4,16,20,57,4,15,76,29,3,6,38,358,25,95,478,870.35,138.233333333333,2999.94915254237,1391.9298245614,21,49,70,98.3606557377049
"./Ship3_Latin-square/2019-10-02_10h08m_Subject 47238.txt","47238",2019-10-02,"10:08",2,82,60,11,11,22,9,0,2,11,43,13,13,69,485,84,100,669,289.4,261.816666666667,2898.27118644068,1683.16071428571,43,59,102,95.0819672131148
"./Ship3_Latin-square/2019-10-02_10h08m_Subject 47242.txt","47242",2019-10-02,"10:08",2,80,60,6,14,20,28,2,6,36,25,6,8,39,694,93,187,974,160.183333333333,142.9,2874.5593220339,1234.55172413793,51,46,97,98.3606557377049
"./Ship3_Latin-square/2019-10-02_10h08m_Subject 47244.txt","47244",2019-10-02,"10:08",2,84,60,10,14,24,14,1,5,20,73,18,22,113,853,140,199,1192,153.433333333333,256.733333333333,2881.27118644068,1695.52542372881,45,104,149,100
"./Ship3_Latin-square/2019-10-02_10h08m_Subject 47633.txt","47633",2019-10-02,"10:08",0,78,60,8,10,18,44,2,3,49,52,11,12,75,513,70,81,664,298.4,164.1,3000,1865.93220338983,97,70,167,100
"./Ship3_Latin-square/2019-10-02_10h08m_Subject 47636.txt","47636",2019-10-02,"10:08",8,79,60,5,14,19,51,3,15,69,72,10,26,108,310,38,50,398,755.466666666667,255.733333333333,2498.25423728814,2688.68965517241,73,130,203,98.3606557377049
"./Ship3_Latin-square/2019-10-02_10h08m_Subject 47752.txt","47752",2019-10-02,"10:08",4,82,60,10,12,22,36,7,7,50,29,35,5,69,548,128,94,770,674.816666666667,140.25,2796.54237288136,1786.70175438596,53,59,112,96.7213114754098
"./Ship3_Latin-square/2019-10-02_10h08m_Subject 47767.txt","47767",2019-10-02,"10:08",2,84,60,13,11,24,14,4,5,23,64,18,7,89,317,91,59,467,197.466666666667,403.016666666667,2898.28813559322,1708.18867924528,64,64,128,91.8032786885246
"./Ship3_Latin-square/2019-10-02_10h08m_Subject 47768.txt","47768",2019-10-02,"10:08",8,84,60,11,13,24,24,8,9,41,23,7,21,51,409,77,169,655,351.75,168.933333333333,2566.05084745763,1907.12727272727,68,73,141,93.4426229508197
"./Ship3_Latin-square/2019-10-02_10h08m_Subject 47780.txt","47780",2019-10-02,"10:08",24,82,60,11,11,22,65,10,19,94,37,12,6,55,328,11,133,472,373.433333333333,167.633333333333,1779.57627118644,958.779661016949,37,42,79,100
"./Ship3_Latin-square/2019-10-02_10h22m_Subject 46884.txt","46884",2019-10-02,"10:22",2,78,60,8,10,18,32,0,2,34,32,7,3,42,275,44,32,351,420.216666666667,215.516666666667,2894.83050847458,2874.13888888889,139,86,225,72.1311475409836
"./Ship3_Latin-square/2019-10-02_10h22m_Subject 47083.txt","47083",2019-10-02,"10:22",4,80,60,5,15,20,70,16,8,94,26,2,13,41,357,24,109,490,1040.63333333333,184.983333333333,2742.32203389831,2326.07142857143,85,94,179,95.0819672131148
"./Ship3_Latin-square/2019-10-02_10h22m_Subject 47086.txt","47086",2019-10-02,"10:22",4,77,60,9,8,17,22,5,2,29,9,3,0,12,629,83,87,799,175.066666666667,103.166666666667,2796.54237288136,1244.32203389831,32,39,71,100
"./Ship3_Latin-square/2019-10-02_10h22m_Subject 47246.txt","47246",2019-10-02,"10:22",2,80,60,7,13,20,32,1,5,38,12,2,6,20,363,54,98,515,320.25,138.516666666667,2877.93220338983,2239.22222222222,28,128,156,93.4426229508197
"./Ship3_Latin-square/2019-10-02_10h22m_Subject 47635.txt","47635",2019-10-02,"10:22",8,78,60,9,9,18,28,6,2,36,44,11,4,59,432,74,80,586,226.083333333333,195.883333333333,2606.72881355932,1695.22033898305,78,45,123,100
"./Ship3_Latin-square/2019-10-02_10h22m_Subject 47779.txt","47779",2019-10-02,"10:22",8,57,44,6,7,13,58,10,9,77,63,12,10,85,84,13,15,112,2899.59090909091,336.795454545455,2590.6511627907,3533.71052631579,58,32,90,90.9090909090909
"./Ship3_Latin-square/2019-10-02_10h22m_Subject 47790.txt","47790",2019-10-02,"10:22",8,56,40,9,7,16,57,7,74,138,32,10,7,49,105,35,18,158,2905.25641025641,301.871794871795,2651.25641025641,4608.03703703704,68,129,197,82.5
"./Ship3_Latin-square/2019-10-02_10h22m_Subject 47797.txt","47797",2019-10-02,"10:22",16,73,55,12,6,18,63,12,6,81,40,18,5,63,181,30,19,230,1427.18181818182,228.854545454545,2288.87037037037,2723.42553191489,21,84,105,87.5
"./Ship3_Latin-square/2019-10-02_11h25m_Subject 46900.txt","46900",2019-10-02,"11:25",0,74,60,6,8,14,7,0,0,7,65,4,34,103,1386,100,223,1709,92.7,159.416666666667,2999.89830508475,887.338983050847,19,30,49,100
"./Ship3_Latin-square/2019-10-02_11h25m_Subject 46986.txt","46986",2019-10-02,"11:25",4,67,49,8,10,18,41,3,7,51,12,6,4,22,193,26,36,255,1320.10416666667,163.833333333333,2783.3125,3990,52,80,132,77.5510204081633
"./Ship3_Latin-square/2019-10-02_11h25m_Subject 47076.txt","47076",2019-10-02,"11:25",2,79,60,8,11,19,5,1,1,7,11,6,2,19,1094,123,211,1428,92.9666666666667,104.766666666667,2894.86440677966,1620.06896551724,70,82,152,98.3606557377049
"./Ship3_Latin-square/2019-10-02_11h25m_Subject 47079.txt","47079",2019-10-02,"11:25",2,76,60,6,10,16,11,1,2,14,52,9,7,68,434,56,86,576,196.966666666667,220.283333333333,2894.86440677966,1596.50847457627,41,48,89,100
"./Ship3_Latin-square/2019-10-02_11h25m_Subject 47082.txt","47082",2019-10-02,"11:25",2,84,60,11,13,24,27,2,5,34,22,0,28,50,306,50,88,444,454.983333333333,123.25,2891.45762711864,1771.23913043478,71,94,165,90.1639344262295
"./Ship3_Latin-square/2019-10-02_11h25m_Subject 47092.txt","47092",2019-10-02,"11:25",2,79,60,9,10,19,19,1,2,22,47,4,5,56,1028,140,176,1344,92.8833333333333,283.583333333333,2894.86440677966,1587.83050847458,62,88,150,100
"./Ship3_Latin-square/2019-10-02_11h25m_Subject 47098.txt","47098",2019-10-02,"11:25",0,82,60,9,13,22,10,4,0,14,8,0,0,8,460,75,102,637,191.233333333333,104.8,2999.89830508475,1400.78181818182,25,67,92,93.4426229508197
"./Ship3_Latin-square/2019-10-02_11h25m_Subject 47226.txt","47226",2019-10-02,"11:25",2,80,60,9,11,20,11,2,0,13,55,12,13,80,2595,546,543,3684,138.05,214.25,2894.83050847458,1144.67796610169,19,34,53,100
"./Ship3_Latin-square/2019-10-02_11h25m_Subject 47227.txt","47227",2019-10-02,"11:25",2,79,60,4,15,19,51,1,4,56,16,6,7,29,496,21,138,655,684.316666666667,123.333333333333,2861,2028.58695652174,44,154,198,83.6065573770492
"./Ship3_Latin-square/2019-10-02_11h25m_Subject 47250.txt","47250",2019-10-02,"11:25",2,85,60,10,15,25,15,1,2,18,23,12,10,45,959,199,236,1394,98.2333333333333,97.0666666666667,2884.72881355932,1422.81355932203,43,43,86,100
"./Ship3_Latin-square/2019-10-02_11h25m_Subject 47645.txt","47645",2019-10-02,"11:25",4,74,53,9,12,21,105,12,12,129,8,3,6,17,221,47,82,350,1528.98113207547,133.924528301887,2776.88461538462,3411.61363636364,73,97,170,88.8888888888889
"./Ship3_Latin-square/2019-10-02_11h25m_Subject 47646.txt","47646",2019-10-02,"11:25",2,81,60,9,12,21,18,1,2,21,88,28,24,140,1395,206,292,1893,209.683333333333,123.85,2884.69491525424,1928.06779661017,23,63,86,100
"./Ship3_Latin-square/2019-10-02_11h25m_Subject 47755.txt","47755",2019-10-02,"11:25",4,80,60,7,13,20,30,3,5,38,55,23,8,86,651,64,201,916,157.033333333333,277.033333333333,2776.23728813559,1991.36206896552,71,165,236,98.3606557377049
"./Ship3_Latin-square/2019-10-02_11h25m_Subject 47760.txt","47760",2019-10-02,"11:25",2,79,60,9,10,19,21,2,2,25,32,17,20,69,1020,197,136,1353,152.616666666667,175.516666666667,2894.84745762712,1308.49152542373,19,69,88,100
"./Ship3_Latin-square/2019-10-02_11h25m_Subject 47770.txt","47770",2019-10-02,"11:25",0,55,41,6,8,14,117,8,6,131,42,7,14,63,164,20,27,211,2943.46341463415,235.951219512195,2999.90243902439,4849.25,67,68,135,90.4761904761905
"./Ship3_Latin-square/2019-10-02_11h25m_Subject 47795.txt","47795",2019-10-02,"11:25",2,79,60,7,12,19,28,7,6,41,40,8,23,71,520,30,127,677,305.883333333333,151.95,2884.71186440678,2310.08771929825,37,67,104,98.3606557377049
"./Ship3_Latin-square/2019-10-02_11h29m_Subject 47229.txt","47229",2019-10-02,"11:29",2,78,60,7,11,18,11,4,2,17,35,6,8,49,898,101,146,1145,117.116666666667,157.083333333333,2884.66101694915,1469.41379310345,28,79,107,98.3606557377049
"./Ship3_Latin-square/2019-10-02_11h29m_Subject 47233.txt","47233",2019-10-02,"11:29",2,78,60,6,12,18,31,3,0,34,36,6,7,49,442,36,105,583,135.516666666667,156.716666666667,2884.74576271186,1705.16666666667,29,109,138,91.8032786885246
"./Ship3_Latin-square/2019-10-02_11h29m_Subject 47234.txt","47234",2019-10-02,"11:29",4,81,60,14,7,21,27,5,5,37,41,15,8,64,585,140,90,815,195.916666666667,212.9,2837.27118644068,1467.625,78,56,134,98.3606557377049
"./Ship3_Latin-square/2019-10-02_11h29m_Subject 47237.txt","47237",2019-10-02,"11:29",24,73,53,11,9,20,63,9,29,101,77,8,36,121,282,8,57,347,892.153846153846,735.019230769231,1938.40384615385,1227.14,44,18,62,96.2264150943396
"./Ship3_Latin-square/2019-10-02_11h29m_Subject 47241.txt","47241",2019-10-02,"11:29",16,80,60,10,10,20,18,2,4,24,6,9,0,15,691,58,174,923,98.2166666666667,104.516666666667,2240.64406779661,1344.03448275862,78,42,120,98.3606557377049
"./Ship3_Latin-square/2019-10-02_11h29m_Subject 47247.txt","47247",2019-10-02,"11:29",4,74,60,7,7,14,18,2,2,22,17,2,3,22,336,28,53,417,281.15,175.65,2796.59322033898,1744.41176470588,40,96,136,91.8032786885246
"./Ship3_Latin-square/2019-10-02_11h29m_Subject 47777.txt","47777",2019-10-02,"11:29",0,80,60,7,13,20,66,5,16,87,40,4,13,57,277,29,60,366,1014.22033898305,197.745762711864,2999.94915254237,3365.47169811321,70,59,129,91.6666666666667
"./Ship3_Latin-square/2019-10-02_11h29m_Subject 47784.txt","47784",2019-10-02,"11:29",4,77,60,8,9,17,35,3,3,41,73,19,22,114,1199,170,153,1522,149.033333333333,194.816666666667,2796.52542372881,1150.40677966102,63,91,154,100
"./Ship3_Latin-square/2019-10-02_12h36m_Subject 46880.txt","46880",2019-10-02,"12:36",2,82,60,4,18,22,6,1,2,9,7,1,4,12,781,31,236,1048,133.733333333333,96.6666666666667,2847.42372881356,1684.89189189189,29,427,456,70.4918032786885
"./Ship3_Latin-square/2019-10-02_12h36m_Subject 46882.txt","46882",2019-10-02,"12:36",24,67,51,12,4,16,64,18,2,84,38,36,3,77,234,10,24,268,1640.94,735.96,2183.94,2309.25581395349,47,30,77,86.2745098039216
"./Ship3_Latin-square/2019-10-02_12h36m_Subject 46883.txt","46883",2019-10-02,"12:36",4,75,60,5,10,15,16,1,0,17,26,13,6,45,660,49,109,818,108.916666666667,141.15,2769.47457627119,1568.42372881356,27,62,89,100
"./Ship3_Latin-square/2019-10-02_12h36m_Subject 46894.txt","46894",2019-10-02,"12:36",16,84,60,13,11,24,88,14,10,112,18,35,3,56,272,36,52,360,873.083333333333,121.95,2240.64406779661,1930.46428571429,67,20,87,93.4426229508197
"./Ship3_Latin-square/2019-10-02_12h36m_Subject 46896.txt","46896",2019-10-02,"12:36",0,81,60,6,15,21,23,2,2,27,32,6,11,49,985,81,259,1325,193.883333333333,142.283333333333,2999.93220338983,1432.61016949153,22,45,67,100
"./Ship3_Latin-square/2019-10-02_12h36m_Subject 47088.txt","47088",2019-10-02,"12:36",8,79,60,9,10,19,19,2,2,23,38,12,9,59,778,96,185,1059,129.65,174.4,2566.06779661017,1631.05084745763,57,95,152,100
"./Ship3_Latin-square/2019-10-02_12h36m_Subject 47228.txt","47228",2019-10-02,"12:36",16,79,60,9,10,19,18,2,4,24,9,3,0,12,552,58,123,733,146.633333333333,110.883333333333,2213.45762711864,1262.67272727273,28,63,91,96.7213114754098
"./Ship3_Latin-square/2019-10-02_12h36m_Subject 47243.txt","47243",2019-10-02,"12:36",16,83,60,13,10,23,64,8,8,80,64,50,12,126,577,81,103,761,195.383333333333,266.366666666667,2240.61016949153,1512.72881355932,125,69,194,100
"./Ship3_Latin-square/2019-10-02_12h36m_Subject 47249.txt","47249",2019-10-02,"12:36",8,81,60,12,9,21,37,6,7,50,50,27,7,84,388,79,70,537,349.716666666667,211.466666666667,2633.83050847458,1560.47457627119,66,46,112,100
"./Ship3_Latin-square/2019-10-02_12h36m_Subject 47639.txt","47639",2019-10-02,"12:36",4,85,60,11,14,25,15,3,1,19,9,9,1,19,716,77,222,1015,103.466666666667,137.083333333333,2776.22033898305,1814.36842105263,75,70,145,96.7213114754098
"./Ship3_Latin-square/2019-10-02_12h36m_Subject 47649.txt","47649",2019-10-02,"12:36",2,81,60,9,12,21,22,5,6,33,20,1,3,24,429,84,96,609,355.983333333333,144.733333333333,2888.10169491525,2358.13043478261,142,216,358,60.655737704918
"./Ship3_Latin-square/2019-10-02_12h36m_Subject 47753.txt","47753",2019-10-02,"12:36",16,82,60,13,9,22,84,9,17,110,41,28,16,85,433,38,60,531,592.583333333333,233.866666666667,2294.86440677966,1454.9387755102,82,140,222,85.2459016393443
"./Ship3_Latin-square/2019-10-02_12h36m_Subject 47758.txt","47758",2019-10-02,"12:36",8,81,60,11,10,21,11,4,0,15,56,57,0,113,875,165,154,1194,113.766666666667,220.016666666667,2606.77966101695,1091.57627118644,48,40,88,100
"./Ship3_Latin-square/2019-10-02_12h36m_Subject 47759.txt","47759",2019-10-02,"12:36",8,79,60,10,9,19,27,5,7,39,54,7,20,81,506,48,123,677,207.533333333333,262.65,2620.22033898305,1284.49152542373,38,35,73,100
"./Ship3_Latin-square/2019-10-02_12h36m_Subject 47776.txt","47776",2019-10-02,"12:36",16,82,60,9,13,22,19,0,6,25,47,22,9,78,918,77,260,1255,95.45,146.75,2105.05084745763,1032.06896551724,31,34,65,100
"./Ship3_Latin-square/2019-10-02_12h36m_Subject 47799.txt","47799",2019-10-02,"12:36",8,84,60,12,12,24,23,0,8,31,56,31,13,100,473,97,136,706,284.533333333333,177.15,2566.03389830508,1512.59322033898,63,32,95,100
"./Ship3_Latin-square/2019-10-02_12h41m_Subject 46881.txt","46881",2019-10-02,"12:41",2,79,60,7,12,19,17,0,1,18,48,18,18,84,980,71,222,1273,105.066666666667,135.833333333333,2881.30508474576,2037.39622641509,59,168,227,93.4426229508197
"./Ship3_Latin-square/2019-10-02_12h41m_Subject 47087.txt","47087",2019-10-02,"12:41",2,76,60,6,10,16,20,1,1,22,35,6,2,43,394,51,54,499,257.566666666667,142.75,2894.84745762712,1694.63793103448,57,39,96,100
"./Ship3_Latin-square/2019-10-02_12h41m_Subject 47626.txt","47626",2019-10-02,"12:41",0,82,60,4,18,22,17,0,6,23,30,1,13,44,273,30,89,392,264.2,171.033333333333,2999.94915254237,2447.14583333333,71,89,160,85.2459016393443
"./Ship3_Latin-square/2019-10-02_12h41m_Subject 47632.txt","47632",2019-10-02,"12:41",16,78,60,10,8,18,27,2,1,30,11,5,4,20,780,88,151,1019,136.783333333333,84.5,2240.61016949153,1115.10714285714,36,57,93,95.0819672131148
"./Ship3_Latin-square/2019-10-02_12h41m_Subject 47634.txt","47634",2019-10-02,"12:41",2,84,60,9,15,24,25,6,7,38,14,4,17,35,356,34,118,508,325.4,123.833333333333,2877.89830508475,1863.5,83,84,167,86.8852459016393
"./Ship3_Latin-square/2019-10-02_12h41m_Subject 47640.txt","47640",2019-10-02,"12:41",2,79,60,11,8,19,29,8,3,40,16,8,2,26,469,69,82,620,641.8,114.4,2905.03389830508,2264.67924528302,23,43,66,93.4426229508197
"./Ship3_Latin-square/2019-10-02_12h41m_Subject 47754.txt","47754",2019-10-02,"12:41",4,74,54,9,11,20,38,4,10,52,63,6,27,96,264,36,84,384,1389.61111111111,277.87037037037,2796.11320754717,3392.3023255814,23,133,156,81.8181818181818
"./Ship3_Latin-square/2019-10-02_12h41m_Subject 47800.txt","47800",2019-10-02,"12:41",24,78,60,8,10,18,56,6,9,71,74,16,15,105,160,7,51,218,596.1,211.35,1779.61016949153,1352.03448275862,45,43,88,98.3606557377049
"./Ship3_Latin-square/2019-10-02_14h02m_Subject 46876.txt","46876",2019-10-02,"14:02",2,79,60,8,11,19,24,2,1,27,2,1,2,5,678,64,151,893,211.483333333333,89.8166666666667,2891.4406779661,1681.75438596491,35,112,147,98.3606557377049
"./Ship3_Latin-square/2019-10-02_14h02m_Subject 46877.txt","46877",2019-10-02,"14:02",0,85,60,13,12,25,3,2,1,6,28,11,21,60,1340,326,354,2020,68.4,160.4,2999.98305084746,1170.98305084746,49,50,99,100
"./Ship3_Latin-square/2019-10-02_14h02m_Subject 46893.txt","46893",2019-10-02,"14:02",16,79,60,8,11,19,8,0,4,12,94,18,7,119,1101,112,261,1474,80.9166666666667,221.616666666667,2077.93220338983,866.610169491525,53,56,109,100
"./Ship3_Latin-square/2019-10-02_14h02m_Subject 46895.txt","46895",2019-10-02,"14:02",2,85,59,10,16,26,42,10,8,60,23,30,11,64,176,59,68,303,796.694915254237,165.120689655172,2879.25862068966,2159.73913043478,24,58,82,88.135593220339
"./Ship3_Latin-square/2019-10-02_14h02m_Subject 47638.txt","47638",2019-10-02,"14:02",16,80,60,15,5,20,99,14,10,123,39,15,0,54,271,37,17,325,1135.13333333333,169.133333333333,2430.47457627119,2308.20689655172,101,44,145,98.3606557377049
"./Ship3_Latin-square/2019-10-02_14h02m_Subject 47757.txt","47757",2019-10-02,"14:02",8,70,48,15,7,22,86,21,7,114,37,29,31,97,221,74,43,338,1459.8085106383,254.170212765957,2761.68085106383,3249.86046511628,89,99,188,93.75
"./Ship3_Latin-square/2019-10-02_14h02m_Subject 47769.txt","47769",2019-10-02,"14:02",4,84,60,12,12,24,21,6,1,28,44,13,11,68,804,172,215,1191,132.55,185.333333333333,2803.33898305085,1551.50847457627,93,70,163,100
"./Ship3_Latin-square/2019-10-02_14h02m_Subject 47771.txt","47771",2019-10-02,"14:02",4,80,60,8,12,20,13,1,0,14,7,1,0,8,940,103,198,1241,75.8833333333333,102.233333333333,2776.23728813559,1390.23728813559,14,89,103,100
"./Ship3_Latin-square/2019-10-02_14h02m_Subject 47775.txt","47775",2019-10-02,"14:02",4,81,60,8,13,21,33,4,9,46,15,10,3,28,520,74,118,712,207.833333333333,121.783333333333,2769.42372881356,1350.32203389831,53,69,122,100
"./Ship3_Latin-square/2019-10-02_14h02m_Subject 47781.txt","47781",2019-10-02,"14:02",24,84,60,11,13,24,26,3,2,31,52,14,10,76,536,17,210,763,95.6166666666667,209.116666666667,1698.23728813559,1600.41176470588,62,109,171,72.1311475409836
"./Ship3_Latin-square/2019-10-02_14h02m_Subject 47782.txt","47782",2019-10-02,"14:02",8,78,60,8,10,18,24,0,1,25,15,3,4,22,543,85,110,738,134.116666666667,119.3,2579.57627118644,1557.16071428571,60,52,112,96.7213114754098
"./Ship3_Latin-square/2019-10-02_14h02m_Subject 47783.txt","47783",2019-10-02,"14:02",24,82,60,13,9,22,71,10,14,95,50,5,12,67,309,16,57,382,462.15,214.183333333333,1942.32203389831,1257.17857142857,64,35,99,95.0819672131148
"./Ship3_Latin-square/2019-10-02_14h02m_Subject 47785.txt","47785",2019-10-02,"14:02",24,83,60,13,10,23,31,2,14,47,45,19,20,84,653,19,196,868,214.15,154.166666666667,1901.59322033898,1212.17021276596,53,97,150,81.9672131147541
"./Ship3_Latin-square/2019-10-02_14h02m_Subject 47786.txt","47786",2019-10-02,"14:02",24,58,46,10,2,12,62,7,3,72,39,10,1,50,86,3,7,96,1808.08695652174,1444.4,2200,4208.57142857143,79,37,116,80.4347826086957
"./Ship3_Latin-square/2019-10-02_14h02m_Subject 47788.txt","47788",2019-10-02,"14:02",8,79,60,8,11,19,23,2,5,30,57,11,6,74,783,96,165,1044,161.583333333333,173.083333333333,2552.49152542373,1386.83050847458,38,75,113,100
"./Ship3_Latin-square/2019-10-02_14h06m_Subject 46888.txt","46888",2019-10-02,"14:06",24,83,60,15,8,23,40,10,1,51,59,44,14,117,335,21,51,407,318.305084745763,186.610169491525,2105.08474576271,1669.78431372549,66,59,125,86.6666666666667
"./Ship3_Latin-square/2019-10-02_14h06m_Subject 46889.txt","46889",2019-10-02,"14:06",2,79,60,8,11,19,12,1,1,14,11,1,2,14,1035,184,186,1405,76.95,118.433333333333,2891.50847457627,1745.91379310345,76,108,184,98.3606557377049
"./Ship3_Latin-square/2019-10-02_14h06m_Subject 46890.txt","46890",2019-10-02,"14:06",2,83,60,10,13,23,20,3,5,28,7,0,10,17,382,86,107,575,437.316666666667,98.9,2891.50847457627,1957.85365853659,47,123,170,77.0491803278689
"./Ship3_Latin-square/2019-10-02_14h06m_Subject 46892.txt","46892",2019-10-02,"14:06",16,83,60,12,11,23,23,3,11,37,40,23,10,73,627,91,114,832,108.25,298.2,2240.62711864407,1205.98245614035,60,100,160,96.7213114754098
"./Ship3_Latin-square/2019-10-02_14h06m_Subject 46898.txt","46898",2019-10-02,"14:06",24,77,60,7,10,17,27,4,4,35,51,12,15,78,326,27,141,494,182.4,264.366666666667,1698.27118644068,1479.13636363636,30,120,150,80.327868852459
"./Ship3_Latin-square/2019-10-02_14h06m_Subject 47097.txt","47097",2019-10-02,"14:06",2,83,60,9,14,23,11,1,1,13,48,10,11,69,929,137,219,1285,69.75,164.766666666667,2884.71186440678,1611.96610169492,70,87,157,100
"./Ship3_Latin-square/2019-10-02_14h06m_Subject 47099.txt","47099",2019-10-02,"14:06",16,80,60,10,10,20,18,3,6,27,25,22,14,61,884,103,157,1144,94.1666666666667,164.566666666667,2267.74576271186,956.218181818182,36,122,158,93.4426229508197
"./Ship3_Latin-square/2019-10-02_14h06m_Subject 47798.txt","47798",2019-10-02,"14:06",0,76,60,6,10,16,24,1,1,26,11,4,3,18,211,27,68,306,713.916666666667,127.55,2999.83050847458,2534,39,129,168,77.0491803278689
"./Ship3_Latin-square/2019-10-02_15h10m_Subject 47080.txt","47080",2019-10-02,"15:10",24,82,60,10,12,22,16,1,2,19,36,10,8,54,451,9,211,671,156.433333333333,176.75,1779.54237288136,1420.02777777778,46,95,141,70.4918032786885
"./Ship3_Latin-square/2019-10-02_15h10m_Subject 47089.txt","47089",2019-10-02,"15:10",2,78,60,6,12,18,35,3,6,44,41,9,7,57,284,28,53,365,1074.43333333333,191.683333333333,2884.72881355932,1945.16071428571,66,36,102,95.0819672131148
"./Ship3_Latin-square/2019-10-02_15h10m_Subject 47762.txt","47762",2019-10-02,"15:10",0,80,60,8,12,20,12,2,7,21,21,3,11,35,313,35,69,417,212.466666666667,153.816666666667,2999.86440677966,2429.41304347826,83,129,212,80.327868852459
"./Ship3_Latin-square/2019-10-02_15h10m_Subject 47791.txt","47791",2019-10-02,"15:10",2,78,60,6,12,18,6,2,0,8,12,1,5,18,839,87,175,1101,64.8,115.383333333333,2881.27118644068,1401.93220338983,18,15,33,100
"./Ship3_Latin-square/2019-10-03_09h50m_Subject 46878.txt","46878",2019-10-03,"09:50",4,75,60,6,9,15,13,1,2,16,18,2,3,23,544,49,72,665,149.75,145.916666666667,2776.25423728814,2061.27586206897,74,70,144,98.3606557377049
"./Ship3_Latin-square/2019-10-03_09h50m_Subject 46885.txt","46885",2019-10-03,"09:50",0,81,60,9,12,21,58,2,6,66,25,0,7,32,334,53,56,443,691.35,128.816666666667,2999.84745762712,2229.41379310345,60,54,114,100
"./Ship3_Latin-square/2019-10-03_09h50m_Subject 46899.txt","46899",2019-10-03,"09:50",2,81,60,11,10,21,22,8,2,32,37,9,9,55,760,145,166,1071,202.316666666667,144.166666666667,2905.01694915254,919.864406779661,37,24,61,100
"./Ship3_Latin-square/2019-10-03_09h50m_Subject 47081.txt","47081",2019-10-03,"09:50",24,82,60,10,12,22,33,6,6,45,29,2,25,56,359,12,121,492,204.616666666667,163.566666666667,1779.64406779661,966.26,43,64,107,86.8852459016393
"./Ship3_Latin-square/2019-10-03_09h50m_Subject 47091.txt","47091",2019-10-03,"09:50",2,76,60,8,8,16,21,2,3,26,56,12,12,80,270,35,37,342,278.5,138.616666666667,2905.06779661017,1837.83050847458,41,46,87,100
"./Ship3_Latin-square/2019-10-03_09h50m_Subject 47095.txt","47095",2019-10-03,"09:50",16,80,60,10,10,20,46,4,11,61,60,7,23,90,244,24,42,310,765.35,228.916666666667,2213.5593220339,1915.72549019608,63,63,126,86.8852459016393
"./Ship3_Latin-square/2019-10-03_09h50m_Subject 47231.txt","47231",2019-10-03,"09:50",4,80,60,10,10,20,65,10,12,87,17,15,6,38,230,59,45,334,1149.64406779661,130.271186440678,2789.74576271186,1764.94444444444,21,66,87,93.3333333333333
"./Ship3_Latin-square/2019-10-03_09h50m_Subject 47238.txt","47238",2019-10-03,"09:50",24,80,60,11,9,20,27,1,5,33,59,17,10,86,319,18,80,417,231.916666666667,191.616666666667,1820.30508474576,695.6,17,38,55,96.7213114754098
"./Ship3_Latin-square/2019-10-03_09h50m_Subject 47242.txt","47242",2019-10-03,"09:50",24,82,60,9,13,22,39,5,9,53,57,18,11,86,271,3,150,424,195.566666666667,214,1657.61016949153,998.088888888889,18,62,80,85.2459016393443
"./Ship3_Latin-square/2019-10-03_09h50m_Subject 47244.txt","47244",2019-10-03,"09:50",0,78,60,6,12,18,22,1,3,26,36,8,4,48,805,95,165,1065,229.95,159.716666666667,2999.94915254237,1878.38983050847,52,106,158,100
"./Ship3_Latin-square/2019-10-03_09h50m_Subject 47633.txt","47633",2019-10-03,"09:50",4,76,60,7,9,16,42,2,1,45,47,6,11,64,384,40,49,473,328.116666666667,171.166666666667,2782.98305084746,1863.22033898305,110,68,178,100
"./Ship3_Latin-square/2019-10-03_09h50m_Subject 47636.txt","47636",2019-10-03,"09:50",0,81,60,14,7,21,117,7,3,127,53,18,4,75,482,150,39,671,656.8,187.75,2999.8813559322,2031.40677966102,123,73,196,100
"./Ship3_Latin-square/2019-10-03_09h50m_Subject 47752.txt","47752",2019-10-03,"09:50",2,79,60,9,10,19,53,7,4,64,23,20,12,55,563,106,102,771,553.383333333333,110.916666666667,2901.62711864407,2004.96428571429,52,75,127,95.0819672131148
"./Ship3_Latin-square/2019-10-03_09h50m_Subject 47767.txt","47767",2019-10-03,"09:50",24,80,60,11,9,20,69,5,16,90,101,32,33,166,164,3,46,213,754.116666666667,376.966666666667,1901.62711864407,1564.94444444444,47,71,118,91.8032786885246
"./Ship3_Latin-square/2019-10-03_09h50m_Subject 47768.txt","47768",2019-10-03,"09:50",0,83,60,8,15,23,10,3,9,22,20,1,2,23,739,104,190,1033,159.283333333333,144.7,2999.84745762712,2174.71929824561,33,97,130,96.7213114754098
"./Ship3_Latin-square/2019-10-03_09h50m_Subject 47780.txt","47780",2019-10-03,"09:50",8,79,60,8,11,19,46,5,4,55,44,13,11,68,437,62,103,602,369.416666666667,163.666666666667,2552.49152542373,1343.62711864407,51,47,98,100
"./Ship3_Latin-square/2019-10-03_09h53m_Subject 46884.txt","46884",2019-10-03,"09:53",0,80,60,8,12,20,25,1,2,28,11,3,1,15,350,61,85,496,347.716666666667,138.383333333333,2999.93220338983,2327.60416666667,95,57,152,86.8852459016393
"./Ship3_Latin-square/2019-10-03_09h53m_Subject 47083.txt","47083",2019-10-03,"09:53",2,81,60,9,12,21,43,15,3,61,28,7,8,43,395,50,99,544,715.1,190.516666666667,2888.08474576271,1933.44444444444,106,78,184,93.4426229508197
"./Ship3_Latin-square/2019-10-03_09h53m_Subject 47086.txt","47086",2019-10-03,"09:53",16,81,60,11,10,21,44,3,8,55,31,4,10,45,282,29,105,416,442.35,193.533333333333,2240.64406779661,1403.54716981132,52,77,129,91.8032786885246
"./Ship3_Latin-square/2019-10-03_09h53m_Subject 47246.txt","47246",2019-10-03,"09:53",0,78,60,5,13,18,27,2,3,32,10,1,3,14,456,51,100,607,189.5,141.633333333333,2999.86440677966,2011.10344827586,37,109,146,96.7213114754098
"./Ship3_Latin-square/2019-10-03_09h53m_Subject 47635.txt","47635",2019-10-03,"09:53",0,78,60,8,10,18,12,0,1,13,30,12,9,51,742,98,119,959,111.866666666667,143.616666666667,2999.91525423729,1678.49152542373,52,72,124,100
"./Ship3_Latin-square/2019-10-03_09h53m_Subject 47779.txt","47779",2019-10-03,"09:53",0,77,60,6,11,17,37,2,4,43,78,15,7,100,289,37,60,386,807.85,237.85,2999.89830508475,2503.39622641509,54,78,132,91.8032786885246
"./Ship3_Latin-square/2019-10-03_09h53m_Subject 47790.txt","47790",2019-10-03,"09:53",16,79,60,10,9,19,68,6,18,92,50,17,5,72,217,21,26,264,829.666666666667,296.716666666667,2240.66101694915,2982.08163265306,76,106,182,85.2459016393443
"./Ship3_Latin-square/2019-10-03_09h53m_Subject 47797.txt","47797",2019-10-03,"09:53",24,50,36,10,4,14,51,13,3,67,39,9,33,81,72,7,11,90,2581.68571428571,361.971428571429,2177.14285714286,3983.51612903226,24,38,62,91.6666666666667
"./Ship3_Latin-square/2019-10-03_11h15m_Subject 46900.txt","46900",2019-10-03,"11:15",2,78,60,6,12,18,11,0,0,11,56,8,11,75,1169,88,341,1598,161.733333333333,142.266666666667,2881.32203389831,1090.93220338983,30,51,81,100
"./Ship3_Latin-square/2019-10-03_11h15m_Subject 46986.txt","46986",2019-10-03,"11:15",16,67,52,10,5,15,48,9,2,59,48,8,2,58,207,37,50,294,1870.36538461538,481.423076923077,2372.45098039216,1458.60465116279,79,48,127,88.6792452830189
"./Ship3_Latin-square/2019-10-03_11h15m_Subject 47076.txt","47076",2019-10-03,"11:15",24,70,50,11,9,20,30,1,7,38,116,3,151,270,399,7,71,477,259.98,569.76,1895.96,1163.5,37,102,139,82.3529411764706
"./Ship3_Latin-square/2019-10-03_11h15m_Subject 47079.txt","47079",2019-10-03,"11:15",0,79,60,9,10,19,24,7,2,33,45,11,10,66,536,89,94,719,315.9,182.3,2999.83050847458,1378.16949152542,36,46,82,100
"./Ship3_Latin-square/2019-10-03_11h15m_Subject 47082.txt","47082",2019-10-03,"11:15",24,71,50,13,8,21,70,14,5,89,30,19,10,59,171,19,41,231,1248.9,142.76,2039.98,3650.05,99,52,151,84.3137254901961
"./Ship3_Latin-square/2019-10-03_11h15m_Subject 47092.txt","47092",2019-10-03,"11:15",0,77,60,8,9,17,21,3,2,26,21,5,0,26,1087,138,168,1393,137.4,172.083333333333,2999.94915254237,1611.23728813559,58,114,172,100
"./Ship3_Latin-square/2019-10-03_11h15m_Subject 47098.txt","47098",2019-10-03,"11:15",24,80,60,14,6,20,45,5,9,59,52,5,13,70,193,2,30,225,454.283333333333,399.466666666667,2064.32203389831,1475.72549019608,49,69,118,88.5245901639344
"./Ship3_Latin-square/2019-10-03_11h15m_Subject 47226.txt","47226",2019-10-03,"11:15",24,80,60,9,11,20,25,4,5,34,45,8,11,64,791,6,359,1156,270.533333333333,149.483333333333,1779.62711864407,992.659090909091,21,69,90,80.327868852459
"./Ship3_Latin-square/2019-10-03_11h15m_Subject 47227.txt","47227",2019-10-03,"11:15",24,76,60,13,3,16,64,7,2,73,44,21,3,68,245,10,20,275,765.283333333333,225.65,2145.67796610169,1157.81818181818,65,37,102,93.4426229508197
"./Ship3_Latin-square/2019-10-03_11h15m_Subject 47250.txt","47250",2019-10-03,"11:15",24,82,60,13,9,22,50,3,9,62,57,26,17,100,385,8,79,472,390.866666666667,199.716666666667,1982.94915254237,1004.80392156863,38,53,91,86.8852459016393
"./Ship3_Latin-square/2019-10-03_11h15m_Subject 47645.txt","47645",2019-10-03,"11:15",16,71,55,12,4,16,96,14,6,116,11,5,2,18,185,24,16,225,1939.49090909091,159.527272727273,2389.05454545455,2967.28888888889,66,77,143,85.7142857142857
"./Ship3_Latin-square/2019-10-03_11h15m_Subject 47646.txt","47646",2019-10-03,"11:15",24,83,60,12,11,23,59,4,30,93,86,39,15,140,504,6,84,594,557.416666666667,210.583333333333,1861,1489.09803921569,37,70,107,88.5245901639344
"./Ship3_Latin-square/2019-10-03_11h15m_Subject 47755.txt","47755",2019-10-03,"11:15",2,81,60,10,11,21,30,1,4,35,26,14,6,46,725,96,131,952,161.25,168.35,2894.83050847458,2090.49152542373,77,142,219,100
"./Ship3_Latin-square/2019-10-03_11h15m_Subject 47760.txt","47760",2019-10-03,"11:15",0,82,60,11,11,22,25,7,3,35,39,13,5,57,1392,239,292,1923,120.383333333333,145.983333333333,2999.8813559322,1230.8813559322,38,54,92,100
"./Ship3_Latin-square/2019-10-03_11h15m_Subject 47770.txt","47770",2019-10-03,"11:15",4,75,58,6,11,17,53,8,3,64,48,5,18,71,267,24,52,343,1536.81034482759,205.862068965517,2775.40350877193,4124.62222222222,99,144,243,84.7457627118644
"./Ship3_Latin-square/2019-10-03_11h15m_Subject 47795.txt","47795",2019-10-03,"11:15",24,50,37,13,0,13,88,23,0,111,47,38,0,85,135,6,0,141,2870.54054054054,286.837837837838,2599.88888888889,3200.36111111111,70,5,75,100
"./Ship3_Latin-square/2019-10-03_11h20m_Subject 47229.txt","47229",2019-10-03,"11:20",24,81,60,9,12,21,32,0,7,39,36,7,13,56,327,11,126,464,197,142.05,1820.27118644068,988.9375,25,73,98,81.9672131147541
"./Ship3_Latin-square/2019-10-03_11h20m_Subject 47233.txt","47233",2019-10-03,"11:20",0,80,60,8,12,20,29,4,4,37,27,2,9,38,390,65,79,534,183.766666666667,137.116666666667,2999.8813559322,1937.73214285714,49,57,106,95.0819672131148
"./Ship3_Latin-square/2019-10-03_11h20m_Subject 47234.txt","47234",2019-10-03,"11:20",16,80,60,11,9,20,38,5,7,50,34,15,10,59,373,83,89,545,331.133333333333,165.85,2267.72881355932,1430.85714285714,71,53,124,95.0819672131148
"./Ship3_Latin-square/2019-10-03_11h20m_Subject 47237.txt","47237",2019-10-03,"11:20",0,81,60,8,13,21,14,0,2,16,3,2,6,11,691,77,169,937,103.1,117.25,2999.86440677966,1100.28813559322,9,30,39,100
"./Ship3_Latin-square/2019-10-03_11h20m_Subject 47241.txt","47241",2019-10-03,"11:20",24,81,60,10,11,21,21,3,12,36,11,5,6,22,553,13,173,739,108.5,118.533333333333,1779.66101694915,932.953488372093,39,66,105,80.327868852459
"./Ship3_Latin-square/2019-10-03_11h20m_Subject 47247.txt","47247",2019-10-03,"11:20",2,77,60,9,8,17,26,4,9,39,20,2,5,27,315,52,31,398,380.216666666667,154.466666666667,2894.8813559322,2209.98148148148,42,88,130,93.4426229508197
"./Ship3_Latin-square/2019-10-03_11h20m_Subject 47777.txt","47777",2019-10-03,"11:20",2,77,60,5,12,17,30,1,3,34,34,1,5,40,419,28,105,552,338.083333333333,188.75,2877.89830508475,2000.94827586207,41,55,96,100
"./Ship3_Latin-square/2019-10-03_11h20m_Subject 47784.txt","47784",2019-10-03,"11:20",2,77,60,8,9,17,10,2,2,14,80,21,14,115,1395,167,238,1800,80.6,246.7,2894.8813559322,1098.01694915254,69,107,176,100
"./Ship3_Latin-square/2019-10-03_12h30m_Subject 46880.txt","46880",2019-10-03,"12:30",24,84,60,11,13,24,32,1,17,50,58,8,10,76,310,5,104,419,228.633333333333,310.4,1779.62711864407,1167.97619047619,44,86,130,75.4098360655738
"./Ship3_Latin-square/2019-10-03_12h30m_Subject 46882.txt","46882",2019-10-03,"12:30",4,81,60,10,11,21,14,0,0,14,72,13,20,105,953,178,266,1397,156.633333333333,155.5,2789.81355932203,1726.93181818182,36,228,264,83.6065573770492
"./Ship3_Latin-square/2019-10-03_12h30m_Subject 46883.txt","46883",2019-10-03,"12:30",2,74,60,5,9,14,33,0,7,40,44,7,5,56,668,67,68,803,144.45,160.083333333333,2891.47457627119,1425.28813559322,38,32,70,100
"./Ship3_Latin-square/2019-10-03_12h30m_Subject 46894.txt","46894",2019-10-03,"12:30",8,80,60,7,13,20,34,4,2,40,16,6,1,23,530,50,138,718,555.016666666667,123.166666666667,2525.37288135593,1514.375,33,70,103,96.7213114754098
"./Ship3_Latin-square/2019-10-03_12h30m_Subject 46896.txt","46896",2019-10-03,"12:30",16,84,60,12,12,24,21,3,4,28,39,21,9,69,670,130,143,943,326.733333333333,146.866666666667,2213.54237288136,1230.87931034483,51,35,86,98.3606557377049
"./Ship3_Latin-square/2019-10-03_12h30m_Subject 47228.txt","47228",2019-10-03,"12:30",8,80,60,9,11,20,22,1,2,25,20,11,4,35,494,80,94,668,257.916666666667,137.633333333333,2579.61016949153,1572.22807017544,39,80,119,96.7213114754098
"./Ship3_Latin-square/2019-10-03_12h30m_Subject 47243.txt","47243",2019-10-03,"12:30",8,78,60,9,9,18,39,2,7,48,10,19,1,30,816,110,158,1084,128.316666666667,112.983333333333,2593.15254237288,1375.52542372881,109,63,172,100
"./Ship3_Latin-square/2019-10-03_12h30m_Subject 47639.txt","47639",2019-10-03,"12:30",16,80,60,12,8,20,60,6,10,76,69,20,22,111,341,39,49,429,635.133333333333,519.083333333333,2294.84745762712,1892.33333333333,84,87,171,93.4426229508197
"./Ship3_Latin-square/2019-10-03_12h30m_Subject 47649.txt","47649",2019-10-03,"12:30",0,78,60,4,14,18,22,3,3,28,4,0,29,33,590,59,156,805,167.216666666667,106.45,2999.93220338983,1841.90243902439,61,248,309,83.6065573770492
"./Ship3_Latin-square/2019-10-03_12h30m_Subject 47753.txt","47753",2019-10-03,"12:30",4,79,60,9,10,19,25,3,1,29,20,4,3,27,717,104,172,993,225.666666666667,174.6,2789.79661016949,1500.42372881356,91,134,225,100
"./Ship3_Latin-square/2019-10-03_12h30m_Subject 47776.txt","47776",2019-10-03,"12:30",8,79,60,9,10,19,16,0,2,18,41,16,8,65,1074,143,257,1474,97.0666666666667,119.35,2606.69491525424,1168.79661016949,57,27,84,100
"./Ship3_Latin-square/2019-10-03_12h33m_Subject 46881.txt","46881",2019-10-03,"12:33",24,81,60,11,10,21,64,7,15,86,70,16,17,103,322,8,48,378,499.8,275.2,1779.59322033898,1317.98039215686,37,81,118,86.8852459016393
"./Ship3_Latin-square/2019-10-03_12h33m_Subject 47087.txt","47087",2019-10-03,"12:33",24,85,60,15,10,25,54,7,14,75,56,23,11,90,266,16,74,356,426.333333333333,204.133333333333,2023.62711864407,1588.89655172414,88,22,110,98.3606557377049
"./Ship3_Latin-square/2019-10-03_12h33m_Subject 47626.txt","47626",2019-10-03,"12:33",2,78,60,7,11,18,23,2,0,25,37,2,3,42,320,27,61,408,539.233333333333,159.033333333333,2884.64406779661,2686.73333333333,71,149,220,80.327868852459
"./Ship3_Latin-square/2019-10-03_12h33m_Subject 47632.txt","47632",2019-10-03,"12:33",2,80,60,9,11,20,16,5,2,23,6,0,7,13,957,143,165,1265,153.75,96.8666666666667,2891.49152542373,1532.87931034483,39,77,116,96.7213114754098
"./Ship3_Latin-square/2019-10-03_12h33m_Subject 47634.txt","47634",2019-10-03,"12:33",24,85,60,14,11,25,53,11,16,80,37,42,10,89,204,19,59,282,481.55,164.033333333333,1942.32203389831,1807.72549019608,91,50,141,90.1639344262295
"./Ship3_Latin-square/2019-10-03_12h33m_Subject 47640.txt","47640",2019-10-03,"12:33",24,84,60,13,11,24,61,5,14,80,29,11,11,51,138,8,39,185,1086.98333333333,168.65,1901.61016949153,1931.65909090909,53,63,116,77.0491803278689
"./Ship3_Latin-square/2019-10-03_12h33m_Subject 47754.txt","47754",2019-10-03,"12:33",16,56,41,10,5,15,46,5,6,57,28,4,3,35,100,22,23,145,2240.875,250.375,2359.925,3715.45161290323,25,60,85,82.9268292682927
"./Ship3_Latin-square/2019-10-03_12h33m_Subject 47800.txt","47800",2019-10-03,"12:33",4,78,60,3,15,18,61,2,12,75,54,4,13,71,269,9,68,346,492.7,158.4,2728.81355932203,2054.75862068966,45,72,117,98.3606557377049
"./Ship3_Latin-square/2019-10-03_13h47m_Subject 46876.txt","46876",2019-10-03,"13:47",24,54,39,12,3,15,37,20,2,59,14,8,1,23,228,1,21,250,481.102564102564,160.435897435897,2384.5641025641,1379.64705882353,40,16,56,87.5
"./Ship3_Latin-square/2019-10-03_13h47m_Subject 46877.txt","46877",2019-10-03,"13:47",4,82,60,11,11,22,5,1,1,7,59,13,6,78,1574,264,301,2139,61.35,243.45,2796.59322033898,950.322033898305,46,55,101,100
"./Ship3_Latin-square/2019-10-03_13h47m_Subject 46893.txt","46893",2019-10-03,"13:47",8,76,60,7,9,16,9,0,20,29,90,10,4,104,1458,184,256,1898,49.2,154.216666666667,2579.61016949153,1080.22033898305,85,116,201,100
"./Ship3_Latin-square/2019-10-03_13h47m_Subject 46895.txt","46895",2019-10-03,"13:47",0,82,60,5,17,22,41,2,17,60,14,3,6,23,290,24,55,369,666.616666666667,144.066666666667,2999.8813559322,1743.11538461538,14,78,92,91.8032786885246
"./Ship3_Latin-square/2019-10-03_13h47m_Subject 46897.txt","46897",2019-10-03,"13:47",4,76,56,10,10,20,65,9,23,97,69,24,38,131,184,33,38,255,1022.35714285714,536.25,2807.07142857143,2602.32692307692,28,120,148,92.9824561403509
"./Ship3_Latin-square/2019-10-03_13h47m_Subject 47638.txt","47638",2019-10-03,"13:47",8,82,60,13,9,22,58,11,5,74,19,7,7,33,393,61,78,532,644.4,126.516666666667,2633.79661016949,2142.29824561404,93,33,126,98.3606557377049
"./Ship3_Latin-square/2019-10-03_13h47m_Subject 47769.txt","47769",2019-10-03,"13:47",16,85,60,13,12,25,26,4,9,39,39,18,9,66,548,78,123,749,223.883333333333,166.55,2267.74576271186,1576.22033898305,106,52,158,100
"./Ship3_Latin-square/2019-10-03_13h47m_Subject 47771.txt","47771",2019-10-03,"13:47",16,84,60,15,9,24,26,2,3,31,13,7,3,23,653,84,143,880,189.233333333333,118.733333333333,2321.98305084746,1124.09615384615,16,84,100,93.4426229508197
"./Ship3_Latin-square/2019-10-03_13h47m_Subject 47775.txt","47775",2019-10-03,"13:47",16,80,60,10,10,20,67,6,9,82,28,5,4,37,312,42,103,457,529.616666666667,125,2186.38983050847,1454.39215686275,40,90,130,91.8032786885246
"./Ship3_Latin-square/2019-10-03_13h47m_Subject 47781.txt","47781",2019-10-03,"13:47",4,79,60,8,11,19,12,1,2,15,35,11,4,50,1177,126,252,1555,94.2166666666667,158.066666666667,2789.79661016949,1152.74576271186,42,37,79,100
"./Ship3_Latin-square/2019-10-03_13h47m_Subject 47783.txt","47783",2019-10-03,"13:47",4,77,60,10,7,17,37,4,1,42,68,14,6,88,782,154,88,1024,481.283333333333,196.383333333333,2810.13559322034,1425.47457627119,34,80,114,100
"./Ship3_Latin-square/2019-10-03_13h47m_Subject 47785.txt","47785",2019-10-03,"13:47",4,76,60,6,10,16,19,1,1,21,69,11,19,99,1737,205,355,2297,238.083333333333,129.633333333333,2783.01694915254,1502.20338983051,36,148,184,100
"./Ship3_Latin-square/2019-10-03_13h47m_Subject 47786.txt","47786",2019-10-03,"13:47",8,81,60,10,11,21,56,10,9,75,27,20,51,98,256,30,81,367,896.983333333333,183.866666666667,2606.67796610169,2730.58,45,115,160,88.5245901639344
"./Ship3_Latin-square/2019-10-03_13h51m_Subject 46888.txt","46888",2019-10-03,"13:51",4,76,60,8,8,16,6,0,2,8,49,9,8,66,874,107,127,1108,58.2166666666667,153.55,2789.83050847458,1462.93220338983,49,48,97,100
"./Ship3_Latin-square/2019-10-03_13h51m_Subject 46889.txt","46889",2019-10-03,"13:51",0,82,60,3,19,22,16,1,2,19,24,0,20,44,1262,101,342,1705,84.35,130.216666666667,2999.84745762712,1645.60344827586,31,172,203,98.3606557377049
"./Ship3_Latin-square/2019-10-03_13h51m_Subject 46890.txt","46890",2019-10-03,"13:51",0,82,60,6,16,22,17,5,4,26,7,0,17,24,473,58,138,669,257.35,94.6,2999.93220338983,2313.69047619048,92,175,267,77.0491803278689
"./Ship3_Latin-square/2019-10-03_13h51m_Subject 46892.txt","46892",2019-10-03,"13:51",8,80,60,9,11,20,11,3,0,14,9,1,2,12,972,125,241,1338,67.4,116.316666666667,2566.05084745763,1206.69491525424,44,50,94,100
"./Ship3_Latin-square/2019-10-03_13h51m_Subject 46898.txt","46898",2019-10-03,"13:51",8,76,60,10,6,16,42,4,3,49,74,14,1,89,510,115,54,679,186.266666666667,177.05,2633.81355932203,1587.98148148148,31,91,122,95.0819672131148
"./Ship3_Latin-square/2019-10-03_13h51m_Subject 47097.txt","47097",2019-10-03,"13:51",24,84,60,15,9,24,47,1,7,55,93,31,14,138,536,9,111,656,156.283333333333,296.366666666667,1942.33898305085,998.245614035088,66,29,95,98.3606557377049
"./Ship3_Latin-square/2019-10-03_13h51m_Subject 47099.txt","47099",2019-10-03,"13:51",8,76,60,8,8,16,20,1,1,22,25,9,10,44,909,97,183,1189,99.6333333333333,148.883333333333,2593.18644067797,1299.12068965517,34,99,133,98.3606557377049
"./Ship3_Latin-square/2019-10-03_13h51m_Subject 47798.txt","47798",2019-10-03,"13:51",4,79,60,7,12,19,18,1,1,20,9,2,2,13,282,21,80,383,315.533333333333,115.4,2776.23728813559,2114.33333333333,52,130,182,77.0491803278689
"./Ship3_Latin-square/2019-10-03_15h00m_Subject 47080.txt","47080",2019-10-03,"15:00",4,80,60,7,13,20,7,0,3,10,19,11,12,42,1004,131,215,1350,61.5833333333333,109.666666666667,2782.98305084746,1389.64912280702,41,120,161,96.7213114754098
"./Ship3_Latin-square/2019-10-03_15h00m_Subject 47089.txt","47089",2019-10-03,"15:00",24,46,32,14,0,14,22,9,0,31,19,121,0,140,168,1,0,169,693.46875,218.28125,2849.90625,1773.41935483871,69,3,72,96.969696969697
"./Ship3_Latin-square/2019-10-03_15h00m_Subject 47762.txt","47762",2019-10-03,"15:00",4,77,60,7,10,17,21,2,7,30,16,3,1,20,210,24,30,264,302.283333333333,115.033333333333,2789.76271186441,2635.55813953488,74,92,166,81.9672131147541
"./Ship3_Latin-square/2019-10-03_15h00m_Subject 47791.txt","47791",2019-10-03,"15:00",0,84,60,10,14,24,5,2,3,10,12,3,3,18,851,153,195,1199,67.9166666666667,106.35,2999.89830508475,1473.67796610169,24,27,51,100
"./Ship3_Latin-square/2019-10-04_09h48m_Subject 46884.txt","46884",2019-10-04,"09:48",2,80,60,10,10,20,28,4,7,39,15,4,3,22,221,34,50,305,501.416666666667,159.3,2898.27118644068,2465.45454545455,85,46,131,81.9672131147541
"./Ship3_Latin-square/2019-10-04_09h48m_Subject 47083.txt","47083",2019-10-04,"09:48",0,76,60,4,12,16,50,5,5,60,20,5,10,35,378,26,79,483,532.566666666667,148.133333333333,2999.77966101695,2158.12068965517,78,71,149,98.3606557377049
"./Ship3_Latin-square/2019-10-04_09h48m_Subject 47086.txt","47086",2019-10-04,"09:48",24,83,60,14,9,23,49,8,12,69,40,12,4,56,290,19,56,365,391.066666666667,196.166666666667,1982.94915254237,1166.42857142857,40,34,74,98.3606557377049
"./Ship3_Latin-square/2019-10-04_09h48m_Subject 47246.txt","47246",2019-10-04,"09:48",2,84,60,10,14,24,13,5,3,21,4,1,2,7,397,67,91,555,135.533333333333,128.85,2884.72881355932,2119.3137254902,43,123,166,86.8852459016393
"./Ship3_Latin-square/2019-10-04_09h48m_Subject 47635.txt","47635",2019-10-04,"09:48",4,82,60,8,14,22,9,0,1,10,22,4,11,37,713,94,151,958,111.616666666667,134.983333333333,2776.18644067797,1594.71186440678,57,31,88,100
"./Ship3_Latin-square/2019-10-04_09h48m_Subject 47779.txt","47779",2019-10-04,"09:48",4,83,60,11,12,23,23,3,3,29,47,14,3,64,172,25,61,258,895.65,181.133333333333,2789.79661016949,2834.89743589744,50,92,142,77.0491803278689
"./Ship3_Latin-square/2019-10-04_09h48m_Subject 47790.txt","47790",2019-10-04,"09:48",4,82,60,9,13,22,43,3,4,50,33,8,15,56,463,99,137,699,474.333333333333,251.383333333333,2769.45762711864,2008.01785714286,55,78,133,96.7213114754098
"./Ship3_Latin-square/2019-10-04_09h48m_Subject 47797.txt","47797",2019-10-04,"09:48",8,53,39,6,8,14,48,4,8,60,87,5,12,104,165,27,34,226,3635.34210526316,647.473684210526,2578.86842105263,2098.63636363636,15,81,96,87.1794871794872
"./Ship3_Latin-square/2019-10-04_09h52m_Subject 46878.txt","46878",2019-10-04,"09:52",2,80,60,11,9,20,7,3,1,11,9,14,12,35,898,151,113,1162,106.833333333333,147.616666666667,2908.42372881356,1554.77966101695,85,56,141,100
"./Ship3_Latin-square/2019-10-04_09h52m_Subject 46885.txt","46885",2019-10-04,"09:52",2,82,60,9,13,22,46,8,7,61,17,7,11,35,308,43,78,429,625.133333333333,127.916666666667,2888.10169491525,2032.66071428571,64,63,127,95.0819672131148
"./Ship3_Latin-square/2019-10-04_09h52m_Subject 46899.txt","46899",2019-10-04,"09:52",0,75,60,8,7,15,12,0,1,13,16,2,2,20,938,118,124,1180,144.566666666667,94.2833333333333,2999.89830508475,1025.69491525424,17,53,70,100
"./Ship3_Latin-square/2019-10-04_09h52m_Subject 47081.txt","47081",2019-10-04,"09:52",8,82,60,9,13,22,17,2,7,26,12,5,1,18,594,88,165,847,114.233333333333,112.6,2566.06779661017,1582.45762711864,43,89,132,100
"./Ship3_Latin-square/2019-10-04_09h52m_Subject 47091.txt","47091",2019-10-04,"09:52",0,80,60,7,13,20,19,0,0,19,61,6,7,74,305,33,49,387,192.683333333333,175.616666666667,2999.91525423729,1872.96551724138,46,56,102,98.3606557377049
"./Ship3_Latin-square/2019-10-04_09h52m_Subject 47095.txt","47095",2019-10-04,"09:52",4,79,60,8,11,19,41,3,5,49,31,5,12,48,446,56,65,567,808.033333333333,210.216666666667,2776.16949152542,2188.05357142857,36,79,115,95.0819672131148
"./Ship3_Latin-square/2019-10-04_09h52m_Subject 47231.txt","47231",2019-10-04,"09:52",0,78,60,1,17,18,60,1,14,75,19,0,3,22,268,4,60,332,619.433333333333,131.466666666667,2999.91525423729,1166.125,8,44,52,100
"./Ship3_Latin-square/2019-10-04_09h52m_Subject 47238.txt","47238",2019-10-04,"09:52",4,76,60,8,8,16,20,2,2,24,39,9,3,51,537,76,69,682,150.966666666667,143.033333333333,2789.76271186441,1216.49152542373,42,28,70,100
"./Ship3_Latin-square/2019-10-04_09h52m_Subject 47242.txt","47242",2019-10-04,"09:52",4,77,60,6,11,17,21,4,1,26,38,2,9,49,652,57,131,840,158.966666666667,164.366666666667,2762.69491525424,1132.83050847458,44,42,86,100
"./Ship3_Latin-square/2019-10-04_09h52m_Subject 47244.txt","47244",2019-10-04,"09:52",2,80,60,9,11,20,7,4,2,13,38,12,7,57,869,138,132,1139,103.65,171.966666666667,2888.06779661017,1500.03389830508,69,89,158,100
"./Ship3_Latin-square/2019-10-04_09h52m_Subject 47633.txt","47633",2019-10-04,"09:52",2,81,60,9,12,21,23,0,5,28,66,12,20,98,370,101,80,551,335.35,163.733333333333,2891.50847457627,1792.44827586207,70,62,132,98.3606557377049
"./Ship3_Latin-square/2019-10-04_09h52m_Subject 47636.txt","47636",2019-10-04,"09:52",4,75,60,5,10,15,48,4,9,61,43,4,7,54,411,44,65,520,561.383333333333,163.033333333333,2769.47457627119,2544.25,111,109,220,95.0819672131148
"./Ship3_Latin-square/2019-10-04_09h52m_Subject 47752.txt","47752",2019-10-04,"09:52",0,81,60,8,13,21,41,5,9,55,23,9,9,41,649,92,189,930,473.583333333333,109.583333333333,2999.83050847458,1666.15254237288,55,57,112,100
"./Ship3_Latin-square/2019-10-04_09h52m_Subject 47767.txt","47767",2019-10-04,"09:52",4,80,60,10,10,20,23,1,3,27,33,9,8,50,280,46,38,364,351.083333333333,136.983333333333,2796.59322033898,1818.88461538462,45,59,104,91.8032786885246
"./Ship3_Latin-square/2019-10-04_09h52m_Subject 47768.txt","47768",2019-10-04,"09:52",4,83,60,13,10,23,20,4,0,24,21,13,16,50,455,126,75,656,234.95,133.316666666667,2810.13559322034,2495.78431372549,99,83,182,88.5245901639344
"./Ship3_Latin-square/2019-10-04_09h52m_Subject 47780.txt","47780",2019-10-04,"09:52",0,82,60,10,12,22,39,6,7,52,39,13,12,64,526,80,117,723,419.866666666667,148.933333333333,2999.89830508475,1611.93103448276,38,57,95,100
"./Ship3_Latin-square/2019-10-04_10h52m_Subject 47229.txt","47229",2019-10-04,"10:52",4,78,60,8,10,18,26,2,5,33,21,4,3,28,550,54,92,696,165.85,107.516666666667,2789.79661016949,1686.47058823529,24,112,136,90.1639344262295
"./Ship3_Latin-square/2019-10-04_10h52m_Subject 47233.txt","47233",2019-10-04,"10:52",2,82,60,10,12,22,25,5,3,33,23,1,7,31,359,73,63,495,135.15,123.25,2888.08474576271,1997.91071428571,45,89,134,93.4426229508197
"./Ship3_Latin-square/2019-10-04_10h52m_Subject 47234.txt","47234",2019-10-04,"10:52",24,85,60,15,10,25,61,3,8,72,43,29,16,88,321,32,78,431,284.183333333333,254.116666666667,2023.64406779661,1308.21428571429,75,44,119,95.0819672131148
"./Ship3_Latin-square/2019-10-04_10h52m_Subject 47237.txt","47237",2019-10-04,"10:52",16,78,57,11,10,21,99,10,25,134,94,22,20,136,315,27,70,412,1033.19298245614,480.333333333333,2228.5,1312.25,35,32,67,100
"./Ship3_Latin-square/2019-10-04_10h52m_Subject 47241.txt","47241",2019-10-04,"10:52",8,77,60,9,8,17,19,0,1,20,8,9,0,17,917,100,156,1173,88.7833333333333,99,2620.32203389831,1103.6724137931,47,52,99,100
"./Ship3_Latin-square/2019-10-04_10h52m_Subject 47247.txt","47247",2019-10-04,"10:52",0,79,60,10,9,19,20,4,4,28,16,3,2,21,294,50,53,397,212.966666666667,146.133333333333,2999.93220338983,2337.50943396226,56,90,146,91.8032786885246
"./Ship3_Latin-square/2019-10-04_10h52m_Subject 47777.txt","47777",2019-10-04,"10:52",24,54,42,9,3,12,124,18,7,149,23,1,2,26,99,2,10,111,1125.80487804878,219.121951219512,2180.41463414634,2166.82051282051,38,36,74,97.6190476190476
"./Ship3_Latin-square/2019-10-04_10h52m_Subject 47784.txt","47784",2019-10-04,"10:52",0,80,60,5,15,20,15,3,1,19,47,6,37,90,1389,109,237,1735,95.0166666666667,194.783333333333,2999.89830508475,1201.67796610169,43,157,200,100
"./Ship3_Latin-square/2019-10-04_10h58m_Subject 46900.txt","46900",2019-10-04,"10:58",24,80,60,14,6,20,60,3,11,74,12,44,3,59,431,7,47,485,308.333333333333,118.366666666667,2064.32203389831,1168.2962962963,46,44,90,91.8032786885246
"./Ship3_Latin-square/2019-10-04_10h58m_Subject 46986.txt","46986",2019-10-04,"10:58",24,50,36,11,3,14,42,16,6,64,17,26,1,44,113,9,5,127,2363.94285714286,257.914285714286,2314.22857142857,2265.96428571429,53,30,83,80.5555555555556
"./Ship3_Latin-square/2019-10-04_10h58m_Subject 47076.txt","47076",2019-10-04,"10:58",4,83,60,13,10,23,5,2,1,8,12,13,4,29,1069,194,212,1475,80.0166666666667,100.533333333333,2816.83050847458,1411.01724137931,53,84,137,100
"./Ship3_Latin-square/2019-10-04_10h58m_Subject 47079.txt","47079",2019-10-04,"10:58",2,82,60,12,10,22,20,2,1,23,40,14,8,62,368,54,92,514,221.016666666667,164.9,2901.66101694915,1909.85964912281,55,54,109,96.7213114754098
"./Ship3_Latin-square/2019-10-04_10h58m_Subject 47082.txt","47082",2019-10-04,"10:58",4,71,52,9,10,19,52,4,8,64,74,12,4,90,196,27,30,253,982.921568627451,254.529411764706,2796.05882352941,2146.39534883721,66,48,114,86.5384615384615
"./Ship3_Latin-square/2019-10-04_10h58m_Subject 47092.txt","47092",2019-10-04,"10:58",2,75,60,7,8,15,11,0,0,11,14,1,3,18,1038,147,156,1341,80.75,139.383333333333,2898.28813559322,1561.48275862069,67,153,220,100
"./Ship3_Latin-square/2019-10-04_10h58m_Subject 47098.txt","47098",2019-10-04,"10:58",0,83,60,6,17,23,17,3,3,23,7,1,12,20,362,42,117,521,344.85,104.85,2999.86440677966,1717.38,48,83,131,91.8032786885246
"./Ship3_Latin-square/2019-10-04_10h58m_Subject 47226.txt","47226",2019-10-04,"10:58",4,80,60,7,13,20,10,3,3,16,17,4,10,31,2652,155,457,3264,154.466666666667,92.7666666666667,2762.69491525424,1179.35593220339,25,177,202,100
"./Ship3_Latin-square/2019-10-04_10h58m_Subject 47227.txt","47227",2019-10-04,"10:58",4,81,60,10,11,21,31,5,4,40,9,15,7,31,458,74,56,588,583.733333333333,98.0666666666667,2783.01694915254,1676.0701754386,34,107,141,96.7213114754098
"./Ship3_Latin-square/2019-10-04_10h58m_Subject 47250.txt","47250",2019-10-04,"10:58",16,80,60,10,10,20,16,2,1,19,20,22,10,52,611,62,163,836,111.4,105.216666666667,2213.50847457627,1070.64406779661,41,36,77,100
"./Ship3_Latin-square/2019-10-04_10h58m_Subject 47645.txt","47645",2019-10-04,"10:58",24,50,35,10,5,15,70,24,13,107,15,1,5,21,111,15,18,144,3285.73529411765,194.617647058824,2223.52941176471,4522.09677419355,73,30,103,94.2857142857143
"./Ship3_Latin-square/2019-10-04_10h58m_Subject 47646.txt","47646",2019-10-04,"10:58",4,78,60,8,10,18,20,2,3,25,91,18,18,127,1412,188,306,1906,159.65,137.066666666667,2782.98305084746,1728.12280701754,48,67,115,98.3606557377049
"./Ship3_Latin-square/2019-10-04_10h58m_Subject 47755.txt","47755",2019-10-04,"10:58",0,81,60,9,12,21,20,1,0,21,20,3,3,26,790,123,133,1046,143.533333333333,147,2999.8813559322,2001.83050847458,81,149,230,98.3606557377049
"./Ship3_Latin-square/2019-10-04_10h58m_Subject 47760.txt","47760",2019-10-04,"10:58",2,81,60,8,13,21,22,3,1,26,37,6,11,54,1086,123,278,1487,111.583333333333,175.133333333333,2888.03389830508,1237.49152542373,15,39,54,100
"./Ship3_Latin-square/2019-10-04_10h58m_Subject 47770.txt","47770",2019-10-04,"10:58",2,58,44,7,7,14,43,8,8,59,61,5,6,72,186,37,32,255,3074.61363636364,282.477272727273,2890.86363636364,4074.24242424242,76,106,182,86.6666666666667
"./Ship3_Latin-square/2019-10-04_10h58m_Subject 47795.txt","47795",2019-10-04,"10:58",4,83,60,6,17,23,39,6,14,59,64,11,42,117,540,16,154,710,383.3,164.183333333333,2742.30508474576,2215.59259259259,28,92,120,91.8032786885246
"./Ship3_Latin-square/2019-10-04_12h08m_Subject 46881.txt","46881",2019-10-04,"12:08",4,83,60,8,15,23,15,3,5,23,66,12,16,94,914,71,248,1233,90.85,200.216666666667,2755.91525423729,1495.91525423729,36,68,104,100
"./Ship3_Latin-square/2019-10-04_12h08m_Subject 47087.txt","47087",2019-10-04,"12:08",4,82,60,12,10,22,15,1,4,20,28,14,5,47,410,85,81,576,93.1333333333333,130.216666666667,2803.33898305085,1439.38983050847,48,25,73,100
"./Ship3_Latin-square/2019-10-04_12h08m_Subject 47626.txt","47626",2019-10-04,"12:08",24,75,58,10,7,17,95,6,14,115,35,15,3,53,183,7,36,226,735.508771929825,159.280701754386,1947.31578947368,1990.35849056604,88,42,130,94.8275862068966
"./Ship3_Latin-square/2019-10-04_12h08m_Subject 47632.txt","47632",2019-10-04,"12:08",8,77,60,7,10,17,12,1,2,15,9,9,2,20,776,64,136,976,103.483333333333,92.7,2552.54237288136,1390.06779661017,52,46,98,98.3606557377049
"./Ship3_Latin-square/2019-10-04_12h08m_Subject 47634.txt","47634",2019-10-04,"12:08",4,82,60,11,11,22,45,12,6,63,18,8,2,28,328,77,97,502,419.833333333333,136.833333333333,2796.59322033898,2013.09615384615,90,44,134,91.8032786885246
"./Ship3_Latin-square/2019-10-04_12h08m_Subject 47640.txt","47640",2019-10-04,"12:08",4,78,60,8,10,18,25,1,8,34,17,6,8,31,546,93,95,734,316.983333333333,133.883333333333,2789.77966101695,1578.14285714286,29,50,79,98.3606557377049
"./Ship3_Latin-square/2019-10-04_12h08m_Subject 47754.txt","47754",2019-10-04,"12:08",8,52,37,9,6,15,47,11,8,66,100,10,5,115,148,26,17,191,2211.83333333333,477.416666666667,2688.80555555556,3310.06060606061,10,62,72,94.5945945945946
"./Ship3_Latin-square/2019-10-04_12h08m_Subject 47800.txt","47800",2019-10-04,"12:08",16,76,60,9,7,16,52,9,2,63,57,19,13,89,252,16,50,318,530.416666666667,186.583333333333,2213.47457627119,1551.71186440678,54,62,116,100
"./Ship3_Latin-square/2019-10-04_12h11m_Subject 46880.txt","46880",2019-10-04,"12:11",4,76,60,4,12,16,3,0,2,5,16,1,4,21,749,46,207,1002,62.3666666666667,128.15,2749.15254237288,1961.37254901961,44,192,236,86.8852459016393
"./Ship3_Latin-square/2019-10-04_12h11m_Subject 46882.txt","46882",2019-10-04,"12:11",16,78,58,11,9,20,49,1,13,63,33,78,3,114,494,53,49,596,1100.42105263158,176.877192982456,2270.17543859649,1918.14583333333,34,64,98,89.6551724137931
"./Ship3_Latin-square/2019-10-04_12h11m_Subject 46883.txt","46883",2019-10-04,"12:11",0,77,60,6,11,17,27,0,1,28,20,20,6,46,601,61,109,771,127.75,146.433333333333,2999.96610169492,1709.49152542373,48,29,77,100
"./Ship3_Latin-square/2019-10-04_12h11m_Subject 46896.txt","46896",2019-10-04,"12:11",2,77,60,3,14,17,12,0,0,12,21,2,10,33,1150,47,207,1404,79.2333333333333,122.183333333333,2867.74576271186,1118.10169491525,41,34,75,100
"./Ship3_Latin-square/2019-10-04_12h11m_Subject 47639.txt","47639",2019-10-04,"12:11",8,81,60,11,10,21,14,5,3,22,25,8,5,38,752,100,143,995,148.6,144.3,2606.72881355932,1533.93103448276,71,64,135,98.3606557377049
"./Ship3_Latin-square/2019-10-04_12h11m_Subject 47649.txt","47649",2019-10-04,"12:11",2,74,60,5,9,14,27,2,0,29,3,0,4,7,622,59,133,814,206.866666666667,98.7333333333333,2891.49152542373,1681.49056603774,67,126,193,91.8032786885246
"./Ship3_Latin-square/2019-10-04_12h11m_Subject 47753.txt","47753",2019-10-04,"12:11",24,83,60,12,11,23,58,6,17,81,26,7,29,62,457,14,130,601,314.666666666667,172.716666666667,1860.98305084746,1218.22448979592,86,100,186,83.6065573770492
"./Ship3_Latin-square/2019-10-04_13h16m_Subject 46888.txt","46888",2019-10-04,"13:16",16,82,60,14,8,22,20,4,0,24,39,23,7,69,512,95,114,721,157.033333333333,127.05,2349.08474576271,1551.16949152542,59,55,114,100
"./Ship3_Latin-square/2019-10-04_13h16m_Subject 46889.txt","46889",2019-10-04,"13:16",2,83,60,8,15,23,11,1,2,14,22,3,10,35,1022,152,244,1418,85.2166666666667,165.366666666667,2874.57627118644,1729.79591836735,44,257,301,90.1639344262295
"./Ship3_Latin-square/2019-10-04_13h16m_Subject 46890.txt","46890",2019-10-04,"13:16",24,83,60,14,9,23,41,11,11,63,6,3,1,10,172,0,43,215,1163.46666666667,100.883333333333,1983.01694915254,2848.35294117647,86,60,146,62.2950819672131
"./Ship3_Latin-square/2019-10-04_13h16m_Subject 46898.txt","46898",2019-10-04,"13:16",0,78,60,9,9,18,21,1,5,27,53,5,9,67,738,100,65,903,109.3,136.366666666667,2999.83050847458,2080.87931034483,36,107,143,98.3606557377049
"./Ship3_Latin-square/2019-10-04_13h16m_Subject 47097.txt","47097",2019-10-04,"13:16",4,85,60,10,15,25,10,0,2,12,48,14,12,74,955,138,276,1369,80.95,190.516666666667,2762.67796610169,1385.91525423729,49,75,124,100
"./Ship3_Latin-square/2019-10-04_13h16m_Subject 47798.txt","47798",2019-10-04,"13:16",2,79,60,7,12,19,21,1,2,24,2,5,3,10,249,34,62,345,366.266666666667,92.3666666666667,2884.71186440678,1840.72222222222,42,118,160,75.4098360655738
"./Ship3_Latin-square/2019-10-04_13h17m_Subject 46876.txt","46876",2019-10-04,"13:17",4,79,60,10,9,19,29,2,1,32,10,6,9,25,593,67,121,781,244.466666666667,100.433333333333,2796.52542372881,1599.48275862069,35,80,115,98.3606557377049
"./Ship3_Latin-square/2019-10-04_13h17m_Subject 46877.txt","46877",2019-10-04,"13:17",2,77,60,8,9,17,14,0,2,16,33,2,5,40,1585,202,243,2030,76.5,165.8,2888.01694915254,1225.45762711864,61,51,112,98.3606557377049
"./Ship3_Latin-square/2019-10-04_13h17m_Subject 46895.txt","46895",2019-10-04,"13:17",2,78,60,7,11,18,48,2,10,60,27,8,9,44,382,66,77,525,471.916666666667,175.466666666667,2888.05084745763,1492.12280701754,47,45,92,98.3606557377049
"./Ship3_Latin-square/2019-10-04_13h17m_Subject 46897.txt","46897",2019-10-04,"13:17",8,70,53,12,5,17,92,20,10,122,35,6,2,43,147,21,22,190,1527.69230769231,337.769230769231,2692.25,3333.23076923077,70,80,150,75.4716981132076
"./Ship3_Latin-square/2019-10-04_13h17m_Subject 47769.txt","47769",2019-10-04,"13:17",8,81,60,12,9,21,30,3,4,37,46,15,8,69,637,123,79,839,210.9,169.133333333333,2633.84745762712,1636.13559322034,91,64,155,100
"./Ship3_Latin-square/2019-10-04_13h17m_Subject 47771.txt","47771",2019-10-04,"13:17",8,81,60,10,11,21,20,2,6,28,8,3,5,16,667,64,210,941,168.233333333333,97.55,2606.74576271186,1418.07142857143,17,74,91,96.7213114754098
"./Ship3_Latin-square/2019-10-04_13h17m_Subject 47775.txt","47775",2019-10-04,"13:17",8,78,60,10,8,18,48,8,11,67,15,4,3,22,440,55,67,562,338.816666666667,111.7,2593.13559322034,1342.13793103448,43,52,95,98.3606557377049
"./Ship3_Latin-square/2019-10-04_13h17m_Subject 47781.txt","47781",2019-10-04,"13:17",16,79,60,9,10,19,13,0,3,16,24,6,5,35,975,86,260,1321,98.3166666666667,145.8,2186.40677966102,1284.07547169811,50,168,218,95.0819672131148
"./Ship3_Latin-square/2019-10-04_13h17m_Subject 47783.txt","47783",2019-10-04,"13:17",16,82,60,14,8,22,39,6,4,49,34,23,1,58,625,57,125,807,363.416666666667,166.633333333333,2322,1545.18965517241,52,47,99,100
"./Ship3_Latin-square/2019-10-04_13h17m_Subject 47785.txt","47785",2019-10-04,"13:17",16,80,60,10,10,20,13,6,2,21,55,24,14,93,1187,125,317,1629,108.083333333333,117.833333333333,2186.42372881356,1197.14285714286,52,209,261,96.7213114754098
"./Ship3_Latin-square/2019-10-04_13h17m_Subject 47786.txt","47786",2019-10-04,"13:17",0,80,60,11,9,20,62,7,4,73,21,4,1,26,355,77,78,510,1066.98333333333,128.083333333333,2999.8813559322,2592.84482758621,59,44,103,98.3606557377049
"./Ship3_Latin-square/2019-10-04_14h23m_Subject 47080.txt","47080",2019-10-04,"14:23",16,81,60,8,13,21,6,2,1,9,59,6,6,71,900,85,203,1188,61.65,126.9,2105.05084745763,1347.36363636364,57,148,205,93.4426229508197
"./Ship3_Latin-square/2019-10-04_14h23m_Subject 47089.txt","47089",2019-10-04,"14:23",4,82,60,12,10,22,28,6,9,43,84,37,10,131,336,51,62,449,757.566666666667,403.033333333333,2816.91525423729,1798.39655172414,78,17,95,98.3606557377049
"./Ship3_Latin-square/2019-10-04_14h23m_Subject 47762.txt","47762",2019-10-04,"14:23",2,78,60,7,11,18,22,0,3,25,27,2,6,35,292,52,54,398,327.983333333333,159.083333333333,2884.67796610169,2189.94,72,81,153,91.8032786885246
"./Ship3_Latin-square/2019-10-04_14h23m_Subject 47791.txt","47791",2019-10-04,"14:23",2,78,60,8,10,18,8,0,0,8,9,2,2,13,831,119,154,1104,69.7333333333333,99.05,2884.66101694915,1393.45762711864,20,23,43,100
"./Ship3_Latin-square/2019-10-05_09h32m_Subject 46884.txt","46884",2019-10-05,"09:32",24,40,30,8,2,10,76,12,8,96,15,2,0,17,75,0,1,76,3891.26666666667,318.233333333333,2279.93333333333,3511.875,47,28,75,83.8709677419355
"./Ship3_Latin-square/2019-10-05_09h32m_Subject 47083.txt","47083",2019-10-05,"09:32",2,82,59,8,15,23,73,11,15,99,22,6,16,44,307,37,112,456,1057.48275862069,209.241379310345,2879.20689655172,2183.94230769231,71,80,151,93.2203389830508
"./Ship3_Latin-square/2019-10-05_09h32m_Subject 47086.txt","47086",2019-10-05,"09:32",8,78,60,6,12,18,25,0,2,27,17,1,4,22,484,45,125,654,189.416666666667,106.45,2552.50847457627,1203.40677966102,25,48,73,100
"./Ship3_Latin-square/2019-10-05_09h32m_Subject 47246.txt","47246",2019-10-05,"09:32",24,80,60,11,9,20,49,9,9,67,35,7,6,48,194,0,60,254,352.016666666667,263.866666666667,1779.59322033898,1507.80952380952,14,78,92,75.4098360655738
"./Ship3_Latin-square/2019-10-05_09h32m_Subject 47635.txt","47635",2019-10-05,"09:32",2,78,60,7,11,18,18,0,3,21,27,3,4,34,668,74,114,856,152.333333333333,163.416666666667,2884.74576271186,1478.15254237288,33,42,75,100
"./Ship3_Latin-square/2019-10-05_09h32m_Subject 47779.txt","47779",2019-10-05,"09:32",2,78,59,9,10,19,75,2,4,81,71,14,5,90,226,48,74,348,1306.27586206897,263.431034482759,2886.1724137931,2573.90243902439,29,107,136,83.0508474576271
"./Ship3_Latin-square/2019-10-05_09h32m_Subject 47790.txt","47790",2019-10-05,"09:32",24,80,57,14,9,23,48,14,15,77,46,14,15,75,222,13,62,297,617.571428571429,276.339285714286,2014.23214285714,1604.88888888889,49,76,125,82.4561403508772
"./Ship3_Latin-square/2019-10-05_09h32m_Subject 47797.txt","47797",2019-10-05,"09:32",0,78,57,4,17,21,35,2,10,47,29,6,26,61,336,30,101,467,1263.0350877193,202.087719298246,2999.9298245614,2524.92592592593,6,81,87,94.8275862068966
"./Ship3_Latin-square/2019-10-05_09h34m_Subject 46878.txt","46878",2019-10-05,"09:34",0,77,60,4,13,17,14,0,3,17,12,3,16,31,1003,80,201,1284,78.1333333333333,123.85,2999.89830508475,1465.67796610169,59,67,126,100
"./Ship3_Latin-square/2019-10-05_09h34m_Subject 46885.txt","46885",2019-10-05,"09:34",24,55,40,11,4,15,123,26,21,170,34,13,6,53,87,4,15,106,2452.46153846154,337.179487179487,2199.94871794872,3224.39473684211,55,31,86,97.5
"./Ship3_Latin-square/2019-10-05_09h34m_Subject 46899.txt","46899",2019-10-05,"09:34",2,77,60,8,9,17,12,3,1,16,27,6,5,38,888,93,147,1128,130.8,119.616666666667,2898.23728813559,780.813559322034,17,21,38,100
"./Ship3_Latin-square/2019-10-05_09h34m_Subject 47081.txt","47081",2019-10-05,"09:34",0,81,60,5,16,21,14,0,6,20,14,2,11,27,534,42,121,697,216.4,144.816666666667,2999.96610169492,1828.77192982456,37,115,152,96.7213114754098
"./Ship3_Latin-square/2019-10-05_09h34m_Subject 47091.txt","47091",2019-10-05,"09:34",2,79,60,7,12,19,8,0,4,12,44,5,2,51,263,30,47,340,119.566666666667,153.7,2888.10169491525,2110.59649122807,46,48,94,96.7213114754098
"./Ship3_Latin-square/2019-10-05_09h34m_Subject 47095.txt","47095",2019-10-05,"09:34",24,66,50,12,4,16,62,9,2,73,41,23,7,71,195,11,33,239,1943.97959183673,287.897959183673,2118.26530612245,2452.60416666667,38,35,73,98
"./Ship3_Latin-square/2019-10-05_09h34m_Subject 47238.txt","47238",2019-10-05,"09:34",16,77,60,10,7,17,27,4,5,36,36,12,8,56,488,60,56,604,253.466666666667,258.166666666667,2294.86440677966,934.542372881356,28,23,51,100
"./Ship3_Latin-square/2019-10-05_09h34m_Subject 47242.txt","47242",2019-10-05,"09:34",16,82,60,9,13,22,29,1,2,32,78,17,8,103,449,57,160,666,190.5,230.133333333333,2105.06779661017,977.754385964912,23,44,67,100
"./Ship3_Latin-square/2019-10-05_09h34m_Subject 47244.txt","47244",2019-10-05,"09:34",24,77,60,12,5,17,32,4,2,38,73,21,9,103,393,16,45,454,240.75,278.033333333333,2064.33898305085,1161.82456140351,70,64,134,98.3606557377049
"./Ship3_Latin-square/2019-10-05_09h34m_Subject 47633.txt","47633",2019-10-05,"09:34",0,78,60,8,10,18,14,2,3,19,59,12,7,78,416,40,71,527,248.916666666667,160.133333333333,2999.8813559322,2079.63157894737,81,62,143,98.3606557377049
"./Ship3_Latin-square/2019-10-05_09h34m_Subject 47636.txt","47636",2019-10-05,"09:34",2,77,60,6,11,17,53,7,13,73,115,5,4,124,468,47,56,571,456.733333333333,224.166666666667,2877.94915254237,2312.47457627119,105,114,219,100
"./Ship3_Latin-square/2019-10-05_09h34m_Subject 47752.txt","47752",2019-10-05,"09:34",2,80,60,8,12,20,43,5,5,53,22,9,9,40,733,99,90,922,528.016666666667,118.266666666667,2891.49152542373,1132.48275862069,47,57,104,98.3606557377049
"./Ship3_Latin-square/2019-10-05_09h34m_Subject 47767.txt","47767",2019-10-05,"09:34",16,81,60,12,9,21,27,5,3,35,44,14,5,63,195,36,43,274,467.116666666667,194.9,2240.66101694915,1823.9387755102,44,63,107,88.5245901639344
"./Ship3_Latin-square/2019-10-05_09h34m_Subject 47768.txt","47768",2019-10-05,"09:34",2,79,58,7,14,21,33,3,5,41,28,2,17,47,423,40,85,548,1013.06896551724,183.724137931034,2875.81034482759,2630.25490196078,62,115,177,91.5254237288136
"./Ship3_Latin-square/2019-10-05_09h34m_Subject 47780.txt","47780",2019-10-05,"09:34",4,77,60,8,9,17,50,5,9,64,41,12,4,57,413,54,56,523,529.966666666667,184.266666666667,2796.57627118644,1878.24137931034,48,61,109,100
"./Ship3_Latin-square/2019-10-05_10h43m_Subject 47229.txt","47229",2019-10-05,"10:43",16,81,60,10,11,21,24,6,4,34,28,14,10,52,587,52,126,765,122.633333333333,127,2132.1186440678,942.610169491525,22,60,82,100
"./Ship3_Latin-square/2019-10-05_10h43m_Subject 47233.txt","47233",2019-10-05,"10:43",24,81,60,9,12,21,59,3,8,70,36,10,12,58,249,11,107,367,218.283333333333,137.466666666667,1698.25423728814,866.086206896552,14,26,40,96.7213114754098
"./Ship3_Latin-square/2019-10-05_10h43m_Subject 47234.txt","47234",2019-10-05,"10:43",8,82,60,10,12,22,49,7,7,63,41,11,5,57,381,84,53,518,422.95,226.5,2593.15254237288,1579.01886792453,50,89,139,93.4426229508197
"./Ship3_Latin-square/2019-10-05_10h43m_Subject 47237.txt","47237",2019-10-05,"10:43",2,75,60,7,8,15,12,2,2,16,13,1,1,15,674,65,94,833,122.366666666667,145.616666666667,2894.86440677966,1006.52542372881,28,29,57,100
"./Ship3_Latin-square/2019-10-05_10h43m_Subject 47241.txt","47241",2019-10-05,"10:43",0,78,60,8,10,18,8,1,2,11,6,12,6,24,1012,163,193,1368,63.9,99.2333333333333,2999.93220338983,1548.52542372881,38,102,140,100
"./Ship3_Latin-square/2019-10-05_10h43m_Subject 47247.txt","47247",2019-10-05,"10:43",2,78,60,6,12,18,26,3,5,34,25,7,0,32,349,46,79,474,206.883333333333,173,2884.72881355932,2105.59649122807,69,53,122,96.7213114754098
"./Ship3_Latin-square/2019-10-05_10h43m_Subject 47777.txt","47777",2019-10-05,"10:43",4,78,60,6,12,18,26,2,4,32,21,2,8,31,453,34,89,576,208.016666666667,170.383333333333,2769.45762711864,1915.32203389831,42,51,93,100
"./Ship3_Latin-square/2019-10-05_10h43m_Subject 47784.txt","47784",2019-10-05,"10:43",2,77,60,6,11,17,18,1,3,22,46,5,13,64,1276,136,168,1580,136.383333333333,196.75,2888.06779661017,1231.05084745763,67,65,132,100
"./Ship3_Latin-square/2019-10-05_10h45m_Subject 46900.txt","46900",2019-10-05,"10:45",4,79,60,7,12,19,11,0,1,12,107,27,11,145,1055,143,249,1447,159.816666666667,186.483333333333,2769.49152542373,1183.86440677966,25,83,108,100
"./Ship3_Latin-square/2019-10-05_10h45m_Subject 46986.txt","46986",2019-10-05,"10:45",8,69,49,9,11,20,76,8,8,92,36,11,15,62,173,32,49,254,1774.67346938776,598.408163265306,2575.4693877551,2597.89130434783,42,61,103,96
"./Ship3_Latin-square/2019-10-05_10h45m_Subject 47076.txt","47076",2019-10-05,"10:45",16,80,60,12,8,20,11,2,2,15,18,22,3,43,528,46,84,658,107.716666666667,165.266666666667,2294.84745762712,1587.85714285714,70,94,164,86.8852459016393
"./Ship3_Latin-square/2019-10-05_10h45m_Subject 47079.txt","47079",2019-10-05,"10:45",24,69,50,11,8,19,59,9,28,96,65,28,9,102,137,10,30,177,1818.36734693878,352.775510204082,1971.38775510204,2818.40425531915,82,32,114,96
"./Ship3_Latin-square/2019-10-05_10h45m_Subject 47082.txt","47082",2019-10-05,"10:45",16,62,46,6,10,16,45,4,10,59,21,2,5,28,94,12,21,127,1802.64444444444,166.155555555556,2111.06666666667,3661.55555555556,38,60,98,86.9565217391304
"./Ship3_Latin-square/2019-10-05_10h45m_Subject 47092.txt","47092",2019-10-05,"10:45",24,80,60,9,11,20,25,1,8,34,53,11,18,82,459,0,150,609,256.716666666667,277.65,1820.32203389831,1096.45454545455,41,73,114,78.6885245901639
"./Ship3_Latin-square/2019-10-05_10h45m_Subject 47098.txt","47098",2019-10-05,"10:45",16,80,60,12,8,20,31,0,4,35,26,5,39,70,207,20,42,269,389.783333333333,186.066666666667,2294.86440677966,2016.28888888889,65,63,128,85.2459016393443
"./Ship3_Latin-square/2019-10-05_10h45m_Subject 47226.txt","47226",2019-10-05,"10:45",16,80,60,10,10,20,13,3,1,17,39,5,33,77,1774,197,399,2370,190.683333333333,93.25,2186.38983050847,956.384615384615,21,95,116,93.4426229508197
"./Ship3_Latin-square/2019-10-05_10h45m_Subject 47227.txt","47227",2019-10-05,"10:45",16,80,60,13,7,20,38,9,4,51,35,8,19,62,277,51,35,363,884.6,197.733333333333,2349.06779661017,1481.63636363636,65,54,119,93.4426229508197
"./Ship3_Latin-square/2019-10-05_10h45m_Subject 47645.txt","47645",2019-10-05,"10:45",8,82,60,11,11,22,79,15,9,103,16,2,4,22,268,55,74,397,1145.33333333333,149.766666666667,2606.69491525424,2205.61403508772,74,58,132,96.7213114754098
"./Ship3_Latin-square/2019-10-05_10h45m_Subject 47646.txt","47646",2019-10-05,"10:45",16,73,60,7,6,13,48,2,7,57,71,22,5,98,905,25,113,1043,337.65,118.7,2267.71186440678,1346.76363636364,37,77,114,95.0819672131148
"./Ship3_Latin-square/2019-10-05_10h45m_Subject 47755.txt","47755",2019-10-05,"10:45",2,81,60,10,11,21,35,4,2,41,15,13,7,35,679,82,121,882,264.016666666667,186.716666666667,2905.03389830508,1881.48275862069,77,170,247,98.3606557377049
"./Ship3_Latin-square/2019-10-05_10h45m_Subject 47760.txt","47760",2019-10-05,"10:45",24,81,60,10,11,21,70,3,33,106,56,44,3,103,419,4,71,494,333.4,232.75,1820.30508474576,921.305084745763,32,14,46,98.3606557377049
"./Ship3_Latin-square/2019-10-05_10h45m_Subject 47770.txt","47770",2019-10-05,"10:45",0,48,35,9,4,13,53,8,3,64,26,24,78,128,217,61,21,299,3098.34285714286,248.6,2999.88571428571,3734.84848484848,64,129,193,94.4444444444444
"./Ship3_Latin-square/2019-10-05_10h45m_Subject 47795.txt","47795",2019-10-05,"10:45",16,52,42,9,1,10,101,25,0,126,46,9,1,56,130,20,2,152,2578.07317073171,222.682926829268,2492.65853658537,2441.68292682927,53,19,72,97.6190476190476
"./Ship3_Latin-square/2019-10-05_11h54m_Subject 46881.txt","46881",2019-10-05,"11:54",16,77,60,8,9,17,24,1,7,32,49,14,7,70,445,30,122,597,208.033333333333,161.45,2159.27118644068,1194.32142857143,22,39,61,95.0819672131148
"./Ship3_Latin-square/2019-10-05_11h54m_Subject 47087.txt","47087",2019-10-05,"11:54",16,75,60,9,6,15,46,3,5,54,33,11,2,46,310,34,31,375,400.816666666667,146.216666666667,2294.86440677966,1307.49152542373,45,32,77,100
"./Ship3_Latin-square/2019-10-05_11h54m_Subject 47626.txt","47626",2019-10-05,"11:54",4,78,60,7,11,18,22,3,3,28,18,6,2,26,436,38,82,556,211.016666666667,144.55,2769.40677966102,1714.41818181818,77,79,156,96.7213114754098
"./Ship3_Latin-square/2019-10-05_11h54m_Subject 47632.txt","47632",2019-10-05,"11:54",4,74,60,5,9,14,26,0,3,29,19,2,4,25,996,96,108,1200,105.15,117.516666666667,2776.23728813559,1217.22033898305,35,56,91,100
"./Ship3_Latin-square/2019-10-05_11h54m_Subject 47634.txt","47634",2019-10-05,"11:54",16,79,60,12,7,19,36,7,2,45,32,8,10,50,310,43,50,403,440.25,166.283333333333,2321.98305084746,1522.27272727273,86,33,119,95.0819672131148
"./Ship3_Latin-square/2019-10-05_11h54m_Subject 47640.txt","47640",2019-10-05,"11:54",16,81,60,10,11,21,48,4,12,64,35,7,9,51,352,21,59,432,677.666666666667,167,2186.40677966102,1450.41818181818,25,41,66,96.7213114754098
"./Ship3_Latin-square/2019-10-05_11h54m_Subject 47800.txt","47800",2019-10-05,"11:54",8,79,60,10,9,19,63,7,6,76,48,14,12,74,284,46,48,378,596.5,168.633333333333,2647.42372881356,2129.37931034483,48,79,127,96.7213114754098
"./Ship3_Latin-square/2019-10-05_11h56m_Subject 46880.txt","46880",2019-10-05,"11:56",16,76,60,8,8,16,14,0,0,14,20,9,3,32,551,35,111,697,141.5,124.666666666667,2186.40677966102,1352.71428571429,62,106,168,86.8852459016393
"./Ship3_Latin-square/2019-10-05_11h56m_Subject 46882.txt","46882",2019-10-05,"11:56",8,82,60,11,11,22,13,0,1,14,84,22,23,129,1039,119,319,1477,148.583333333333,163.5,2606.71186440678,1562.55555555556,26,197,223,86.8852459016393
"./Ship3_Latin-square/2019-10-05_11h56m_Subject 46883.txt","46883",2019-10-05,"11:56",2,80,60,7,13,20,12,1,3,16,15,13,3,31,605,69,130,804,126.416666666667,130.816666666667,2891.45762711864,1242.74137931034,25,21,46,100
"./Ship3_Latin-square/2019-10-05_11h56m_Subject 46896.txt","46896",2019-10-05,"11:56",8,81,60,9,12,21,18,2,1,21,15,9,8,32,929,100,136,1165,144.45,118.333333333333,2579.61016949153,1028.05084745763,25,25,50,100
"./Ship3_Latin-square/2019-10-05_11h56m_Subject 47649.txt","47649",2019-10-05,"11:56",24,79,60,12,7,19,54,3,5,62,25,5,1,31,257,12,42,311,550.866666666667,187.45,1983.03389830508,1560.93023255814,62,60,122,80.327868852459
"./Ship3_Latin-square/2019-10-05_11h56m_Subject 47753.txt","47753",2019-10-05,"11:56",2,79,60,10,9,19,43,0,1,44,40,8,3,51,767,134,127,1028,164.566666666667,234.316666666667,2901.59322033898,1480.98275862069,61,113,174,98.3606557377049
"./Ship3_Latin-square/2019-10-05_12h58m_Subject 46888.txt","46888",2019-10-05,"12:58",8,78,60,9,9,18,32,1,4,37,28,3,5,36,554,86,98,738,568.7,126.616666666667,2593.13559322034,1983.76785714286,58,41,99,95.0819672131148
"./Ship3_Latin-square/2019-10-05_12h58m_Subject 46889.txt","46889",2019-10-05,"12:58",24,77,59,12,6,18,54,12,25,91,50,23,6,79,393,15,40,448,366.101694915254,336.305084745763,2064.35593220339,1285.57142857143,71,76,147,83.3333333333333
"./Ship3_Latin-square/2019-10-05_12h58m_Subject 46890.txt","46890",2019-10-05,"12:58",0,81,60,10,11,21,21,4,1,26,2,5,3,10,460,54,126,640,1471.2,86.4333333333333,2999.86440677966,2012.08333333333,77,96,173,86.8852459016393
"./Ship3_Latin-square/2019-10-05_12h58m_Subject 46898.txt","46898",2019-10-05,"12:58",4,79,60,10,9,19,41,10,3,54,34,14,2,50,528,71,69,668,945,229.15,2789.81355932203,2421.05882352941,35,105,140,86.8852459016393
"./Ship3_Latin-square/2019-10-05_12h58m_Subject 47097.txt","47097",2019-10-05,"12:58",16,77,60,11,6,17,14,5,2,21,68,20,2,90,683,88,104,875,105.15,213,2322.03389830508,918.457627118644,43,30,73,100
"./Ship3_Latin-square/2019-10-05_12h58m_Subject 47798.txt","47798",2019-10-05,"12:58",0,79,60,5,14,19,16,0,1,17,10,1,1,12,287,30,73,390,943.283333333333,110.583333333333,2999.91525423729,2786.60975609756,58,82,140,85.2459016393443
"./Ship3_Latin-square/2019-10-05_13h00m_Subject 46876.txt","46876",2019-10-05,"13:00",16,59,46,8,5,13,45,1,8,54,14,8,9,31,249,30,37,316,445.955555555556,127.644444444444,2288.77777777778,1366.75,30,31,61,97.8260869565217
"./Ship3_Latin-square/2019-10-05_13h00m_Subject 46877.txt","46877",2019-10-05,"13:00",0,83,60,7,16,23,17,1,1,19,25,4,13,42,1434,208,342,1984,76.8,148.516666666667,2999.8813559322,1280.83050847458,33,69,102,98.3606557377049
"./Ship3_Latin-square/2019-10-05_13h00m_Subject 46895.txt","46895",2019-10-05,"13:00",24,45,34,7,4,11,49,9,14,72,49,27,35,111,64,4,11,79,2907.17647058824,576.294117647059,1909.09090909091,3907.64516129032,20,60,80,94.1176470588235
"./Ship3_Latin-square/2019-10-05_13h00m_Subject 46897.txt","46897",2019-10-05,"13:00",2,81,60,8,13,21,62,6,22,90,41,18,33,92,365,29,93,487,702.233333333333,193.55,2884.61016949153,2720.31111111111,41,149,190,78.6885245901639
"./Ship3_Latin-square/2019-10-05_13h00m_Subject 47781.txt","47781",2019-10-05,"13:00",8,77,58,6,13,19,18,2,6,26,18,1,6,25,892,73,315,1280,572.206896551724,160.48275862069,2544.77586206897,1418.58823529412,54,88,142,88.135593220339
"./Ship3_Latin-square/2019-10-05_13h00m_Subject 47783.txt","47783",2019-10-05,"13:00",8,78,60,10,8,18,36,10,5,51,41,11,8,60,679,80,100,859,358.716666666667,141.65,2647.35593220339,1973.27586206897,35,97,132,98.3606557377049
"./Ship3_Latin-square/2019-10-05_13h00m_Subject 47785.txt","47785",2019-10-05,"13:00",8,81,60,11,10,21,17,2,2,21,86,19,10,115,1738,244,271,2253,198.75,128.066666666667,2606.74576271186,1455.15254237288,31,148,179,100
"./Ship3_Latin-square/2019-10-05_13h00m_Subject 47786.txt","47786",2019-10-05,"13:00",4,50,37,6,7,13,64,8,25,97,20,7,0,27,90,12,23,125,2126.2972972973,147.891891891892,2805.35135135135,3273.91891891892,31,7,38,100
"./Ship3_Latin-square/2019-10-05_14h02m_Subject 47080.txt","47080",2019-10-05,"14:02",8,77,60,7,10,17,8,2,1,11,49,7,15,71,1203,83,218,1504,72.9,101.65,2566.03389830508,1287.1724137931,46,90,136,100
"./Ship3_Latin-square/2019-10-05_14h02m_Subject 47089.txt","47089",2019-10-05,"14:02",16,64,48,10,6,16,33,4,3,40,48,98,7,153,209,20,29,258,570.416666666667,246.340425531915,2421.21276595745,1262.64444444444,55,15,70,95.8333333333333
"./Ship3_Latin-square/2019-10-05_14h02m_Subject 47762.txt","47762",2019-10-05,"14:02",0,79,60,10,9,19,40,6,3,49,12,3,1,16,267,55,33,355,420.75,112.933333333333,2999.86440677966,2330.16363636364,58,52,110,93.4426229508197
"./Ship3_Latin-square/2019-10-05_14h02m_Subject 47791.txt","47791",2019-10-05,"14:02",24,79,60,10,9,19,15,3,2,20,27,4,3,34,397,13,67,477,115.3,134.966666666667,1901.62711864407,1187.1914893617,22,67,89,83.6065573770492
"./Ship3_Latin-square/2019-10-06_09h57m_Subject 46878.txt","46878",2019-10-06,"09:57",2,81,60,10,11,21,12,1,2,15,17,3,8,28,929,150,179,1258,80.8666666666667,146.933333333333,2891.49152542373,1612,71,66,137,100
"./Ship3_Latin-square/2019-10-06_09h57m_Subject 46885.txt","46885",2019-10-06,"09:57",4,79,60,7,12,19,73,6,10,89,15,2,3,20,347,43,85,475,747.866666666667,111.633333333333,2769.42372881356,2137.05084745763,47,55,102,100
"./Ship3_Latin-square/2019-10-06_09h57m_Subject 46899.txt","46899",2019-10-06,"09:57",24,78,60,15,3,18,110,6,10,126,35,9,9,53,593,7,33,633,658.816666666667,151.083333333333,2227.05084745763,783.982456140351,37,28,65,96.7213114754098
"./Ship3_Latin-square/2019-10-06_09h57m_Subject 47081.txt","47081",2019-10-06,"09:57",4,79,60,4,15,19,18,0,3,21,19,0,6,25,620,41,172,833,122.533333333333,187.716666666667,2735.54237288136,1602.96363636364,31,93,124,96.7213114754098
"./Ship3_Latin-square/2019-10-06_09h57m_Subject 47091.txt","47091",2019-10-06,"09:57",24,77,60,7,10,17,24,0,4,28,49,8,9,66,187,8,45,240,202.75,152.716666666667,1738.94915254237,1203.15094339623,34,52,86,91.8032786885246
"./Ship3_Latin-square/2019-10-06_09h57m_Subject 47095.txt","47095",2019-10-06,"09:57",2,81,60,9,12,21,27,0,5,32,18,7,7,32,473,90,89,652,293.183333333333,143.4,2888.05084745763,1985.0350877193,56,74,130,96.7213114754098
"./Ship3_Latin-square/2019-10-06_09h57m_Subject 47231.txt","47231",2019-10-06,"09:57",2,81,58,6,17,23,43,5,9,57,31,9,29,69,188,18,39,245,979.241379310345,180.551724137931,2866.63157894737,1849.05660377358,22,62,84,96.6101694915254
"./Ship3_Latin-square/2019-10-06_09h57m_Subject 47238.txt","47238",2019-10-06,"09:57",8,85,60,13,12,25,15,1,2,18,45,23,31,99,583,125,128,836,143.066666666667,172.416666666667,2579.57627118644,1574.8431372549,40,123,163,88.5245901639344
"./Ship3_Latin-square/2019-10-06_09h57m_Subject 47242.txt","47242",2019-10-06,"09:57",8,82,60,9,13,22,25,3,4,32,27,26,7,60,578,87,149,814,248.833333333333,120.466666666667,2566.05084745763,1356.89830508475,61,80,141,100
"./Ship3_Latin-square/2019-10-06_09h57m_Subject 47244.txt","47244",2019-10-06,"09:57",4,77,60,7,10,17,13,0,5,18,26,7,8,41,813,80,107,1000,101.966666666667,164.333333333333,2776.22033898305,1501.66101694915,84,78,162,100
"./Ship3_Latin-square/2019-10-06_09h57m_Subject 47633.txt","47633",2019-10-06,"09:57",2,78,60,9,9,18,22,3,12,37,54,8,12,74,361,65,66,492,235.133333333333,151.266666666667,2894.86440677966,1795.54385964912,65,86,151,98.3606557377049
"./Ship3_Latin-square/2019-10-06_09h57m_Subject 47636.txt","47636",2019-10-06,"09:57",0,71,52,5,14,19,43,4,13,60,104,9,56,169,297,49,106,452,990.137254901961,321.823529411765,2999.86274509804,3137,63,127,190,94.2307692307692
"./Ship3_Latin-square/2019-10-06_09h57m_Subject 47752.txt","47752",2019-10-06,"09:57",24,55,39,10,6,16,57,18,6,81,32,45,23,100,167,22,20,209,1026.69230769231,190.717948717949,2076.87179487179,1719.97368421053,55,25,80,97.5
"./Ship3_Latin-square/2019-10-06_09h57m_Subject 47767.txt","47767",2019-10-06,"09:57",8,79,60,8,11,19,31,4,3,38,52,4,24,80,267,34,57,358,464.2,191.566666666667,2566.08474576271,2062.58181818182,53,69,122,96.7213114754098
"./Ship3_Latin-square/2019-10-06_09h57m_Subject 47768.txt","47768",2019-10-06,"09:57",0,80,59,3,18,21,30,1,5,36,28,0,19,47,453,17,177,647,977.559322033898,139.610169491525,2999.89655172414,2422.57407407407,35,95,130,96.6666666666667
"./Ship3_Latin-square/2019-10-06_09h57m_Subject 47780.txt","47780",2019-10-06,"09:57",2,81,60,6,15,21,45,5,10,60,52,10,23,85,400,54,141,595,564.95,157.8,2864.37288135593,1931.66666666667,43,93,136,93.4426229508197
"./Ship3_Latin-square/2019-10-06_10h01m_Subject 46884.txt","46884",2019-10-06,"10:01",4,77,59,9,9,18,40,4,9,53,18,1,11,30,283,31,37,351,1165.45762711864,251.440677966102,2806.86206896552,2891.87804878049,82,101,183,81.6666666666667
"./Ship3_Latin-square/2019-10-06_10h01m_Subject 47083.txt","47083",2019-10-06,"10:01",24,81,60,12,9,21,90,6,15,111,62,21,10,93,210,9,59,278,957.983333333333,245.283333333333,1942.32203389831,1910.76923076923,123,55,178,88.5245901639344
"./Ship3_Latin-square/2019-10-06_10h01m_Subject 47086.txt","47086",2019-10-06,"10:01",0,80,60,11,9,20,23,8,3,34,12,2,3,17,487,93,87,667,254.216666666667,111.25,2999.93220338983,1515.83050847458,33,87,120,100
"./Ship3_Latin-square/2019-10-06_10h01m_Subject 47246.txt","47246",2019-10-06,"10:01",4,78,60,7,11,18,20,5,6,31,6,1,10,17,404,51,99,554,154,126,2769.45762711864,1891.23636363636,26,96,122,91.8032786885246
"./Ship3_Latin-square/2019-10-06_10h01m_Subject 47635.txt","47635",2019-10-06,"10:01",0,82,60,2,20,22,56,1,5,62,47,3,18,68,528,9,44,581,890.566666666667,180.466666666667,2999.91525423729,2012.84210526316,25,60,85,96.7213114754098
"./Ship3_Latin-square/2019-10-06_10h01m_Subject 47779.txt","47779",2019-10-06,"10:01",0,80,60,9,11,20,23,1,7,31,51,8,1,60,293,44,46,383,621.55,167,2999.93220338983,2733.88235294118,36,87,123,90.1639344262295
"./Ship3_Latin-square/2019-10-06_10h01m_Subject 47790.txt","47790",2019-10-06,"10:01",2,76,60,7,9,16,43,2,4,49,68,14,2,84,577,33,73,683,428.716666666667,426.8,2891.47457627119,2414.30769230769,81,153,234,90.1639344262295
"./Ship3_Latin-square/2019-10-06_10h01m_Subject 47797.txt","47797",2019-10-06,"10:01",4,84,60,10,14,24,41,5,7,53,34,6,9,49,349,60,96,505,730.203389830509,212.559322033898,2783.03389830508,2261.07843137255,24,126,150,91.6666666666667
"./Ship3_Latin-square/2019-10-06_11h11m_Subject 46900.txt","46900",2019-10-06,"11:11",16,85,60,14,11,25,27,2,7,36,53,68,8,129,621,58,150,829,160.733333333333,186.383333333333,2294.83050847458,1139.17307692308,32,76,108,90.1639344262295
"./Ship3_Latin-square/2019-10-06_11h11m_Subject 46986.txt","46986",2019-10-06,"11:11",0,81,60,8,13,21,38,8,6,52,15,6,7,28,325,52,61,438,614.85,139.116666666667,2999.79661016949,2690.32,82,86,168,88.5245901639344
"./Ship3_Latin-square/2019-10-06_11h11m_Subject 47076.txt","47076",2019-10-06,"11:11",8,79,60,11,8,19,8,1,3,12,16,7,7,30,788,100,125,1013,71,165.916666666667,2647.38983050847,1649.79310344828,66,88,154,96.7213114754098
"./Ship3_Latin-square/2019-10-06_11h11m_Subject 47079.txt","47079",2019-10-06,"11:11",4,80,60,10,10,20,25,4,3,32,46,13,7,66,434,98,61,593,443.683333333333,185.733333333333,2803.32203389831,1979.66101694915,75,40,115,100
"./Ship3_Latin-square/2019-10-06_11h11m_Subject 47082.txt","47082",2019-10-06,"11:11",8,71,53,10,8,18,41,13,2,56,52,15,2,69,205,36,34,275,1345.82692307692,277.461538461538,2646.05769230769,2837.12244897959,62,42,104,100
"./Ship3_Latin-square/2019-10-06_11h11m_Subject 47092.txt","47092",2019-10-06,"11:11",4,79,60,7,12,19,12,2,4,18,23,6,1,30,933,112,197,1242,85.4166666666667,171.4,2776.27118644068,1539.15254237288,58,106,164,100
"./Ship3_Latin-square/2019-10-06_11h11m_Subject 47098.txt","47098",2019-10-06,"11:11",2,83,60,9,14,23,13,1,1,15,6,4,2,12,565,78,137,780,177.066666666667,109.766666666667,2884.67796610169,1378.89830508475,27,70,97,100
"./Ship3_Latin-square/2019-10-06_11h11m_Subject 47226.txt","47226",2019-10-06,"11:11",8,79,60,7,12,19,13,2,1,16,131,20,7,158,2543,208,700,3451,137.366666666667,171.233333333333,2552.52542372881,1299.31578947368,72,117,189,100
"./Ship3_Latin-square/2019-10-06_11h11m_Subject 47227.txt","47227",2019-10-06,"11:11",8,82,60,10,12,22,33,3,9,45,11,16,15,42,355,67,60,482,680.866666666667,123.566666666667,2579.62711864407,1942.01960784314,45,122,167,86.8852459016393
"./Ship3_Latin-square/2019-10-06_11h11m_Subject 47250.txt","47250",2019-10-06,"11:11",8,80,60,11,9,20,7,3,1,11,11,32,2,45,905,167,158,1230,75.5166666666667,87.1166666666667,2620.27118644068,1216.12068965517,45,66,111,98.3606557377049
"./Ship3_Latin-square/2019-10-06_11h11m_Subject 47645.txt","47645",2019-10-06,"11:11",0,81,59,8,14,22,72,7,14,93,11,1,9,21,316,46,58,420,1147.42372881356,145.118644067797,2999.89830508475,2554.17857142857,55,103,158,95
"./Ship3_Latin-square/2019-10-06_11h11m_Subject 47646.txt","47646",2019-10-06,"11:11",8,76,60,7,9,16,26,0,0,26,61,8,22,91,1375,103,313,1791,190.683333333333,119.45,2566.01694915254,1520,25,60,85,100
"./Ship3_Latin-square/2019-10-06_11h11m_Subject 47755.txt","47755",2019-10-06,"11:11",24,85,60,13,12,25,111,14,24,149,47,19,35,101,288,13,95,396,668.433333333333,221.25,1861,1787.69565217391,72,153,225,80.327868852459
"./Ship3_Latin-square/2019-10-06_11h11m_Subject 47760.txt","47760",2019-10-06,"11:11",4,73,60,6,7,13,25,1,5,31,28,8,3,39,800,77,158,1035,148.116666666667,188.866666666667,2803.37288135593,1318.74576271186,32,30,62,98.3606557377049
"./Ship3_Latin-square/2019-10-06_11h11m_Subject 47770.txt","47770",2019-10-06,"11:11",2,61,44,5,12,17,45,13,3,61,43,8,15,66,189,22,51,262,2647,241.863636363636,2872.70454545455,3675.58333333333,51,111,162,88.8888888888889
"./Ship3_Latin-square/2019-10-06_11h11m_Subject 47795.txt","47795",2019-10-06,"11:11",8,78,60,12,6,18,61,15,6,82,62,29,1,92,464,40,42,546,640.566666666667,190.15,2674.54237288136,2144.68965517241,76,52,128,98.3606557377049
"./Ship3_Latin-square/2019-10-06_11h15m_Subject 47229.txt","47229",2019-10-06,"11:15",8,77,60,8,9,17,26,2,3,31,29,10,2,41,652,73,91,816,128.433333333333,122.716666666667,2579.64406779661,1404.56140350877,26,67,93,96.7213114754098
"./Ship3_Latin-square/2019-10-06_11h15m_Subject 47233.txt","47233",2019-10-06,"11:15",4,80,60,7,13,20,68,2,28,98,33,5,8,46,553,59,154,766,194.266666666667,158.133333333333,2776.22033898305,1645.01724137931,40,146,186,98.3606557377049
"./Ship3_Latin-square/2019-10-06_11h15m_Subject 47234.txt","47234",2019-10-06,"11:15",0,78,60,6,12,18,30,5,6,41,79,5,27,111,600,103,95,798,235.833333333333,259.516666666667,2999.94915254237,1209.78947368421,49,81,130,96.7213114754098
"./Ship3_Latin-square/2019-10-06_11h15m_Subject 47237.txt","47237",2019-10-06,"11:15",8,77,60,10,7,17,34,3,4,41,62,11,13,86,420,66,50,536,319.65,449.35,2620.22033898305,1359.96551724138,45,35,80,98.3606557377049
"./Ship3_Latin-square/2019-10-06_11h15m_Subject 47241.txt","47241",2019-10-06,"11:15",4,82,60,9,13,22,14,1,3,18,10,15,7,32,891,98,248,1237,100.7,114.183333333333,2762.71186440678,1340.08928571429,52,96,148,96.7213114754098
"./Ship3_Latin-square/2019-10-06_11h15m_Subject 47247.txt","47247",2019-10-06,"11:15",24,54,41,7,6,13,101,13,15,129,48,14,6,68,93,0,22,115,2499.875,581.125,1979.925,2300.7,14,41,55,100
"./Ship3_Latin-square/2019-10-06_11h15m_Subject 47777.txt","47777",2019-10-06,"11:15",16,78,60,6,12,18,75,9,12,96,51,30,8,89,236,19,50,305,842.816666666667,210.033333333333,2050.79661016949,1787.17543859649,58,63,121,96.7213114754098
"./Ship3_Latin-square/2019-10-06_11h15m_Subject 47784.txt","47784",2019-10-06,"11:15",24,78,60,12,6,18,170,23,15,208,93,30,6,129,368,7,58,433,950.633333333333,245.3,2064.30508474576,1197.08620689655,65,51,116,98.3606557377049
"./Ship3_Latin-square/2019-10-06_12h20m_Subject 46880.txt","46880",2019-10-06,"12:20",8,82,60,10,12,22,9,0,2,11,17,12,4,33,739,84,139,962,91.1333333333333,120.483333333333,2566.06779661017,1622.89583333333,64,181,245,85.2459016393443
"./Ship3_Latin-square/2019-10-06_12h20m_Subject 46883.txt","46883",2019-10-06,"12:20",24,78,60,11,7,18,87,10,17,114,68,33,5,106,217,0,43,260,757.216666666667,326.85,1942.30508474576,1322.64,26,55,81,85.2459016393443
"./Ship3_Latin-square/2019-10-06_12h20m_Subject 46896.txt","46896",2019-10-06,"12:20",4,80,60,8,12,20,17,5,2,24,12,7,7,26,735,99,118,952,264.55,115.883333333333,2769.45762711864,1643.91525423729,28,27,55,100
"./Ship3_Latin-square/2019-10-06_12h20m_Subject 47649.txt","47649",2019-10-06,"12:20",4,82,60,9,13,22,34,1,5,40,8,4,1,13,578,80,172,830,319.6,131.95,2769.4406779661,1821.62857142857,41,277,318,75.4098360655738
"./Ship3_Latin-square/2019-10-06_12h20m_Subject 47753.txt","47753",2019-10-06,"12:20",0,80,60,8,12,20,16,1,2,19,13,3,7,23,821,133,129,1083,113.133333333333,151.583333333333,2999.91525423729,1576.84745762712,70,104,174,100
"./Ship3_Latin-square/2019-10-06_12h24m_Subject 46881.txt","46881",2019-10-06,"12:24",8,80,60,10,10,20,26,3,0,29,64,26,6,96,795,122,138,1055,171,214.45,2620.33898305085,1567.36206896552,53,65,118,98.3606557377049
"./Ship3_Latin-square/2019-10-06_12h24m_Subject 47087.txt","47087",2019-10-06,"12:24",8,75,60,8,7,15,19,2,4,25,39,43,2,84,361,41,41,443,173.416666666667,141.15,2633.84745762712,1580.15254237288,48,36,84,100
"./Ship3_Latin-square/2019-10-06_12h24m_Subject 47626.txt","47626",2019-10-06,"12:24",16,76,60,10,6,16,29,2,2,33,32,5,7,44,365,49,45,459,253.066666666667,168.483333333333,2240.64406779661,1324.81034482759,62,47,109,98.3606557377049
"./Ship3_Latin-square/2019-10-06_12h24m_Subject 47632.txt","47632",2019-10-06,"12:24",16,79,60,10,9,19,16,4,2,22,19,9,3,31,536,51,122,709,107.1,126.4,2213.52542372881,1067.34545454545,32,45,77,93.4426229508197
"./Ship3_Latin-square/2019-10-06_12h24m_Subject 47634.txt","47634",2019-10-06,"12:24",8,84,60,12,12,24,64,10,7,81,13,4,7,24,353,64,90,507,473.866666666667,124.683333333333,2593.18644067797,1710.12068965517,77,41,118,98.3606557377049
"./Ship3_Latin-square/2019-10-06_12h24m_Subject 47640.txt","47640",2019-10-06,"12:24",8,84,60,14,10,24,37,5,5,47,17,7,6,30,399,89,80,568,764.316666666667,129.733333333333,2633.8813559322,2158.75510204082,39,71,110,86.8852459016393
"./Ship3_Latin-square/2019-10-06_13h39m_Subject 46876.txt","46876",2019-10-06,"13:39",8,83,60,12,11,23,24,3,4,31,23,9,8,40,416,62,151,629,251.333333333333,173.133333333333,2633.86440677966,1438.01724137931,43,45,88,98.3606557377049
"./Ship3_Latin-square/2019-10-06_13h39m_Subject 46877.txt","46877",2019-10-06,"13:39",2,82,60,10,12,22,6,0,0,6,47,27,13,87,1459,241,317,2017,57.3,184.766666666667,2894.8813559322,1228.08474576271,53,72,125,100
"./Ship3_Latin-square/2019-10-06_13h39m_Subject 46895.txt","46895",2019-10-06,"13:39",4,84,60,13,11,24,29,6,1,36,25,11,8,44,321,78,39,438,467.65,151.2,2803.33898305085,1826.61818181818,35,45,80,95.0819672131148
"./Ship3_Latin-square/2019-10-06_13h39m_Subject 46897.txt","46897",2019-10-06,"13:39",16,81,59,14,8,22,71,17,7,95,29,13,7,49,134,20,19,173,1091.40677966102,182.559322033898,2321.98305084746,2387.16666666667,29,66,95,85
"./Ship3_Latin-square/2019-10-06_13h39m_Subject 47786.txt","47786",2019-10-06,"13:39",2,78,60,7,11,18,45,6,3,54,30,11,4,45,411,28,94,533,758.383333333333,165.75,2888.08474576271,2269.3275862069,40,26,66,98.3606557377049
"./Ship3_Latin-square/2019-10-06_13h40m_Subject 46889.txt","46889",2019-10-06,"13:40",4,79,60,7,12,19,10,0,2,12,23,0,3,26,1127,154,225,1506,57.9833333333333,114.8,2762.62711864407,1556.20689655172,68,186,254,98.3606557377049
"./Ship3_Latin-square/2019-10-06_13h40m_Subject 46890.txt","46890",2019-10-06,"13:40",16,79,60,10,9,19,19,3,1,23,13,8,8,29,269,29,49,347,298.55,165.966666666667,2240.62711864407,1774.7,55,73,128,86.8852459016393
"./Ship3_Latin-square/2019-10-06_13h40m_Subject 46898.txt","46898",2019-10-06,"13:40",2,76,60,5,11,16,26,4,6,36,46,4,14,64,653,52,80,785,147.116666666667,150.1,2881.32203389831,1924.29310344828,29,116,145,98.3606557377049
"./Ship3_Latin-square/2019-10-06_13h40m_Subject 47097.txt","47097",2019-10-06,"13:40",8,76,60,7,9,16,17,1,2,20,55,10,4,69,909,82,150,1141,94.9833333333333,209.55,2579.61016949153,1156.25423728814,45,85,130,100
"./Ship3_Latin-square/2019-10-06_13h40m_Subject 47798.txt","47798",2019-10-06,"13:40",2,81,60,7,14,21,24,1,3,28,7,2,0,9,264,18,50,332,483.233333333333,114.916666666667,2877.91525423729,2058.65909090909,41,97,138,88.5245901639344
"./Ship3_Latin-square/2019-10-06_14h41m_Subject 47089.txt","47089",2019-10-06,"14:41",8,81,60,14,7,21,40,8,5,53,60,51,3,114,350,46,46,442,555.816666666667,248.75,2701.64406779661,1672.32203389831,82,23,105,100
"./Ship3_Latin-square/2019-10-06_14h41m_Subject 47762.txt","47762",2019-10-06,"14:41",2,80,60,10,10,20,34,7,1,42,29,4,1,34,190,36,30,256,670.016666666667,196.2,2901.66101694915,2745.57142857143,91,43,134,77.0491803278689
"./Ship3_Latin-square/2019-10-06_14h41m_Subject 47791.txt","47791",2019-10-06,"14:41",4,79,60,9,10,19,26,1,1,28,13,13,7,33,559,68,119,746,264.183333333333,102.816666666667,2789.76271186441,1733.63157894737,32,21,53,100
"./Ship3_Latin-square/2019-10-07_10h13m_Subject 46878.txt","46878",2019-10-07,"10:13",24,82,60,11,11,22,23,3,10,36,35,18,18,71,436,14,145,595,152.6,196.55,1820.27118644068,1120.51162790698,57,94,151,80.327868852459
"./Ship3_Latin-square/2019-10-07_10h13m_Subject 46885.txt","46885",2019-10-07,"10:13",16,81,60,11,10,21,84,14,15,113,28,14,7,49,225,37,47,309,1173.93333333333,146.716666666667,2240.64406779661,1942.81818181818,82,59,141,93.4426229508197
"./Ship3_Latin-square/2019-10-07_10h13m_Subject 46899.txt","46899",2019-10-07,"10:13",4,77,60,7,10,17,11,0,1,12,23,3,5,31,918,88,192,1198,96.9166666666667,129.516666666667,2783.03389830508,1003.16949152542,32,59,91,100
"./Ship3_Latin-square/2019-10-07_10h13m_Subject 47081.txt","47081",2019-10-07,"10:13",2,81,60,7,14,21,12,4,6,22,26,4,18,48,571,61,167,799,128.833333333333,167.116666666667,2877.94915254237,1872.29824561404,36,80,116,96.7213114754098
"./Ship3_Latin-square/2019-10-07_10h13m_Subject 47091.txt","47091",2019-10-07,"10:13",4,80,60,12,8,20,9,3,0,12,49,20,6,75,236,47,36,319,173.466666666667,152.166666666667,2823.67796610169,1830.38983050847,51,38,89,100
"./Ship3_Latin-square/2019-10-07_10h13m_Subject 47095.txt","47095",2019-10-07,"10:13",0,79,60,5,14,19,18,0,2,20,23,5,10,38,563,56,93,712,193.066666666667,158.566666666667,2999.89830508475,1984.0350877193,28,150,178,96.7213114754098
"./Ship3_Latin-square/2019-10-07_10h13m_Subject 47231.txt","47231",2019-10-07,"10:13",24,69,50,12,7,19,64,16,15,95,68,16,18,102,119,17,44,180,1713.52,592.08,2020.34693877551,2112.37777777778,51,38,89,92
"./Ship3_Latin-square/2019-10-07_10h13m_Subject 47244.txt","47244",2019-10-07,"10:13",16,80,60,10,10,20,17,4,3,24,50,25,9,84,601,66,140,807,155.216666666667,251.266666666667,2186.38983050847,1372.62711864407,63,82,145,100
"./Ship3_Latin-square/2019-10-07_10h13m_Subject 47633.txt","47633",2019-10-07,"10:13",24,77,60,10,7,17,71,11,7,89,73,16,9,98,208,9,26,243,512.383333333333,187.916666666667,1861.01694915254,1530.27586206897,92,83,175,98.3606557377049
"./Ship3_Latin-square/2019-10-07_10h13m_Subject 47636.txt","47636",2019-10-07,"10:13",2,77,60,8,9,17,61,5,5,71,40,9,8,57,481,62,65,608,391.333333333333,158.316666666667,2894.8813559322,2420.40350877193,110,120,230,98.3606557377049
"./Ship3_Latin-square/2019-10-07_10h13m_Subject 47752.txt","47752",2019-10-07,"10:13",4,83,60,9,14,23,45,7,5,57,17,8,5,30,572,93,183,848,724.533333333333,105.116666666667,2769.47457627119,1757.16981132075,66,66,132,90.1639344262295
"./Ship3_Latin-square/2019-10-07_10h13m_Subject 47768.txt","47768",2019-10-07,"10:13",2,79,60,8,11,19,19,2,6,27,32,4,9,45,671,67,118,856,349.85,129.6,2898.23728813559,1914.38181818182,64,73,137,95.0819672131148
"./Ship3_Latin-square/2019-10-07_10h13m_Subject 47780.txt","47780",2019-10-07,"10:13",0,81,60,11,10,21,39,4,5,48,45,15,16,76,513,80,101,694,349.866666666667,155.766666666667,2999.94915254237,1647.81355932203,58,32,90,100
"./Ship3_Latin-square/2019-10-07_10h16m_Subject 46884.txt","46884",2019-10-07,"10:16",16,56,44,10,2,12,55,4,2,61,34,3,2,39,107,10,2,119,1631.20454545455,746.25,2418.13636363636,5135.65517241379,73,54,127,68.8888888888889
"./Ship3_Latin-square/2019-10-07_10h16m_Subject 47083.txt","47083",2019-10-07,"10:16",4,77,60,4,13,17,49,1,9,59,20,1,5,26,322,18,86,426,948.116666666667,142.633333333333,2755.91525423729,1919.19298245614,70,79,149,96.7213114754098
"./Ship3_Latin-square/2019-10-07_10h16m_Subject 47086.txt","47086",2019-10-07,"10:16",4,78,60,6,12,18,34,9,1,44,5,0,2,7,534,43,120,697,335.95,97.2666666666667,2762.62711864407,1534.08771929825,33,92,125,96.7213114754098
"./Ship3_Latin-square/2019-10-07_10h16m_Subject 47246.txt","47246",2019-10-07,"10:16",16,82,60,8,14,22,19,2,5,26,7,3,4,14,324,33,111,468,144.866666666667,122.783333333333,2077.94915254237,1591.97916666667,24,92,116,88.5245901639344
"./Ship3_Latin-square/2019-10-07_10h16m_Subject 47635.txt","47635",2019-10-07,"10:16",2,79,60,10,9,19,16,2,1,19,20,11,7,38,768,122,143,1033,132.583333333333,125.933333333333,2898.28813559322,1476.79661016949,49,45,94,100
"./Ship3_Latin-square/2019-10-07_10h16m_Subject 47779.txt","47779",2019-10-07,"10:16",2,81,60,8,13,21,12,3,2,17,50,9,3,62,370,40,46,456,635.133333333333,190.05,2888.08474576271,2253.64583333333,75,69,144,85.2459016393443
"./Ship3_Latin-square/2019-10-07_10h16m_Subject 47790.txt","47790",2019-10-07,"10:16",0,84,60,11,13,24,13,7,3,23,11,3,15,29,556,148,65,769,258.95,125.5,2999.91525423729,2233.15217391304,59,198,257,85.2459016393443
"./Ship3_Latin-square/2019-10-07_10h16m_Subject 47797.txt","47797",2019-10-07,"10:16",2,80,59,9,12,21,53,5,6,64,19,15,8,42,286,49,35,370,1245.49152542373,117.050847457627,2891.52542372881,2278.56363636364,13,86,99,96.6666666666667
"./Ship3_Latin-square/2019-10-07_11h33m_Subject 46900.txt","46900",2019-10-07,"11:33",8,80,60,11,9,20,10,0,2,12,80,26,16,122,739,113,266,1118,117.15,198.066666666667,2620.27118644068,1049.77777777778,24,89,113,91.8032786885246
"./Ship3_Latin-square/2019-10-07_11h33m_Subject 46986.txt","46986",2019-10-07,"11:33",4,64,46,9,9,18,40,10,3,53,10,2,5,17,151,36,45,232,2363.73913043478,138.369565217391,2795.53333333333,2807.27777777778,44,54,98,85.1063829787234
"./Ship3_Latin-square/2019-10-07_11h33m_Subject 47079.txt","47079",2019-10-07,"11:33",16,80,60,10,10,20,39,12,10,61,71,16,16,103,266,25,44,335,427.866666666667,229.466666666667,2186.38983050847,1762.94736842105,71,64,135,96.7213114754098
"./Ship3_Latin-square/2019-10-07_11h33m_Subject 47092.txt","47092",2019-10-07,"11:33",16,77,60,10,7,17,23,2,0,25,24,6,2,32,770,62,128,960,128.5,169,2321.91525423729,1157.70689655172,71,81,152,98.3606557377049
"./Ship3_Latin-square/2019-10-07_11h33m_Subject 47098.txt","47098",2019-10-07,"11:33",8,81,60,10,11,21,33,2,8,43,14,3,17,34,390,53,66,509,242.533333333333,121.283333333333,2579.57627118644,1353.47368421053,35,47,82,96.7213114754098
"./Ship3_Latin-square/2019-10-07_11h33m_Subject 47645.txt","47645",2019-10-07,"11:33",4,74,54,8,12,20,62,7,15,84,12,1,8,21,274,33,65,372,1549.71698113208,156.490566037736,2773.52830188679,2563.75,43,75,118,98.1481481481482
"./Ship3_Latin-square/2019-10-07_11h33m_Subject 47755.txt","47755",2019-10-07,"11:33",4,81,60,9,12,21,49,10,7,66,48,17,4,69,487,100,72,659,369.366666666667,169.916666666667,2776.22033898305,2097.57627118644,65,120,185,100
"./Ship3_Latin-square/2019-10-07_11h33m_Subject 47760.txt","47760",2019-10-07,"11:33",16,81,60,10,11,21,16,0,12,28,23,9,3,35,704,59,199,962,132.05,135.533333333333,2186.38983050847,965.152542372881,9,21,30,98.3606557377049
"./Ship3_Latin-square/2019-10-07_11h33m_Subject 47770.txt","47770",2019-10-07,"11:33",24,55,44,9,2,11,64,9,3,76,44,22,1,67,172,10,6,188,2160.38636363636,771.863636363636,2127.15909090909,3378.91428571429,94,58,152,80
"./Ship3_Latin-square/2019-10-07_11h36m_Subject 47233.txt","47233",2019-10-07,"11:36",16,81,60,11,10,21,163,8,23,194,29,5,5,39,474,39,126,639,351.25,127.916666666667,2240.61016949153,1483.42372881356,43,136,179,100
"./Ship3_Latin-square/2019-10-07_11h36m_Subject 47234.txt","47234",2019-10-07,"11:36",4,81,60,11,10,21,31,3,6,40,46,7,16,69,452,104,59,615,327.25,221.266666666667,2796.59322033898,1375,45,70,115,96.7213114754098
"./Ship3_Latin-square/2019-10-07_11h36m_Subject 47237.txt","47237",2019-10-07,"11:36",4,77,60,9,8,17,26,3,1,30,7,7,13,27,444,72,81,597,154.95,99.6,2810.05084745763,1233.70689655172,47,20,67,96.7213114754098
"./Ship3_Latin-square/2019-10-07_11h36m_Subject 47241.txt","47241",2019-10-07,"11:36",2,78,60,7,11,18,8,0,1,9,13,5,4,22,1072,128,155,1355,81.95,114.083333333333,2881.30508474576,1686.01694915254,59,80,139,100
"./Ship3_Latin-square/2019-10-07_11h36m_Subject 47247.txt","47247",2019-10-07,"11:36",4,79,60,7,12,19,28,3,4,35,25,4,3,32,324,70,75,469,229.966666666667,157.55,2769.47457627119,1780.375,56,57,113,96.7213114754098
"./Ship3_Latin-square/2019-10-07_11h36m_Subject 47777.txt","47777",2019-10-07,"11:36",8,76,60,7,9,16,47,4,7,58,31,8,4,43,296,25,60,381,379.016666666667,175.916666666667,2579.62711864407,2008.50847457627,62,40,102,100
"./Ship3_Latin-square/2019-10-07_11h36m_Subject 47784.txt","47784",2019-10-07,"11:36",4,82,60,9,13,22,13,2,3,18,85,19,15,119,1354,201,382,1937,91.7166666666667,196.833333333333,2782.98305084746,1111,56,97,153,100
"./Ship3_Latin-square/2019-10-07_12h47m_Subject 47626.txt","47626",2019-10-07,"12:47",8,80,60,11,9,20,18,1,5,24,25,4,3,32,449,58,78,585,195.55,172.433333333333,2606.74576271186,1619.1875,54,128,182,86.8852459016393
"./Ship3_Latin-square/2019-10-07_12h47m_Subject 47632.txt","47632",2019-10-07,"12:47",24,79,60,13,6,19,34,7,4,45,26,16,7,49,441,20,74,535,228.433333333333,137.2,2023.67796610169,795.176470588235,34,57,91,86.8852459016393
"./Ship3_Latin-square/2019-10-07_12h49m_Subject 46883.txt","46883",2019-10-07,"12:49",4,77,60,8,9,17,22,5,3,30,38,18,1,57,550,68,134,752,120.7,155.95,2796.54237288136,1457.94736842105,33,41,74,96.7213114754098
"./Ship3_Latin-square/2019-10-07_12h49m_Subject 46896.txt","46896",2019-10-07,"12:49",16,75,60,8,7,15,27,1,9,37,39,10,4,53,588,59,90,737,204.833333333333,139.05,2240.62711864407,1240.24137931034,43,40,83,98.3606557377049
"./Ship3_Latin-square/2019-10-07_12h49m_Subject 47649.txt","47649",2019-10-07,"12:49",16,82,60,14,8,22,43,3,9,55,16,5,3,24,277,30,51,358,804.633333333333,134.683333333333,2349.05084745763,2590.0487804878,108,63,171,75.4098360655738
"./Ship3_Latin-square/2019-10-07_12h49m_Subject 47753.txt","47753",2019-10-07,"12:49",24,86,60,15,11,26,69,5,29,103,38,26,14,78,425,15,116,556,336.133333333333,211.233333333333,1983.01694915254,1177.52941176471,88,91,179,86.8852459016393
"./Ship3_Latin-square/2019-10-07_14h03m_Subject 46877.txt","46877",2019-10-07,"14:03",24,83,60,15,8,23,15,1,4,20,23,80,8,111,735,36,121,892,87.7,154.15,2023.64406779661,827.636363636364,59,74,133,83.6065573770492
"./Ship3_Latin-square/2019-10-07_14h03m_Subject 46895.txt","46895",2019-10-07,"14:03",16,61,44,7,10,17,42,8,10,60,46,8,59,113,152,20,41,213,1286.13636363636,390.272727272727,2069.74418604651,2283.53846153846,24,55,79,93.3333333333333
"./Ship3_Latin-square/2019-10-07_14h03m_Subject 46897.txt","46897",2019-10-07,"14:03",0,79,60,7,12,19,36,7,4,47,47,5,12,64,355,37,56,448,644.616666666667,225.4,2999.96610169492,1995.49056603774,42,66,108,91.8032786885246
"./Ship3_Latin-square/2019-10-07_14h03m_Subject 47786.txt","47786",2019-10-07,"14:03",0,83,60,11,12,23,53,7,7,67,33,6,8,47,288,60,36,384,897.083333333333,139.883333333333,2999.83050847458,2923.45098039216,70,42,112,88.5245901639344
"./Ship3_Latin-square/2019-10-07_14h07m_Subject 46889.txt","46889",2019-10-07,"14:07",16,82,60,10,12,22,9,0,8,17,36,13,5,54,798,121,165,1084,90.35,164.533333333333,2186.37288135593,1258.86046511628,71,246,317,80.327868852459
"./Ship3_Latin-square/2019-10-07_14h07m_Subject 46890.txt","46890",2019-10-07,"14:07",2,82,60,9,13,22,11,2,3,16,14,7,11,32,436,90,107,633,335.316666666667,128.733333333333,2891.47457627119,2263.02564102564,99,153,252,73.7704918032787
"./Ship3_Latin-square/2019-10-07_14h07m_Subject 46898.txt","46898",2019-10-07,"14:07",0,79,60,7,12,19,21,4,3,28,33,0,14,47,691,96,118,905,137.75,119.366666666667,2999.91525423729,1925.64912280702,37,102,139,96.7213114754098
"./Ship3_Latin-square/2019-10-07_14h07m_Subject 47798.txt","47798",2019-10-07,"14:07",24,67,49,12,6,18,47,7,6,60,31,16,14,61,104,2,17,123,1393.89583333333,277.333333333333,2099.9375,2683.27777777778,51,44,95,79.5918367346939
"./Ship3_Latin-square/2019-10-07_15h22m_Subject 47762.txt","47762",2019-10-07,"15:22",24,54,38,9,7,16,41,3,12,56,21,18,26,65,98,7,16,121,2247.97297297297,520.216216216216,1897.18918918919,2880.56666666667,44,44,88,81.5789473684211
"./Ship3_Latin-square/2019-10-07_15h22m_Subject 47791.txt","47791",2019-10-07,"15:22",16,83,60,9,14,23,14,14,3,31,9,9,12,30,480,53,124,657,130.916666666667,105.366666666667,2077.93220338983,1289.96363636364,20,83,103,93.4426229508197
"./Ship3_Latin-square/2019-10-08_10h00m_Subject 46884.txt","46884",2019-10-08,"10:00",8,71,53,8,10,18,78,8,14,100,30,4,5,39,144,31,23,198,1501.92452830189,347.339622641509,2592.39622641509,3370.72340425532,55,63,118,92.5925925925926
"./Ship3_Latin-square/2019-10-08_10h00m_Subject 47083.txt","47083",2019-10-08,"10:00",16,80,59,13,8,21,66,13,8,87,38,6,5,49,279,32,39,350,1226.42372881356,182.508474576271,2294.8813559322,1794.03703703704,85,68,153,93.3333333333333
"./Ship3_Latin-square/2019-10-08_10h00m_Subject 47086.txt","47086",2019-10-08,"10:00",2,79,60,10,9,19,29,6,6,41,8,0,0,8,470,78,76,624,216.183333333333,95.4166666666667,2898.27118644068,1496.16363636364,38,58,96,95.0819672131148
"./Ship3_Latin-square/2019-10-08_10h00m_Subject 47246.txt","47246",2019-10-08,"10:00",8,85,60,10,15,25,17,8,2,27,2,4,8,14,433,72,102,607,208.783333333333,112.566666666667,2525.37288135593,1676.26785714286,32,74,106,98.3606557377049
"./Ship3_Latin-square/2019-10-08_10h00m_Subject 47635.txt","47635",2019-10-08,"10:00",24,81,60,11,10,21,64,6,14,84,48,12,9,69,265,2,74,341,377.45,197.433333333333,1860.98305084746,1659.06896551724,66,25,91,98.3606557377049
"./Ship3_Latin-square/2019-10-08_10h00m_Subject 47779.txt","47779",2019-10-08,"10:00",24,48,35,10,3,13,20,5,2,27,25,26,1,52,51,10,4,65,3435.47058823529,842,2294.08823529412,6962.77272727273,75,23,98,68.5714285714286
"./Ship3_Latin-square/2019-10-08_10h00m_Subject 47790.txt","47790",2019-10-08,"10:00",24,62,46,12,4,16,48,2,7,57,33,8,3,44,174,14,16,204,3139.4347826087,189.195652173913,2112.97826086957,1902.13888888889,46,46,92,80.8510638297872
"./Ship3_Latin-square/2019-10-08_10h00m_Subject 47797.txt","47797",2019-10-08,"10:00",0,85,60,11,14,25,66,6,9,81,17,3,12,32,349,44,90,483,1052.58333333333,124.116666666667,2999.91525423729,2367.56363636364,6,109,115,93.4426229508197
"./Ship3_Latin-square/2019-10-08_10h03m_Subject 46878.txt","46878",2019-10-08,"10:03",4,78,60,5,13,18,8,2,4,14,5,0,4,9,862,61,185,1108,72.05,108.866666666667,2762.64406779661,1633.91525423729,76,66,142,100
"./Ship3_Latin-square/2019-10-08_10h03m_Subject 46885.txt","46885",2019-10-08,"10:03",8,72,55,8,9,17,106,11,10,127,18,9,8,35,209,25,58,292,1759.57407407407,119.018518518519,2585.12962962963,2435.57692307692,59,67,126,96.3636363636364
"./Ship3_Latin-square/2019-10-08_10h03m_Subject 46899.txt","46899",2019-10-08,"10:03",16,83,60,14,9,23,93,7,27,127,63,23,27,113,512,63,81,656,763.2,180.016666666667,2376.23728813559,998.275862068965,49,48,97,98.3606557377049
"./Ship3_Latin-square/2019-10-08_10h03m_Subject 47081.txt","47081",2019-10-08,"10:03",0,83,60,6,17,23,21,4,4,29,6,25,5,36,767,99,220,1086,172.133333333333,119.183333333333,2999.86440677966,1442.96551724138,29,81,110,98.3606557377049
"./Ship3_Latin-square/2019-10-08_10h03m_Subject 47091.txt","47091",2019-10-08,"10:03",16,79,60,9,10,19,16,0,3,19,46,11,8,65,226,27,53,306,248.65,151.933333333333,2186.38983050847,1488.9298245614,54,43,97,96.7213114754098
"./Ship3_Latin-square/2019-10-08_10h03m_Subject 47095.txt","47095",2019-10-08,"10:03",24,60,44,10,6,16,40,5,9,54,38,12,30,80,176,18,43,237,658.068181818182,470.976744186047,2051.11627906977,1722.775,47,33,80,95.4545454545455
"./Ship3_Latin-square/2019-10-08_10h03m_Subject 47231.txt","47231",2019-10-08,"10:03",4,84,60,9,15,24,39,4,15,58,27,7,7,41,172,26,39,237,791.6,151.566666666667,2755.8813559322,1856.70833333333,66,29,95,85.2459016393443
"./Ship3_Latin-square/2019-10-08_10h03m_Subject 47244.txt","47244",2019-10-08,"10:03",8,80,60,7,13,20,24,0,3,27,37,8,6,51,689,70,173,932,132.9,171.183333333333,2566.01694915254,1526.10344827586,85,98,183,98.3606557377049
"./Ship3_Latin-square/2019-10-08_10h03m_Subject 47633.txt","47633",2019-10-08,"10:03",4,80,60,9,11,20,31,7,4,42,60,11,10,81,364,51,69,484,337.05,163.5,2789.77966101695,2006.9649122807,138,68,206,96.7213114754098
"./Ship3_Latin-square/2019-10-08_10h03m_Subject 47636.txt","47636",2019-10-08,"10:03",24,48,34,12,2,14,70,15,7,92,63,30,7,100,205,21,13,239,2005.85294117647,3353.55882352941,2505.88235294118,2433.64705882353,89,24,113,100
"./Ship3_Latin-square/2019-10-08_10h03m_Subject 47752.txt","47752",2019-10-08,"10:03",16,53,41,11,1,12,42,11,4,57,40,20,26,86,270,44,0,314,689.463414634146,274.731707317073,2531.60975609756,1510.625,60,22,82,97.6190476190476
"./Ship3_Latin-square/2019-10-08_10h03m_Subject 47768.txt","47768",2019-10-08,"10:03",24,85,60,13,12,25,49,7,8,64,35,12,15,62,223,6,76,305,512.083333333333,185.15,1860.94915254237,1703.82978723404,61,66,127,80.327868852459
"./Ship3_Latin-square/2019-10-08_10h03m_Subject 47780.txt","47780",2019-10-08,"10:03",2,79,60,9,10,19,32,5,6,43,59,18,11,88,434,75,77,586,316.983333333333,350.45,2888.05084745763,1968.28813559322,58,56,114,100
"./Ship3_Latin-square/2019-10-08_11h11m_Subject 46986.txt","46986",2019-10-08,"11:11",2,79,58,11,10,21,38,7,1,46,9,10,2,21,281,46,71,398,1152.66666666667,148.561403508772,2905.24561403509,2600.12765957447,86,65,151,93.1034482758621
"./Ship3_Latin-square/2019-10-08_11h11m_Subject 47079.txt","47079",2019-10-08,"11:11",8,77,60,6,11,17,31,1,18,50,66,10,11,87,329,29,63,421,443,233.416666666667,2566.06779661017,2227.05263157895,79,80,159,96.7213114754098
"./Ship3_Latin-square/2019-10-08_11h11m_Subject 47092.txt","47092",2019-10-08,"11:11",8,80,60,11,9,20,16,3,1,20,17,4,2,23,917,122,159,1198,106.8,137.65,2633.81355932203,1430.5593220339,76,117,193,100
"./Ship3_Latin-square/2019-10-08_11h11m_Subject 47098.txt","47098",2019-10-08,"11:11",4,83,60,9,14,23,19,1,4,24,5,1,4,10,447,66,108,621,154.55,94.1,2762.66101694915,1424.09259259259,25,68,93,96.7213114754098
"./Ship3_Latin-square/2019-10-08_11h11m_Subject 47645.txt","47645",2019-10-08,"11:11",2,82,60,9,13,22,53,8,12,73,13,0,3,16,287,43,82,412,860.65,135.3,2888.10169491525,2536.82352941176,65,79,144,88.5245901639344
"./Ship3_Latin-square/2019-10-08_11h11m_Subject 47755.txt","47755",2019-10-08,"11:11",16,82,60,14,8,22,48,7,5,60,14,24,2,40,441,78,104,623,230.783333333333,145,2349.1186440678,2064.70212765957,84,130,214,83.6065573770492
"./Ship3_Latin-square/2019-10-08_11h11m_Subject 47760.txt","47760",2019-10-08,"11:11",8,81,60,12,9,21,52,10,7,69,42,51,10,103,513,84,117,714,405.766666666667,188.816666666667,2633.79661016949,1325.91379310345,41,26,67,96.7213114754098
"./Ship3_Latin-square/2019-10-08_11h11m_Subject 47770.txt","47770",2019-10-08,"11:11",4,77,58,9,10,19,33,7,3,43,46,15,7,68,416,64,81,561,1274.62068965517,233.034482758621,2803.43859649123,2142.55555555556,125,82,207,94.9152542372881
"./Ship3_Latin-square/2019-10-08_11h15m_Subject 47233.txt","47233",2019-10-08,"11:15",8,80,60,7,13,20,78,1,8,87,27,5,6,38,530,34,122,686,209.033333333333,129.216666666667,2525.35593220339,1552.125,26,137,163,96.7213114754098
"./Ship3_Latin-square/2019-10-08_11h15m_Subject 47234.txt","47234",2019-10-08,"11:15",2,83,60,10,13,23,22,5,2,29,60,25,5,90,484,87,76,647,161.766666666667,282.7,2884.74576271186,1562.58181818182,55,80,135,95.0819672131148
"./Ship3_Latin-square/2019-10-08_11h15m_Subject 47237.txt","47237",2019-10-08,"11:15",16,76,60,11,5,16,24,1,6,31,21,5,0,26,421,29,40,490,252.45,142.783333333333,2321.96610169492,905.135593220339,33,21,54,98.3606557377049
"./Ship3_Latin-square/2019-10-08_11h15m_Subject 47241.txt","47241",2019-10-08,"11:15",0,82,60,8,14,22,17,0,5,22,9,5,2,16,1019,154,261,1434,92.0833333333333,116.316666666667,2999.93220338983,1546.23728813559,38,107,145,100
"./Ship3_Latin-square/2019-10-08_11h15m_Subject 47247.txt","47247",2019-10-08,"11:15",16,77,60,9,8,17,45,7,5,57,23,4,4,31,198,26,26,250,436.6,146.883333333333,2240.66101694915,1851.20454545455,33,93,126,80.327868852459
"./Ship3_Latin-square/2019-10-08_11h15m_Subject 47784.txt","47784",2019-10-08,"11:15",16,73,60,7,6,13,46,0,8,54,88,9,8,105,783,78,65,926,293.866666666667,253.766666666667,2240.59322033898,920.101694915254,48,61,109,100
"./Ship3_Latin-square/2019-10-08_12h25m_Subject 46883.txt","46883",2019-10-08,"12:25",16,81,60,11,10,21,33,6,7,46,40,36,12,88,241,36,52,329,380.2,173.716666666667,2213.49152542373,1732.98076923077,44,64,108,91.8032786885246
"./Ship3_Latin-square/2019-10-08_12h25m_Subject 46896.txt","46896",2019-10-08,"12:25",24,84,60,6,18,24,60,4,23,87,35,7,23,65,224,6,173,403,432.333333333333,137.5,1332.16949152542,1127.96153846154,21,58,79,90.1639344262295
"./Ship3_Latin-square/2019-10-08_12h25m_Subject 47649.txt","47649",2019-10-08,"12:25",8,79,60,9,10,19,29,3,5,37,25,6,0,31,438,28,90,556,332.766666666667,160.516666666667,2593.13559322034,2282.16666666667,81,196,277,72.1311475409836
"./Ship3_Latin-square/2019-10-08_12h25m_Subject 47753.txt","47753",2019-10-08,"12:25",0,78,60,9,9,18,13,2,1,16,34,1,3,38,895,133,159,1187,133.4,136.4,2999.89830508475,1464.5593220339,52,93,145,100
"./Ship3_Latin-square/2019-10-08_12h30m_Subject 47632.txt","47632",2019-10-08,"12:30",8,80,60,10,10,20,22,6,1,29,19,11,1,31,604,118,74,796,258.183333333333,121.65,2593.16949152542,1170.84482758621,33,47,80,98.3606557377049
"./Ship3_Latin-square/2019-10-08_13h35m_Subject 46889.txt","46889",2019-10-08,"13:35",8,78,60,6,12,18,10,0,3,13,31,12,6,49,1086,140,211,1437,92.95,143.55,2525.38983050847,1322.21818181818,45,162,207,95.0819672131148
"./Ship3_Latin-square/2019-10-08_13h35m_Subject 46890.txt","46890",2019-10-08,"13:35",8,81,60,10,11,21,19,1,5,25,12,3,14,29,307,53,68,428,362.45,105.516666666667,2579.5593220339,1873.46153846154,54,110,164,80.327868852459
"./Ship3_Latin-square/2019-10-08_13h35m_Subject 46898.txt","46898",2019-10-08,"13:35",2,80,60,10,10,20,31,3,6,40,63,8,4,75,518,68,120,706,271.683333333333,127.066666666667,2894.89830508475,2292.32692307692,33,117,150,90.1639344262295
"./Ship3_Latin-square/2019-10-08_13h35m_Subject 47798.txt","47798",2019-10-08,"13:35",4,82,60,9,13,22,23,2,3,28,8,4,1,13,288,27,67,382,365.033333333333,112.966666666667,2783,1969.24,49,70,119,91.8032786885246
"./Ship3_Latin-square/2019-10-08_13h38m_Subject 46877.txt","46877",2019-10-08,"13:38",4,81,60,8,13,21,6,1,1,8,59,21,10,90,1475,176,359,2010,40.4333333333333,219.466666666667,2776.22033898305,1033.93220338983,48,86,134,100
"./Ship3_Latin-square/2019-10-08_13h38m_Subject 46895.txt","46895",2019-10-08,"13:38",8,80,60,13,7,20,36,6,6,48,44,20,3,67,258,73,27,358,663.4,214.866666666667,2660.96610169492,2297.44897959184,59,62,121,85.2459016393443
"./Ship3_Latin-square/2019-10-08_13h38m_Subject 46897.txt","46897",2019-10-08,"13:38",24,47,33,13,1,14,49,20,3,72,17,22,11,50,74,5,0,79,2511.24242424242,314.030303030303,2636.30303030303,3460.55172413793,39,12,51,88.2352941176471
"./Ship3_Latin-square/2019-10-08_13h38m_Subject 47786.txt","47786",2019-10-08,"13:38",2,78,60,9,9,18,39,9,7,55,42,3,4,49,319,44,47,410,777.783333333333,169.816666666667,2901.64406779661,2589.67857142857,62,47,109,96.7213114754098
"./Ship3_Latin-square/2019-10-08_14h55m_Subject 47762.txt","47762",2019-10-08,"14:55",4,82,60,9,13,22,10,0,3,13,10,3,3,16,214,35,57,306,354.5,121.716666666667,2776.22033898305,2678.39130434783,88,129,217,60.655737704918
"./Ship3_Latin-square/2019-10-08_14h55m_Subject 47791.txt","47791",2019-10-08,"14:55",8,77,60,6,11,17,4,0,0,4,7,1,6,14,848,79,158,1085,49.7666666666667,97.1833333333333,2538.94915254237,1192.83050847458,25,32,57,98.3606557377049
"./Ship3_Latin-square/2019-10-09_09h55m_Subject 47083.txt","47083",2019-10-09,"09:55",8,82,60,12,10,22,54,5,7,66,30,13,3,46,330,62,66,458,567.716666666667,169.7,2620.30508474576,1956.98214285714,92,79,171,96.7213114754098
"./Ship3_Latin-square/2019-10-09_09h55m_Subject 47086.txt","47086",2019-10-09,"09:55",0,81,60,8,13,21,17,1,2,20,13,3,1,17,495,68,110,673,220.466666666667,114,2999.84745762712,1841.47368421053,41,110,151,96.7213114754098
"./Ship3_Latin-square/2019-10-09_09h55m_Subject 47635.txt","47635",2019-10-09,"09:55",4,84,60,11,13,24,26,0,2,28,49,12,21,82,493,92,125,710,206.35,196.766666666667,2783.01694915254,1574.40677966102,56,49,105,98.3606557377049
"./Ship3_Latin-square/2019-10-09_09h55m_Subject 47779.txt","47779",2019-10-09,"09:55",4,80,60,10,10,20,19,6,1,26,56,19,4,79,308,54,85,447,423.933333333333,184.466666666667,2803.33898305085,2549.77551020408,61,67,128,86.8852459016393
"./Ship3_Latin-square/2019-10-09_09h55m_Subject 47790.txt","47790",2019-10-09,"09:55",0,78,60,8,10,18,21,4,3,28,14,0,3,17,583,120,116,819,162.883333333333,131.833333333333,2999.96610169492,2113.29545454545,75,137,212,86.8852459016393
"./Ship3_Latin-square/2019-10-09_09h55m_Subject 47797.txt","47797",2019-10-09,"09:55",2,73,55,6,12,18,36,7,9,52,23,2,24,49,197,53,36,286,1313.70909090909,178.363636363636,2881.42592592593,1867.29166666667,23,76,99,89.2857142857143
"./Ship3_Latin-square/2019-10-09_09h58m_Subject 46878.txt","46878",2019-10-09,"09:58",16,80,60,11,9,20,28,6,6,40,14,13,7,34,371,53,84,508,237.2,189.933333333333,2240.59322033898,1803.2962962963,74,68,142,95.0819672131148
"./Ship3_Latin-square/2019-10-09_09h58m_Subject 46899.txt","46899",2019-10-09,"09:58",8,79,60,11,8,19,24,7,2,33,11,4,5,20,757,88,146,991,171.7,96.3666666666667,2647.40677966102,1071.49152542373,45,28,73,100
"./Ship3_Latin-square/2019-10-09_09h58m_Subject 47081.txt","47081",2019-10-09,"09:58",2,76,60,5,11,16,19,3,8,30,20,2,9,31,399,36,56,491,156.633333333333,163.25,2881.32203389831,2047.74545454545,62,47,109,93.4426229508197
"./Ship3_Latin-square/2019-10-09_09h58m_Subject 47091.txt","47091",2019-10-09,"09:58",8,80,60,11,9,20,17,0,2,19,51,19,2,72,259,45,42,346,252.466666666667,168.233333333333,2606.71186440678,1857.72881355932,47,46,93,100
"./Ship3_Latin-square/2019-10-09_09h58m_Subject 47095.txt","47095",2019-10-09,"09:58",0,79,60,7,12,19,18,1,5,24,18,4,15,37,393,47,46,486,153.266666666667,132.45,2999.8813559322,2111.54545454545,36,88,124,95
"./Ship3_Latin-square/2019-10-09_09h58m_Subject 47231.txt","47231",2019-10-09,"09:58",16,78,57,12,9,21,66,16,6,88,20,19,3,42,187,29,40,256,1162.68421052632,141,2285.64285714286,2417.66666666667,70,41,111,91.3793103448276
"./Ship3_Latin-square/2019-10-09_09h58m_Subject 47633.txt","47633",2019-10-09,"09:58",16,77,60,10,7,17,38,6,2,46,67,25,8,100,296,39,39,374,505.966666666667,198.383333333333,2267.79661016949,1522.62711864407,94,64,158,100
"./Ship3_Latin-square/2019-10-09_09h58m_Subject 47636.txt","47636",2019-10-09,"09:58",4,76,60,7,9,16,60,2,8,70,38,10,7,55,389,46,50,485,571.783333333333,144.116666666667,2782.98305084746,2596.13559322034,101,100,201,100
"./Ship3_Latin-square/2019-10-09_09h58m_Subject 47752.txt","47752",2019-10-09,"09:58",8,79,60,9,10,19,40,3,11,54,16,8,8,32,464,59,131,654,457,106.7,2593.16949152542,1597.10526315789,64,57,121,96.7213114754098
"./Ship3_Latin-square/2019-10-09_09h58m_Subject 47768.txt","47768",2019-10-09,"09:58",4,7,6,1,0,1,20,2,0,22,13,3,0,16,29,4,0,33,51843,3164.2,2840,1152,4,5,9,100
"./Ship3_Latin-square/2019-10-09_09h58m_Subject 47780.txt","47780",2019-10-09,"09:58",24,79,60,11,8,19,95,7,16,118,57,15,11,83,248,15,60,323,666.15,218.05,1860.98305084746,1442.43103448276,83,51,134,98.3606557377049
"./Ship3_Latin-square/2019-10-09_11h08m_Subject 47234.txt","47234",2019-10-09,"11:08",0,80,60,7,13,20,17,1,4,22,47,8,10,65,490,41,82,613,521.683333333333,353.8,2999.81355932203,1794.81132075472,71,76,147,91.8032786885246
"./Ship3_Latin-square/2019-10-09_11h08m_Subject 47237.txt","47237",2019-10-09,"11:08",24,75,55,14,6,20,61,4,7,72,60,18,81,159,289,4,30,323,696.781818181818,514.454545454545,2127.21818181818,1011.11764705882,48,26,74,94.6428571428571
"./Ship3_Latin-square/2019-10-09_11h08m_Subject 47241.txt","47241",2019-10-09,"11:08",2,78,60,7,11,18,13,2,1,16,5,10,1,16,939,116,158,1213,82.7166666666667,101.533333333333,2888.10169491525,1325.96610169492,45,55,100,100
"./Ship3_Latin-square/2019-10-09_11h08m_Subject 47247.txt","47247",2019-10-09,"11:08",8,75,60,6,9,15,30,0,0,30,19,2,2,23,276,32,41,349,291.783333333333,160.716666666667,2566.05084745763,2333.38,65,105,170,90.1639344262295
"./Ship3_Latin-square/2019-10-09_11h08m_Subject 47784.txt","47784",2019-10-09,"11:08",8,77,60,7,10,17,42,0,4,46,79,27,12,118,1075,117,194,1386,194.183333333333,203.833333333333,2552.49152542373,1096.06779661017,42,118,160,100
"./Ship3_Latin-square/2019-10-09_11h10m_Subject 46986.txt","46986",2019-10-09,"11:10",0,78,60,8,10,18,35,5,6,46,7,1,6,14,338,45,62,445,599.783333333333,127.983333333333,2999.83050847458,2338.125,88,67,155,85.2459016393443
"./Ship3_Latin-square/2019-10-09_11h10m_Subject 47098.txt","47098",2019-10-09,"11:10",16,85,60,14,11,25,34,8,8,50,54,41,31,126,244,36,61,341,286.116666666667,338.1,2294.81355932203,1386.80392156863,49,71,120,86.8852459016393
"./Ship3_Latin-square/2019-10-09_11h10m_Subject 47645.txt","47645",2019-10-09,"11:10",0,81,60,8,13,21,58,12,20,90,12,3,5,20,298,40,55,393,642.4,122.366666666667,2999.94915254237,3093.53448275862,60,72,132,96.7213114754098
"./Ship3_Latin-square/2019-10-09_11h10m_Subject 47755.txt","47755",2019-10-09,"11:10",8,80,60,8,12,20,36,4,4,44,67,19,5,91,578,85,146,809,353.05,430.183333333333,2538.94915254237,2072.22916666667,66,245,311,90.1639344262295
"./Ship3_Latin-square/2019-10-09_11h10m_Subject 47770.txt","47770",2019-10-09,"11:10",16,52,39,10,3,13,50,8,3,61,59,26,2,87,183,28,14,225,2308.23076923077,1310.07692307692,2494.71052631579,3792.54285714286,93,44,137,92.5
"./Ship3_Latin-square/2019-10-09_12h23m_Subject 47632.txt","47632",2019-10-09,"12:23",0,81,60,8,13,21,18,0,1,19,12,3,10,25,856,130,161,1147,202.183333333333,97.3833333333333,2999.96610169492,1245.87931034483,25,42,67,98.3606557377049
"./Ship3_Latin-square/2019-10-09_12h28m_Subject 46883.txt","46883",2019-10-09,"12:28",8,79,60,9,10,19,42,2,2,46,25,15,22,62,441,52,99,592,204.116666666667,133.25,2593.20338983051,1604.66666666667,29,88,117,95.0819672131148
"./Ship3_Latin-square/2019-10-09_12h28m_Subject 46896.txt","46896",2019-10-09,"12:28",8,78,60,9,9,18,30,1,1,32,39,11,13,63,747,75,137,959,528.766666666667,173.633333333333,2593.13559322034,1609.13559322034,39,38,77,100
"./Ship3_Latin-square/2019-10-09_12h28m_Subject 47753.txt","47753",2019-10-09,"12:28",16,83,60,14,9,23,51,8,7,66,26,27,13,66,458,70,88,616,470.3,206.816666666667,2294.84745762712,1101.41818181818,62,93,155,93.4426229508197
"./Ship3_Latin-square/2019-10-09_13h38m_Subject 46890.txt","46890",2019-10-09,"13:38",4,83,60,9,14,23,10,1,0,11,72,6,6,84,334,81,95,510,306.71186440678,303.271186440678,2783,2046.61290322581,75,132,207,66.6666666666667
"./Ship3_Latin-square/2019-10-09_13h38m_Subject 46898.txt","46898",2019-10-09,"13:38",24,80,60,11,9,20,43,2,5,50,44,24,20,88,412,24,46,482,306.583333333333,252.1,1901.66101694915,1183.52941176471,36,131,167,86.8852459016393
"./Ship3_Latin-square/2019-10-09_13h38m_Subject 47798.txt","47798",2019-10-09,"13:38",16,76,56,12,8,20,18,3,1,22,13,7,3,23,211,22,51,284,676.589285714286,134.232142857143,2314.23214285714,1811.42222222222,59,45,104,87.719298245614
"./Ship3_Latin-square/2019-10-09_13h42m_Subject 46877.txt","46877",2019-10-09,"13:42",16,82,60,12,10,22,8,1,2,11,28,9,4,41,996,128,211,1335,74.0166666666667,163.066666666667,2267.74576271186,829.092592592593,24,127,151,93.4426229508197
"./Ship3_Latin-square/2019-10-09_13h42m_Subject 46897.txt","46897",2019-10-09,"13:42",2,70,51,9,10,19,59,10,5,74,30,4,12,46,116,19,21,156,1869.09803921569,184.392156862745,2887.98,2921.55813953488,30,42,72,88.4615384615385
"./Ship3_Latin-square/2019-10-09_13h42m_Subject 47786.txt","47786",2019-10-09,"13:42",24,64,49,10,5,15,59,8,6,73,48,11,7,66,104,4,10,118,1497.16326530612,1123.73469387755,2020.38775510204,3086.29268292683,51,39,90,88
"./Ship3_Latin-square/2019-10-09_14h43m_Subject 47762.txt","47762",2019-10-09,"14:43",16,64,49,11,4,15,76,11,3,90,15,10,0,25,155,19,14,188,2561.10416666667,226.5,2433.22916666667,3506.90909090909,105,17,122,93.8775510204082
"./Ship3_Latin-square/2019-10-10_09h57m_Subject 46878.txt","46878",2019-10-10,"09:57",8,73,60,7,6,13,14,2,2,18,7,4,1,12,837,104,95,1036,97.1333333333333,116.783333333333,2606.62711864407,1507.08474576271,67,63,130,100
"./Ship3_Latin-square/2019-10-10_09h57m_Subject 47081.txt","47081",2019-10-10,"09:57",24,73,55,10,8,18,81,6,11,98,64,28,25,117,256,16,23,295,891.818181818182,466.818181818182,1865.43636363636,1572.96,72,79,151,91.0714285714286
"./Ship3_Latin-square/2019-10-10_09h57m_Subject 47095.txt","47095",2019-10-10,"09:57",16,78,60,10,8,18,28,3,5,36,28,6,7,41,229,29,48,306,382.733333333333,181.516666666667,2240.66101694915,2242.86538461538,64,58,122,91.8032786885246
"./Ship3_Latin-square/2019-10-10_09h57m_Subject 47231.txt","47231",2019-10-10,"09:57",8,82,58,12,12,24,54,8,12,74,35,24,9,68,264,37,44,345,978.948275862069,171.965517241379,2599.93103448276,1893.85964912281,77,28,105,98.3050847457627
"./Ship3_Latin-square/2019-10-10_09h57m_Subject 47633.txt","47633",2019-10-10,"09:57",8,80,60,9,11,20,32,5,7,44,61,15,17,93,411,59,82,552,635.983333333333,167.416666666667,2552.47457627119,1608.84745762712,64,74,138,100
"./Ship3_Latin-square/2019-10-10_09h57m_Subject 47636.txt","47636",2019-10-10,"09:57",16,76,56,12,8,20,78,9,11,98,73,37,4,114,265,52,37,354,1262.44642857143,338.839285714286,2330.83636363636,2547.49090909091,130,71,201,100
"./Ship3_Latin-square/2019-10-10_09h57m_Subject 47768.txt","47768",2019-10-10,"09:57",16,71,51,9,11,20,41,6,6,53,30,9,15,54,302,42,81,425,913.18,223.9,2167.94,1770.4347826087,46,79,125,94.1176470588235
"./Ship3_Latin-square/2019-10-10_09h57m_Subject 47780.txt","47780",2019-10-10,"09:57",4,76,60,7,9,16,31,6,3,40,44,18,5,67,545,65,103,713,158.783333333333,182.45,2789.77966101695,1429.59322033898,48,58,106,100
"./Ship3_Latin-square/2019-10-10_10h00m_Subject 47086.txt","47086",2019-10-10,"10:00",2,79,60,6,13,19,17,7,1,25,7,0,11,18,513,31,121,665,211.666666666667,91.75,2881.27118644068,1347.22033898305,27,73,100,100
"./Ship3_Latin-square/2019-10-10_10h00m_Subject 47635.txt","47635",2019-10-10,"10:00",16,77,60,9,8,17,15,2,8,25,36,9,6,51,488,40,73,601,157.483333333333,151.483333333333,2213.52542372881,1245.76363636364,36,58,94,96.7213114754098
"./Ship3_Latin-square/2019-10-10_10h00m_Subject 47779.txt","47779",2019-10-10,"10:00",16,41,31,6,4,10,71,11,12,94,45,7,4,56,76,7,7,90,5658.73333333333,381.566666666667,2359.93333333333,5280.125,51,63,114,87.0967741935484
"./Ship3_Latin-square/2019-10-10_10h00m_Subject 47790.txt","47790",2019-10-10,"10:00",16,83,60,12,11,23,45,11,7,63,48,6,16,70,236,32,64,332,644.033333333333,205.616666666667,2240.66101694915,2302.57142857143,65,110,175,90.1639344262295
"./Ship3_Latin-square/2019-10-10_10h00m_Subject 47797.txt","47797",2019-10-10,"10:00",24,60,43,10,7,17,64,8,7,79,53,19,24,96,81,11,26,118,2040.59523809524,552.928571428571,1971.38095238095,4194.47058823529,15,62,77,83.7209302325581
"./Ship3_Latin-square/2019-10-10_11h20m_Subject 46986.txt","46986",2019-10-10,"11:20",2,79,60,11,8,19,25,3,9,37,5,4,3,12,311,52,63,426,536.983333333333,115.35,2908.42372881356,2543.40816326531,79,71,150,86.8852459016393
"./Ship3_Latin-square/2019-10-10_11h20m_Subject 47098.txt","47098",2019-10-10,"11:20",24,82,60,12,10,22,71,14,12,97,63,8,49,120,208,4,57,269,670.133333333333,383.616666666667,1942.32203389831,1231.71428571429,38,69,107,95.0819672131148
"./Ship3_Latin-square/2019-10-10_11h20m_Subject 47645.txt","47645",2019-10-10,"11:20",2,82,60,8,14,22,55,4,14,73,8,3,9,20,211,54,69,334,689.333333333333,119.2,2888.08474576271,2854.69811320755,55,60,115,93.4426229508197
"./Ship3_Latin-square/2019-10-10_11h20m_Subject 47770.txt","47770",2019-10-10,"11:20",8,63,49,6,8,14,47,2,2,51,122,14,45,181,208,27,23,258,1978.69387755102,534.857142857143,2566.66666666667,3420.2,62,124,186,80
"./Ship3_Latin-square/2019-10-10_11h24m_Subject 47234.txt","47234",2019-10-10,"11:24",2,82,60,9,13,22,20,2,2,24,64,16,24,104,404,68,87,559,216.85,283.4,2891.50847457627,1527.62264150943,76,71,147,91.8032786885246
"./Ship3_Latin-square/2019-10-10_11h24m_Subject 47237.txt","47237",2019-10-10,"11:24",8,78,60,9,9,18,37,2,6,45,7,2,6,15,481,50,85,616,333.416666666667,118.466666666667,2620.30508474576,1040.89830508475,28,32,60,100
"./Ship3_Latin-square/2019-10-10_11h24m_Subject 47241.txt","47241",2019-10-10,"11:24",24,79,60,10,9,19,22,4,6,32,24,10,7,41,545,9,117,671,137.866666666667,148.333333333333,1901.64406779661,998.021276595745,38,62,100,81.9672131147541
"./Ship3_Latin-square/2019-10-10_12h57m_Subject 47632.txt","47632",2019-10-10,"12:57",4,77,60,3,14,17,14,0,2,16,12,2,6,20,955,43,235,1233,97.6166666666667,88.9,2735.5593220339,1051.66101694915,30,46,76,100
"./Ship3_Latin-square/2019-10-10_12h59m_Subject 46896.txt","46896",2019-10-10,"12:59",0,82,60,4,18,22,17,2,3,22,62,3,8,73,983,76,294,1353,134.433333333333,247.083333333333,2999.86440677966,1345.18644067797,31,38,69,100
"./Ship3_Latin-square/2019-10-10_12h59m_Subject 47753.txt","47753",2019-10-10,"12:59",2,81,60,7,14,21,33,0,5,38,14,2,26,42,740,83,183,1006,509.833333333333,127.8,2874.5593220339,1238.18644067797,53,98,151,100
"./Ship3_Latin-square/2019-10-10_14h12m_Subject 46877.txt","46877",2019-10-10,"14:12",8,84,60,13,11,24,11,1,1,13,25,17,7,49,1265,276,254,1795,57.4833333333333,158.433333333333,2620.32203389831,1003.23728813559,38,62,100,100
"./Ship3_Latin-square/2019-10-10_14h12m_Subject 46897.txt","46897",2019-10-10,"14:12",4,79,60,9,10,19,40,3,7,50,12,13,11,36,233,32,38,303,504.95,153.183333333333,2796.5593220339,1905.30612244898,26,74,100,88.5245901639344
"./Ship3_Latin-square/2019-10-10_14h12m_Subject 47786.txt","47786",2019-10-10,"14:12",4,78,60,10,8,18,55,5,15,75,33,5,9,47,308,35,53,396,739.55,133.133333333333,2810.13559322034,2418.98113207547,53,42,95,95.0819672131148
"./Ship3_Latin-square/2019-10-10_14h15m_Subject 46890.txt","46890",2019-10-10,"14:15",16,86,60,12,14,26,27,1,4,32,14,12,9,35,234,33,91,358,345.666666666667,116.95,2186.37288135593,2267.02564102564,72,99,171,75.4098360655738
"./Ship3_Latin-square/2019-10-10_14h15m_Subject 46898.txt","46898",2019-10-10,"14:15",4,81,60,10,11,21,28,4,4,36,66,8,19,93,569,87,113,769,123.633333333333,133.216666666667,2796.59322033898,1925.33962264151,37,102,139,93.4426229508197
"./Ship3_Latin-square/2019-10-10_14h15m_Subject 47798.txt","47798",2019-10-10,"14:15",8,79,60,6,13,19,27,4,5,36,11,2,6,19,258,21,56,335,549.05,122.716666666667,2538.96610169492,2099.55555555556,45,80,125,90.1639344262295
"./Ship3_Latin-square/2019-10-10_15h23m_Subject 47762.txt","47762",2019-10-10,"15:23",8,81,60,11,10,21,29,3,6,38,16,3,2,21,244,35,67,346,372.983333333333,169.483333333333,2593.1186440678,2385.78947368421,83,102,185,77.0491803278689
"./Ship3_Latin-square/2019-10-11_09h55m_Subject 47086.txt","47086",2019-10-11,"09:55",24,80,60,10,10,20,40,1,15,56,31,3,4,38,268,20,61,349,310.15,165.166666666667,1820.27118644068,948.363636363636,30,43,73,96.7213114754098
"./Ship3_Latin-square/2019-10-11_09h55m_Subject 47635.txt","47635",2019-10-11,"09:55",8,81,60,7,14,21,16,1,3,20,53,6,7,66,590,61,150,801,163.716666666667,193.433333333333,2511.81355932203,1365.72881355932,40,51,91,100
"./Ship3_Latin-square/2019-10-11_09h55m_Subject 47779.txt","47779",2019-10-11,"09:55",8,77,58,9,10,19,54,10,3,67,65,23,4,92,292,34,65,391,1307.42105263158,221.561403508772,2578.89473684211,2815.29411764706,33,103,136,89.6551724137931
"./Ship3_Latin-square/2019-10-11_09h55m_Subject 47790.txt","47790",2019-10-11,"09:55",2,78,60,7,11,18,18,1,3,22,26,4,5,35,756,78,177,1011,230.333333333333,170.183333333333,2884.71186440678,1796.18,38,181,219,95.0819672131148
"./Ship3_Latin-square/2019-10-11_09h55m_Subject 47797.txt","47797",2019-10-11,"09:55",4,81,60,9,12,21,46,3,6,55,11,8,5,24,283,32,64,379,1029.8,147.633333333333,2782.96610169492,2255.875,11,52,63,95.0819672131148
"./Ship3_Latin-square/2019-10-11_09h58m_Subject 47081.txt","47081",2019-10-11,"09:58",4,84,60,8,16,24,14,1,5,20,19,6,21,46,566,73,173,812,105.2,182.85,2755.91525423729,1830.18867924528,43,103,146,95.0819672131148
"./Ship3_Latin-square/2019-10-11_09h58m_Subject 47095.txt","47095",2019-10-11,"09:58",2,80,60,10,10,20,20,6,0,26,17,14,7,38,330,64,47,441,869.416666666667,128.066666666667,2894.81355932203,2387.36206896552,27,44,71,98.3606557377049
"./Ship3_Latin-square/2019-10-11_09h58m_Subject 47636.txt","47636",2019-10-11,"09:58",8,78,60,11,7,18,74,24,4,102,51,14,6,71,356,68,47,471,1058.86666666667,212.216666666667,2633.81355932203,2355.45762711864,133,72,205,100
"./Ship3_Latin-square/2019-10-11_09h58m_Subject 47768.txt","47768",2019-10-11,"09:58",8,78,60,7,11,18,35,5,9,49,35,4,16,55,370,28,76,474,736.95,161.65,2566.05084745763,2173.44230769231,65,76,141,88.5245901639344
"./Ship3_Latin-square/2019-10-11_09h58m_Subject 47780.txt","47780",2019-10-11,"09:58",16,82,60,11,11,22,31,4,9,44,34,13,6,53,417,56,117,590,194.7,151.466666666667,2240.64406779661,1292.94736842105,58,60,118,96.7213114754098
"./Ship3_Latin-square/2019-10-11_11h04m_Subject 47234.txt","47234",2019-10-11,"11:04",24,81,58,15,8,23,67,7,9,83,58,62,8,128,195,21,52,268,723.40350877193,362.859649122807,2115.73684210526,1508.98,74,44,118,91.3793103448276
"./Ship3_Latin-square/2019-10-11_11h04m_Subject 47237.txt","47237",2019-10-11,"11:04",0,81,60,7,14,21,10,0,1,11,17,0,10,27,753,87,179,1019,142.4,159.4,2999.93220338983,1225.1186440678,25,40,65,100
"./Ship3_Latin-square/2019-10-11_11h04m_Subject 47241.txt","47241",2019-10-11,"11:04",4,80,60,8,12,20,8,3,2,13,7,1,2,10,880,133,171,1184,78.9166666666667,102.066666666667,2769.45762711864,1446.42372881356,40,70,110,100
"./Ship3_Latin-square/2019-10-11_11h07m_Subject 46986.txt","46986",2019-10-11,"11:07",24,75,53,11,11,22,75,10,12,97,37,8,11,56,123,12,43,178,1426.5,379.923076923077,1846.03846153846,2419.16279069767,58,55,113,86.7924528301887
"./Ship3_Latin-square/2019-10-11_11h07m_Subject 47098.txt","47098",2019-10-11,"11:07",8,80,60,12,8,20,36,2,5,43,26,31,14,71,422,75,74,571,461.483333333333,173.933333333333,2660.94915254237,1329.59322033898,34,44,78,100
"./Ship3_Latin-square/2019-10-11_11h07m_Subject 47645.txt","47645",2019-10-11,"11:07",24,67,48,14,5,19,85,19,13,117,16,15,2,33,161,17,14,192,2213.875,192.375,2299.89583333333,3355.73913043478,84,53,137,95.9183673469388
"./Ship3_Latin-square/2019-10-11_12h15m_Subject 47632.txt","47632",2019-10-11,"12:15",2,82,60,10,12,22,10,2,2,14,16,3,7,26,895,145,170,1210,204.466666666667,106.666666666667,2888.10169491525,1267.93103448276,39,71,110,98.3606557377049
"./Ship3_Latin-square/2019-10-11_12h18m_Subject 46896.txt","46896",2019-10-11,"12:18",4,79,60,7,12,19,16,1,1,18,54,9,4,67,694,102,146,942,303.2,197.983333333333,2762.66101694915,1460.89655172414,48,36,84,98.3606557377049
"./Ship3_Latin-square/2019-10-11_12h18m_Subject 47753.txt","47753",2019-10-11,"12:18",8,84,60,11,13,24,15,0,5,20,13,4,29,46,572,74,146,792,149.5,128.05,2593.13559322034,1337.47457627119,51,73,124,100
"./Ship3_Latin-square/2019-10-11_13h20m_Subject 46890.txt","46890",2019-10-11,"13:20",24,83,59,15,9,24,44,6,10,60,22,13,6,41,124,3,38,165,928.627118644068,162.372881355932,1965.46551724138,2724.88235294118,98,62,160,64.4067796610169
"./Ship3_Latin-square/2019-10-11_13h20m_Subject 46898.txt","46898",2019-10-11,"13:20",16,79,60,11,8,19,41,6,3,50,44,19,6,69,342,39,53,434,738.6,252.083333333333,2322,1912.78,43,105,148,86.8852459016393
"./Ship3_Latin-square/2019-10-11_13h30m_Subject 46897.txt","46897",2019-10-11,"13:30",0,84,60,10,14,24,24,5,8,37,15,1,13,29,238,39,39,316,632.2,163.716666666667,2999.86440677966,1790.64444444444,72,55,127,83.3333333333333
"./Ship3_Latin-square/2019-10-11_13h30m_Subject 47786.txt","47786",2019-10-11,"13:30",16,78,60,9,9,18,56,7,5,68,39,9,4,52,182,19,27,228,920.366666666667,181.216666666667,2186.38983050847,2599.40816326531,39,87,126,88.5245901639344
"./Ship3_Latin-square/2019-10-12_09h30m_Subject 47086.txt","47086",2019-10-12,"09:30",4,80,60,9,11,20,26,2,4,32,7,0,2,9,537,82,129,748,172.416666666667,103.483333333333,2789.81355932203,1389.01724137931,37,78,115,100
"./Ship3_Latin-square/2019-10-12_09h30m_Subject 47790.txt","47790",2019-10-12,"09:30",8,64,45,10,9,19,47,12,6,65,31,16,10,57,282,63,79,424,1442.61363636364,292.727272727273,2636.31818181818,2534.33333333333,37,72,109,95.5555555555556
"./Ship3_Latin-square/2019-10-12_09h30m_Subject 47797.txt","47797",2019-10-12,"09:30",16,53,38,10,5,15,34,4,5,43,26,5,6,37,91,26,33,150,2487.32432432432,241.783783783784,2437.75675675676,3055.58064516129,36,32,68,84.2105263157895
"./Ship3_Latin-square/2019-10-12_09h32m_Subject 47081.txt","47081",2019-10-12,"09:32",16,80,60,12,8,20,26,6,1,33,32,12,1,45,303,48,53,404,252.7,275.666666666667,2267.72881355932,1675.23076923077,54,97,151,88.5245901639344
"./Ship3_Latin-square/2019-10-12_09h32m_Subject 47095.txt","47095",2019-10-12,"09:32",8,72,53,12,7,19,19,8,7,34,32,12,17,61,230,64,36,330,1594.13461538462,222.980769230769,2661.5,2602.85714285714,44,36,80,94.3396226415094
"./Ship3_Latin-square/2019-10-12_09h32m_Subject 47780.txt","47780",2019-10-12,"09:32",8,79,60,10,9,19,20,1,3,24,39,9,7,55,512,74,81,667,199.416666666667,211.416666666667,2606.69491525424,1597.875,74,96,170,96.7213114754098
"./Ship3_Latin-square/2019-10-12_10h40m_Subject 47234.txt","47234",2019-10-12,"10:40",4,79,60,9,10,19,26,4,5,35,52,12,11,75,375,58,46,479,312.966666666667,279.383333333333,2789.83050847458,1497.38888888889,63,64,127,95.0819672131148
"./Ship3_Latin-square/2019-10-12_10h40m_Subject 47237.txt","47237",2019-10-12,"10:40",4,83,60,12,11,23,11,0,1,12,23,2,6,31,622,75,160,857,149.966666666667,134.683333333333,2803.32203389831,1339.77586206897,42,31,73,100
"./Ship3_Latin-square/2019-10-12_10h40m_Subject 47241.txt","47241",2019-10-12,"10:40",16,79,60,12,7,19,12,3,7,22,7,16,2,25,750,86,111,947,96.9166666666667,111.333333333333,2294.89830508475,987.561403508772,32,43,75,95.0819672131148
"./Ship3_Latin-square/2019-10-12_10h42m_Subject 46986.txt","46986",2019-10-12,"10:42",4,76,60,7,9,16,32,3,1,36,5,1,3,9,387,42,60,489,293.55,115.4,2803.37288135593,1723.71153846154,62,83,145,93.4426229508197
"./Ship3_Latin-square/2019-10-12_10h42m_Subject 47098.txt","47098",2019-10-12,"10:42",0,80,60,7,13,20,15,2,3,20,19,3,1,23,677,77,184,938,118.166666666667,176,2999.89830508475,1451.01694915254,40,45,85,100
"./Ship3_Latin-square/2019-10-12_10h42m_Subject 47645.txt","47645",2019-10-12,"10:42",4,85,60,10,15,25,59,10,16,85,7,2,6,15,267,56,68,391,864.316666666667,118.066666666667,2769.4406779661,2544.3,60,86,146,88.5245901639344
"./Ship3_Latin-square/2019-10-12_11h46m_Subject 47632.txt","47632",2019-10-12,"11:46",0,80,60,7,13,20,12,1,4,17,9,12,5,26,841,104,198,1143,118.35,85.8666666666667,2999.84745762712,1237.65517241379,34,27,61,98.3606557377049
"./Ship3_Latin-square/2019-10-12_11h49m_Subject 46896.txt","46896",2019-10-12,"11:49",2,76,60,5,11,16,15,0,1,16,56,7,8,71,737,80,151,968,134.3,196.233333333333,2877.96610169492,1389.32203389831,22,28,50,100
"./Ship3_Latin-square/2019-10-12_11h49m_Subject 47753.txt","47753",2019-10-12,"11:49",4,84,60,10,14,24,8,2,4,14,12,7,5,24,745,109,201,1055,87.7833333333333,128.516666666667,2776.25423728814,1523.08620689655,47,96,143,98.3606557377049
"./Ship3_Latin-square/2019-10-12_12h55m_Subject 46890.txt","46890",2019-10-12,"12:55",8,84,58,12,14,26,25,1,0,26,24,13,7,44,205,51,78,334,1005.80701754386,157.035087719298,2578.94736842105,3346.96774193548,84,98,182,65.5172413793103
"./Ship3_Latin-square/2019-10-12_12h55m_Subject 46898.txt","46898",2019-10-12,"12:55",8,74,60,9,5,14,23,0,1,24,28,24,7,59,963,95,94,1152,120.483333333333,215.6,2633.83050847458,1526.81355932203,169,75,244,100
"./Ship3_Latin-square/2019-10-12_12h58m_Subject 46897.txt","46897",2019-10-12,"12:58",8,82,60,12,10,22,37,4,9,50,18,5,4,27,140,22,27,189,767.35,214.716666666667,2620.27118644068,2318.37837837838,71,45,116,75.4098360655738
"./Ship3_Latin-square/2019-10-12_12h58m_Subject 47786.txt","47786",2019-10-12,"12:58",8,78,60,9,9,18,65,7,14,86,32,13,10,55,176,25,19,220,1426.06666666667,136.183333333333,2606.69491525424,3188.86440677966,47,15,62,100
"./Ship3_Latin-square/2019-10-13_09h55m_Subject 47081.txt","47081",2019-10-13,"09:55",8,83,60,12,11,23,27,9,3,39,8,19,0,27,399,93,74,566,148.566666666667,173.266666666667,2593.20338983051,2044.41509433962,48,125,173,90.1639344262295
"./Ship3_Latin-square/2019-10-13_09h55m_Subject 47095.txt","47095",2019-10-13,"09:55",4,81,60,10,11,21,20,3,1,24,43,6,20,69,386,72,103,561,152.683333333333,165.9,2803.28813559322,1990.47272727273,21,93,114,93.4426229508197
"./Ship3_Latin-square/2019-10-13_10h01m_Subject 47086.txt","47086",2019-10-13,"10:01",16,78,60,9,9,18,19,0,5,24,13,1,1,15,434,29,73,536,153.833333333333,100.966666666667,2186.42372881356,1212.89473684211,41,66,107,98.3606557377049
"./Ship3_Latin-square/2019-10-13_10h01m_Subject 47790.txt","47790",2019-10-13,"10:01",4,79,60,6,13,19,40,5,5,50,81,6,34,121,297,22,101,420,635.05,250.233333333333,2755.8813559322,2502.68421052632,60,72,132,96.7213114754098
"./Ship3_Latin-square/2019-10-13_10h01m_Subject 47797.txt","47797",2019-10-13,"10:01",8,68,50,7,11,18,39,3,11,53,50,6,31,87,133,28,25,186,1416.36,389.18,2559.0612244898,3085.09523809524,17,106,123,86.2745098039216
"./Ship3_Latin-square/2019-10-13_11h17m_Subject 46986.txt","46986",2019-10-13,"11:17",16,74,55,10,9,19,60,6,8,74,26,3,13,42,239,31,36,306,1272.41818181818,285.636363636364,2243.58181818182,2200.07547169811,73,66,139,98.2142857142857
"./Ship3_Latin-square/2019-10-13_11h17m_Subject 47098.txt","47098",2019-10-13,"11:17",4,77,60,7,10,17,24,1,3,28,9,0,5,14,545,68,112,725,137.716666666667,109.483333333333,2782.96610169492,1392.35185185185,25,78,103,95.0819672131148
"./Ship3_Latin-square/2019-10-13_11h17m_Subject 47645.txt","47645",2019-10-13,"11:17",16,77,56,12,9,21,90,14,15,119,9,4,9,22,167,23,49,239,1445.85714285714,132.178571428571,2301.78181818182,2779.58,70,65,135,91.0714285714286
"./Ship3_Latin-square/2019-10-13_11h20m_Subject 47234.txt","47234",2019-10-13,"11:20",16,82,60,12,10,22,47,5,14,66,72,101,2,175,234,57,48,339,426.6,302.966666666667,2240.59322033898,1620.21428571429,67,66,133,96.7213114754098
"./Ship3_Latin-square/2019-10-13_11h20m_Subject 47237.txt","47237",2019-10-13,"11:20",2,78,60,7,11,18,7,1,2,10,5,1,2,8,715,103,156,974,105.35,115.516666666667,2888.13559322034,1282.67796610169,25,32,57,100
"./Ship3_Latin-square/2019-10-13_11h20m_Subject 47241.txt","47241",2019-10-13,"11:20",8,79,60,9,10,19,15,4,4,23,16,14,3,33,823,88,160,1071,144.633333333333,111.916666666667,2593.15254237288,1213.57627118644,56,46,102,98.3606557377049
"./Ship3_Latin-square/2019-10-13_12h30m_Subject 46896.txt","46896",2019-10-13,"12:30",0,81,60,5,16,21,24,0,2,26,32,7,9,48,691,59,145,895,265.95,131.983333333333,2999.89830508475,1480.10344827586,22,26,48,98.3606557377049
"./Ship3_Latin-square/2019-10-13_12h30m_Subject 47753.txt","47753",2019-10-13,"12:30",16,86,60,16,10,26,55,11,14,80,27,13,18,58,429,64,108,601,362.916666666667,210.95,2349.10169491525,1365.45283018868,90,97,187,90.1639344262295
"./Ship3_Latin-square/2019-10-13_12h35m_Subject 47632.txt","47632",2019-10-13,"12:35",2,80,60,8,12,20,15,5,3,23,7,10,5,22,673,74,140,887,219.583333333333,97.1833333333333,2884.71186440678,1682.47457627119,28,59,87,100
"./Ship3_Latin-square/2019-10-13_13h45m_Subject 46897.txt","46897",2019-10-13,"13:45",24,64,45,14,5,19,69,16,6,91,18,8,1,27,81,3,9,93,2137.53333333333,444.755555555556,2199.93333333333,3404.51515151515,44,36,80,82.6086956521739
"./Ship3_Latin-square/2019-10-13_13h49m_Subject 46890.txt","46890",2019-10-13,"13:49",0,82,60,9,13,22,15,1,0,16,20,12,8,40,738,162,157,1057,135.233333333333,105.15,2999.83050847458,2270.2,131,162,293,86.8852459016393
"./Ship3_Latin-square/2019-10-14_10h10m_Subject 47095.txt","47095",2019-10-14,"10:10",16,81,60,10,11,21,22,8,8,38,34,14,15,63,337,36,84,457,208.933333333333,158.15,2186.40677966102,1596.34545454545,60,65,125,91.8032786885246
"./Ship3_Latin-square/2019-10-14_10h15m_Subject 47086.txt","47086",2019-10-14,"10:15",8,79,60,10,9,19,27,3,3,33,10,1,3,14,702,105,124,931,128.816666666667,110.216666666667,2593.22033898305,1295.20338983051,51,77,128,100
"./Ship3_Latin-square/2019-10-14_10h15m_Subject 47790.txt","47790",2019-10-14,"10:15",16,83,58,15,10,25,62,10,11,83,44,22,5,71,346,57,62,465,1128.20689655172,228.568965517241,2310.31034482759,2304.94117647059,67,81,148,93.2203389830508
"./Ship3_Latin-square/2019-10-14_11h30m_Subject 46986.txt","46986",2019-10-14,"11:30",8,80,60,11,9,20,35,10,6,51,9,5,6,20,382,57,92,531,384.233333333333,118.766666666667,2647.37288135593,1454.75862068966,64,38,102,98.3606557377049
"./Ship3_Latin-square/2019-10-14_11h30m_Subject 47098.txt","47098",2019-10-14,"11:30",2,82,60,10,12,22,21,4,1,26,5,2,2,9,562,115,109,786,186.866666666667,93.75,2898.25423728814,1819.03773584906,45,129,174,96.7213114754098
"./Ship3_Latin-square/2019-10-14_11h30m_Subject 47645.txt","47645",2019-10-14,"11:30",8,79,60,10,9,19,78,13,10,101,12,1,2,15,240,34,44,318,1098.9,136.683333333333,2593.22033898305,2846.26315789474,85,67,152,96.7213114754098
"./Ship3_Latin-square/2019-10-14_11h33m_Subject 47234.txt","47234",2019-10-14,"11:33",8,83,60,10,13,23,32,5,7,44,18,10,1,29,482,72,100,654,163.05,154.983333333333,2566.06779661017,1376.20338983051,64,70,134,100
"./Ship3_Latin-square/2019-10-14_11h33m_Subject 47237.txt","47237",2019-10-14,"11:33",0,79,60,7,12,19,32,40,2,74,25,1,22,48,751,86,154,991,186.25,137.55,2999.93220338983,1303.57627118644,102,35,137,100
"./Ship3_Latin-square/2019-10-14_12h33m_Subject 47632.txt","47632",2019-10-14,"12:33",24,78,60,9,9,18,18,0,3,21,18,6,16,40,543,9,142,694,87.6,98.6,1820.30508474576,941.869565217391,32,75,107,80.327868852459
"./Ship3_Latin-square/2019-10-14_12h41m_Subject 46896.txt","46896",2019-10-14,"12:41",2,81,60,5,16,21,13,1,2,16,37,8,12,57,798,69,164,1031,185.35,135.566666666667,2864.37288135593,1155.74576271186,13,24,37,100
"./Ship3_Latin-square/2019-10-14_12h41m_Subject 47753.txt","47753",2019-10-14,"12:41",24,85,60,17,8,25,65,7,13,85,51,23,12,86,447,25,92,564,478.883333333333,253.133333333333,2145.74576271186,1062.10204081633,93,85,178,83.6065573770492
"./Ship3_Latin-square/2019-10-14_13h27m_Subject 46890.txt","46890",2019-10-14,"13:27",4,82,60,9,13,22,11,3,3,17,19,4,10,33,415,28,141,584,285.683333333333,92.85,2782.98305084746,2590.73529411765,113,148,261,72.1311475409836
"./Ship3_Latin-square/2019-10-14_13h42m_Subject 46897.txt","46897",2019-10-14,"13:42",16,66,49,10,7,17,60,11,9,80,29,10,3,42,97,12,12,121,1802.14285714286,337.897959183673,2314.20408163265,3963.625,58,49,107,86
"./Ship3_Latin-square/2019-10-15_09h52m_Subject 47790.txt","47790",2019-10-15,"09:52",24,42,31,7,4,11,51,9,5,65,23,11,4,38,117,4,12,133,6913.9,201.466666666667,2039.9,5575.80769230769,30,29,59,87.0967741935484
"./Ship3_Latin-square/2019-10-15_09h54m_Subject 47095.txt","47095",2019-10-15,"09:54",24,66,50,10,6,16,39,2,10,51,43,11,22,76,212,9,17,238,2141.22448979592,208.734693877551,1922.42857142857,1952.14285714286,45,55,100,84
"./Ship3_Latin-square/2019-10-15_11h10m_Subject 47098.txt","47098",2019-10-15,"11:10",0,81,60,9,12,21,15,2,3,20,6,0,0,6,558,104,129,791,143.266666666667,95.25,2999.81355932203,1775.44642857143,53,68,121,96.7213114754098
"./Ship3_Latin-square/2019-10-15_11h15m_Subject 47237.txt","47237",2019-10-15,"11:15",2,81,60,9,12,21,8,5,1,14,17,1,11,29,637,66,154,857,259.066666666667,128.966666666667,2891.47457627119,1624.71929824561,95,55,150,96.7213114754098
"./Ship3_Latin-square/2019-10-15_12h22m_Subject 47632.txt","47632",2019-10-15,"12:22",4,79,60,9,10,19,13,1,3,17,16,12,1,29,808,84,115,1007,104.15,114.2,2796.59322033898,1212.77966101695,29,43,72,96.7213114754098
"./Ship3_Latin-square/2019-10-15_12h24m_Subject 46896.txt","46896",2019-10-15,"12:24",24,75,60,7,8,15,29,5,3,37,41,9,2,52,310,9,68,387,216.266666666667,136.75,1820.28813559322,1067.38461538462,38,39,77,93.4426229508197
"./Ship3_Latin-square/2019-10-15_12h24m_Subject 47753.txt","47753",2019-10-15,"12:24",8,80,60,9,11,20,8,1,1,10,19,4,7,30,665,88,177,930,162.666666666667,129.766666666667,2579.62711864407,1354.15254237288,58,77,135,100
"./Ship3_Latin-square/2019-10-15_13h35m_Subject 46897.txt","46897",2019-10-15,"13:35",8,53,40,10,3,13,87,11,6,104,21,6,3,30,81,23,4,108,3077.94871794872,637.179487179487,2733.25641025641,4810.88235294118,59,26,85,90
"./Ship3_Latin-square/2019-10-15_13h39m_Subject 46890.txt","46890",2019-10-15,"13:39",2,85,60,11,14,25,11,2,4,17,29,5,9,43,541,98,184,823,213.716666666667,179.916666666667,2898.20338983051,2039.42222222222,87,116,203,83.6065573770492
"./Ship3_Latin-square/2019-10-16_09h37m_Subject 47790.txt","47790",2019-10-16,"09:37",8,76,60,9,7,16,20,1,5,26,30,7,4,41,447,69,56,572,242.516666666667,176.983333333333,2620.28813559322,1801.7962962963,59,67,126,93.4426229508197
"./Ship3_Latin-square/2019-10-16_09h39m_Subject 47095.txt","47095",2019-10-16,"09:39",8,82,60,13,9,22,5,2,3,10,21,5,7,33,536,143,78,757,92.2333333333333,128.633333333333,2620.25423728814,1774.9649122807,56,76,132,93.4426229508197
"./Ship3_Latin-square/2019-10-16_10h57m_Subject 47237.txt","47237",2019-10-16,"10:57",24,77,60,13,4,17,93,5,14,112,93,28,5,126,298,9,15,322,807.133333333333,602.316666666667,2105.01694915254,879.122807017544,53,32,85,95.0819672131148
"./Ship3_Latin-square/2019-10-16_11h05m_Subject 47098.txt","47098",2019-10-16,"11:05",2,80,60,9,11,20,8,1,2,11,2,0,1,3,587,75,89,751,182.516666666667,87.5833333333333,2894.91525423729,1646.31034482759,43,66,109,96.7213114754098
"./Ship3_Latin-square/2019-10-16_12h01m_Subject 47632.txt","47632",2019-10-16,"12:01",16,80,60,10,10,20,6,1,4,11,15,8,0,23,734,106,157,997,70.9166666666667,106.95,2213.52542372881,1120.10169491525,47,38,85,98.3606557377049
"./Ship3_Latin-square/2019-10-16_12h12m_Subject 46896.txt","46896",2019-10-16,"12:12",4,80,60,9,11,20,13,3,1,17,34,17,10,61,704,104,143,951,165.133333333333,133.216666666667,2789.76271186441,1434.64406779661,42,26,68,100
"./Ship3_Latin-square/2019-10-16_12h12m_Subject 47753.txt","47753",2019-10-16,"12:12",0,78,60,4,14,18,15,0,2,17,17,1,7,25,1022,53,191,1266,441.4,139.333333333333,2999.94915254237,1373.35593220339,48,92,140,100
"./Ship3_Latin-square/2019-10-16_13h12m_Subject 46890.txt","46890",2019-10-16,"13:12",0,82,59,9,14,23,18,5,1,24,15,6,10,31,457,32,130,619,1226.25862068966,95.7413793103448,2999.93103448276,2631.62222222222,56,110,166,84.7457627118644
"./Ship3_Latin-square/2019-10-16_13h15m_Subject 46897.txt","46897",2019-10-16,"13:15",16,50,35,11,4,15,76,16,12,104,18,15,10,43,66,21,11,98,3102.88235294118,434.470588235294,2482.26470588235,4707.06666666667,53,37,90,88.5714285714286
"./Ship3_Latin-square/2019-10-17_09h57m_Subject 47790.txt","47790",2019-10-17,"09:57",0,78,60,8,10,18,13,3,3,19,17,2,7,26,791,133,167,1091,149.066666666667,134.6,2999.91525423729,1558.6724137931,42,41,83,98.3606557377049
"./Ship3_Latin-square/2019-10-17_10h00m_Subject 47095.txt","47095",2019-10-17,"10:00",0,80,60,7,13,20,25,1,1,27,34,9,11,54,608,101,112,821,205.233333333333,156.766666666667,2999.91525423729,1783.77966101695,45,74,119,96.7213114754098
"./Ship3_Latin-square/2019-10-17_11h27m_Subject 47237.txt","47237",2019-10-17,"11:27",4,81,60,8,13,21,4,1,1,6,21,6,6,33,727,62,185,974,99.8666666666667,111.933333333333,2769.47457627119,908.338983050847,22,15,37,100
"./Ship3_Latin-square/2019-10-17_11h29m_Subject 47098.txt","47098",2019-10-17,"11:29",24,81,60,11,10,21,37,1,9,47,29,6,15,50,161,4,40,205,475.083333333333,161.116666666667,1942.32203389831,1662.02,42,48,90,85.2459016393443
"./Ship3_Latin-square/2019-10-17_12h52m_Subject 47632.txt","47632",2019-10-17,"12:52",8,79,60,10,9,19,13,2,1,16,17,11,3,31,684,106,120,910,143.983333333333,115.65,2620.30508474576,1259.10344827586,46,41,87,98.3606557377049
"./Ship3_Latin-square/2019-10-17_12h54m_Subject 46896.txt","46896",2019-10-17,"12:54",16,80,60,9,11,20,41,5,7,53,38,10,11,59,496,66,82,644,319.65,122.55,2159.28813559322,1146.68965517241,19,39,58,98.3606557377049
"./Ship3_Latin-square/2019-10-17_12h54m_Subject 47753.txt","47753",2019-10-17,"12:54",4,79,60,8,11,19,9,1,3,13,23,5,9,37,793,97,168,1058,114.033333333333,130.166666666667,2782.94915254237,1386.52631578947,54,93,147,96.7213114754098
"./Ship3_Latin-square/2019-10-17_13h58m_Subject 46890.txt","46890",2019-10-17,"13:58",2,83,60,11,12,23,11,3,0,14,34,12,18,64,602,85,200,887,255.166666666667,109.766666666667,2894.91525423729,1890.59183673469,52,118,170,86.8852459016393
"./Ship3_Latin-square/2019-10-17_14h00m_Subject 46897.txt","46897",2019-10-17,"14:00",4,57,44,8,5,13,67,9,8,84,14,27,20,61,121,12,17,150,2575.44186046512,181.744186046512,2813.90697674419,3258.48648648649,45,29,74,86.3636363636364
"./Ship3_Latin-square/2019-10-18_09h57m_Subject 47790.txt","47790",2019-10-18,"09:57",4,76,60,9,7,16,39,5,5,49,30,13,2,45,394,75,31,500,428.016666666667,180.9,2810.10169491525,2263.375,65,55,120,86.8852459016393
"./Ship3_Latin-square/2019-10-18_10h00m_Subject 47095.txt","47095",2019-10-18,"10:00",4,87,60,14,13,27,10,9,1,20,27,14,10,51,570,125,124,819,127.65,153.05,2803.33898305085,1899.69491525424,46,63,109,98.3606557377049
"./Ship3_Latin-square/2019-10-18_11h04m_Subject 47237.txt","47237",2019-10-18,"11:04",16,77,60,9,8,17,30,1,7,38,34,14,1,49,469,35,65,569,264.583333333333,203.783333333333,2267.72881355932,1126.38596491228,41,37,78,96.7213114754098
"./Ship3_Latin-square/2019-10-18_11h06m_Subject 47098.txt","47098",2019-10-18,"11:06",4,77,60,7,10,17,10,3,2,15,6,0,6,12,491,43,86,620,173.766666666667,97.05,2789.76271186441,1627.05263157895,30,73,103,98.3606557377049
"./Ship3_Latin-square/2019-10-18_12h11m_Subject 46896.txt","46896",2019-10-18,"12:11",8,84,60,11,13,24,19,4,5,28,36,19,10,65,642,121,119,882,134.15,134.616666666667,2579.62711864407,1351.79661016949,35,24,59,100
"./Ship3_Latin-square/2019-10-18_12h11m_Subject 47753.txt","47753",2019-10-18,"12:11",2,79,60,9,10,19,12,1,1,14,14,4,7,25,783,114,142,1039,137.683333333333,136.183333333333,2894.8813559322,1744.81034482759,52,135,187,98.3606557377049
"./Ship3_Latin-square/2019-10-18_13h16m_Subject 46890.txt","46890",2019-10-18,"13:16",24,75,54,13,8,21,55,5,7,67,35,18,9,62,136,1,30,167,1116.03703703704,376.851851851852,1977.68518518519,2526.35897435897,65,54,119,72.7272727272727
"./Ship3_Latin-square/2019-10-18_13h18m_Subject 46897.txt","46897",2019-10-18,"13:18",24,46,34,8,4,12,60,7,12,79,23,31,4,58,51,3,7,61,3569.23529411765,788.575757575758,2127.24242424242,4347.7037037037,46,19,65,85.2941176470588
"./Ship3_Latin-square/2019-10-19_09h30m_Subject 47790.txt","47790",2019-10-19,"09:30",2,80,60,9,11,20,19,2,1,22,30,7,3,40,626,108,62,796,265,196.75,2891.4406779661,2036.78,72,120,192,90.1639344262295
"./Ship3_Latin-square/2019-10-19_09h32m_Subject 47095.txt","47095",2019-10-19,"09:32",2,77,60,6,11,17,20,4,2,26,36,5,15,56,337,42,50,429,390.15,169.85,2881.32203389831,2435.76363636364,36,64,100,91.8032786885246
"./Ship3_Latin-square/2019-10-19_10h38m_Subject 47237.txt","47237",2019-10-19,"10:38",8,78,60,9,9,18,12,4,0,16,28,2,4,34,628,48,107,783,120.333333333333,102.35,2593.20338983051,1198.37931034483,39,40,79,98.3606557377049
"./Ship3_Latin-square/2019-10-19_10h40m_Subject 47098.txt","47098",2019-10-19,"10:40",16,77,55,4,18,22,39,0,16,55,14,0,21,35,174,18,114,306,1248.47272727273,158.163636363636,1785.16666666667,4105.47058823529,13,226,239,48.2142857142857
"./Ship3_Latin-square/2019-10-19_11h50m_Subject 47753.txt","47753",2019-10-19,"11:50",0,82,60,6,16,22,42,4,9,55,23,2,30,55,606,72,155,833,553.233333333333,207.516666666667,2999.89830508475,1969.31578947368,39,120,159,96.7213114754098
"./Ship3_Latin-square/2019-10-19_12h49m_Subject 46890.txt","46890",2019-10-19,"12:49",4,83,60,11,12,23,12,4,4,20,52,13,13,78,552,148,124,824,206.95,157.066666666667,2789.77966101695,2270.8085106383,48,129,177,81.9672131147541
"./Ship3_Latin-square/2019-10-19_12h55m_Subject 46897.txt","46897",2019-10-19,"12:55",2,79,56,9,14,23,40,9,5,54,17,9,15,41,200,19,63,282,1333.41071428571,158.357142857143,2892.83928571429,3210.06666666667,44,64,108,87.719298245614
"./Ship3_Latin-square/2019-10-20_10h10m_Subject 47095.txt","47095",2019-10-20,"10:10",0,78,60,9,9,18,33,4,5,42,36,14,18,68,620,104,100,824,195.083333333333,222.75,2999.8813559322,2013.94827586207,42,103,145,96.7213114754098
"./Ship3_Latin-square/2019-10-20_10h15m_Subject 47790.txt","47790",2019-10-20,"10:15",0,81,60,8,13,21,21,4,4,29,13,2,6,21,558,109,75,742,213.133333333333,122.833333333333,2999.89830508475,2131.50980392157,49,93,142,90.1639344262295
"./Ship3_Latin-square/2019-10-20_11h27m_Subject 47098.txt","47098",2019-10-20,"11:27",8,84,60,12,12,24,16,4,7,27,14,6,53,73,412,80,100,592,180.383333333333,125.083333333333,2593.13559322034,1867.86666666667,41,163,204,83.6065573770492
"./Ship3_Latin-square/2019-10-20_12h35m_Subject 47753.txt","47753",2019-10-20,"12:35",2,79,60,7,12,19,6,0,0,6,11,8,1,20,830,113,157,1100,78.4833333333333,134.666666666667,2891.50847457627,1476.18965517241,56,113,169,98.3606557377049
"./Ship3_Latin-square/2019-10-20_13h45m_Subject 46897.txt","46897",2019-10-20,"13:45",0,81,60,9,12,21,21,6,3,30,13,5,12,30,232,33,43,308,199.55,128.583333333333,2999.89830508475,2150.66666666667,86,28,114,81.9672131147541
"./Ship3_Latin-square/2019-10-20_13h49m_Subject 46890.txt","46890",2019-10-20,"13:49",16,74,53,12,9,21,26,2,2,30,27,6,10,43,627,50,81,758,346.326923076923,125.423076923077,2261.5,2024.82051282051,35,102,137,81.1320754716981
"./Ship3_Latin-square/2019-10-21_10h05m_Subject 47095.txt","47095",2019-10-21,"10:05",2,76,60,5,11,16,63,1,2,66,36,6,14,56,654,42,118,814,176.516666666667,181.816666666667,2877.94915254237,1762.8813559322,29,96,125,98.3606557377049
"./Ship3_Latin-square/2019-10-21_10h09m_Subject 47790.txt","47790",2019-10-21,"10:09",2,82,60,10,12,22,24,3,5,32,4,4,7,15,681,143,107,931,232.033333333333,127.666666666667,2894.86440677966,1988.42857142857,75,141,216,86.8852459016393
"./Ship3_Latin-square/2019-10-21_12h30m_Subject 47753.txt","47753",2019-10-21,"12:30",24,83,60,14,9,23,78,9,10,97,52,68,21,141,308,12,84,404,555.3,240.45,1983.01694915254,1501.82,102,92,194,85.2459016393443
"./Ship3_Latin-square/2019-10-21_13h35m_Subject 46897.txt","46897",2019-10-21,"13:35",24,78,58,11,9,20,43,7,5,55,36,14,18,68,77,0,26,103,830.379310344828,434.637931034483,1905.22807017544,2726.10256410256,43,70,113,71.1864406779661
"./Ship3_Latin-square/2019-10-21_13h39m_Subject 46890.txt","46890",2019-10-21,"13:39",8,80,60,8,12,20,7,0,1,8,46,4,21,71,793,109,233,1135,137.8,127.616666666667,2525.37288135593,1699.52830188679,30,95,125,93.4426229508197
"./Ship3_Latin-square/2019-10-22_10h02m_Subject 47790.txt","47790",2019-10-22,"10:02",24,82,60,12,10,22,46,9,10,65,21,17,6,44,188,11,83,282,694.016666666667,170.383333333333,1860.96610169492,2815.13157894737,56,86,142,72.1311475409836
"./Ship3_Latin-square/2019-10-22_10h04m_Subject 47095.txt","47095",2019-10-22,"10:04",24,78,59,12,7,19,54,7,8,69,40,9,12,61,262,14,32,308,714.431034482759,186.120689655172,1924.06896551724,2044.05882352941,55,78,133,86.4406779661017
"./Ship3_Latin-square/2019-10-22_12h40m_Subject 47753.txt","47753",2019-10-22,"12:40",4,80,60,8,12,20,10,1,0,11,24,0,3,27,933,124,248,1305,70.4666666666667,137.65,2776.25423728814,1368.34482758621,66,124,190,100
"./Ship3_Latin-square/2019-10-22_14h02m_Subject 46897.txt","46897",2019-10-22,"14:02",0,84,60,7,17,24,43,8,7,58,4,7,5,16,272,18,75,365,528.5,108.866666666667,2999.89830508475,1845.24,33,59,92,88.5245901639344
"./Ship3_Latin-square/2019-10-23_09h57m_Subject 47790.txt","47790",2019-10-23,"09:57",4,80,60,8,12,20,18,3,2,23,15,3,5,23,468,61,90,619,222.666666666667,123.75,2782.96610169492,2265.57142857143,52,135,187,81.9672131147541
"./Ship3_Latin-square/2019-10-23_10h00m_Subject 47095.txt","47095",2019-10-23,"10:00",4,80,60,6,14,20,10,1,2,13,22,8,11,41,644,62,146,852,79.25,127.85,2755.8813559322,1529.08620689655,30,60,90,98.3333333333333
"./Ship3_Latin-square/2019-10-23_12h26m_Subject 47753.txt","47753",2019-10-23,"12:26",16,84,60,13,11,24,27,2,8,37,15,8,13,36,641,86,162,889,156.4,135.616666666667,2267.72881355932,1058.66101694915,73,53,126,100
"./Ship3_Latin-square/2019-10-23_14h00m_Subject 46897.txt","46897",2019-10-23,"14:00",16,52,37,14,1,15,47,31,0,78,15,7,1,23,104,15,2,121,2401.08333333333,322.75,2777.63888888889,4861.96774193548,67,11,78,86.4864864864865
"./Ship3_Latin-square/2019-10-24_09h53m_Subject 47790.txt","47790",2019-10-24,"09:53",16,81,60,12,9,21,14,3,0,17,18,9,2,29,324,46,98,468,382.816666666667,139.65,2240.62711864407,1842.61538461538,38,126,164,78.6885245901639
"./Ship3_Latin-square/2019-10-24_09h56m_Subject 47095.txt","47095",2019-10-24,"09:56",16,75,56,12,7,19,37,8,2,47,15,16,5,36,379,30,65,474,836.127272727273,115.218181818182,2330.85454545455,3299.35294117647,52,62,114,94.6428571428571
"./Ship3_Latin-square/2019-10-24_12h17m_Subject 47753.txt","47753",2019-10-24,"12:17",8,83,60,10,13,23,8,0,4,12,16,14,4,34,925,145,248,1318,78.75,124.75,2552.47457627119,1142.05172413793,43,125,168,98.3606557377049
"./Ship3_Latin-square/2019-10-24_13h35m_Subject 46897.txt","46897",2019-10-24,"13:35",2,79,60,9,10,19,53,7,5,65,15,7,11,33,339,30,48,417,433.25,158.6,2891.4406779661,1560.59649122807,55,19,74,96.7213114754098
"./Ship3_Latin-square/2019-10-25_09h48m_Subject 47790.txt","47790",2019-10-25,"09:48",8,77,60,8,9,17,10,5,2,17,28,4,7,39,511,27,87,625,291.05,140.133333333333,2579.62711864407,1718.54761904762,30,212,242,81.9672131147541
"./Ship3_Latin-square/2019-10-25_09h51m_Subject 47095.txt","47095",2019-10-25,"09:51",8,76,59,11,6,17,30,13,0,43,36,12,4,52,367,54,53,474,470.98275862069,162.103448275862,2627.48275862069,2168.01785714286,34,65,99,98.3050847457627
"./Ship3_Latin-square/2019-10-25_12h54m_Subject 46897.txt","46897",2019-10-25,"12:54",8,69,52,8,9,17,75,8,7,90,14,6,6,26,176,18,26,220,1942.07843137255,182.960784313725,2607.80392156863,2200.75,42,24,66,94.2307692307692
"./Ship3_Latin-square/2019-10-26_12h51m_Subject 46897.txt","46897",2019-10-26,"12:51",4,81,60,10,11,21,56,5,5,66,19,4,3,26,183,30,43,256,815,154.316666666667,2789.77966101695,2368.27272727273,70,53,123,88.5245901639344
"./Ship3_Latin-square/2019-10-27_14h01m_Subject 46897.txt","46897",2019-10-27,"14:01",16,47,36,10,1,11,68,16,2,86,7,22,1,30,108,16,4,128,3784.88888888889,174.305555555556,2542.77142857143,2665.25806451613,49,14,63,89.1891891891892
"./Ship3_Latin-square/2019-10-28_13h40m_Subject 46897.txt","46897",2019-10-28,"13:40",24,45,32,13,0,13,53,24,0,77,35,45,0,80,80,3,0,83,2799.03125,1726.96875,2767.67741935484,3799.34482758621,51,14,65,93.9393939393939
"./Ship3_Latin-square/2019-10-29_14h16m_Subject 46897.txt","46897",2019-10-29,"14:16",8,64,47,9,8,17,70,6,8,84,34,26,7,67,253,28,71,352,1577.95652173913,998.630434782609,2634.76086956522,2124.11111111111,28,41,69,97.8723404255319
"./Ship3_Latin-square/2019-10-30_13h20m_Subject 46897.txt","46897",2019-10-30,"13:20",8,64,46,13,5,18,79,14,4,97,11,27,3,41,163,18,14,195,2319.08695652174,296.45652173913,2733.28888888889,1594.5,36,43,79,93.6170212765958
"./Ship3_Latin-square/2019-10-31_13h05m_Subject 46897.txt","46897",2019-10-31,"13:05",0,78,60,7,11,18,45,7,11,63,7,1,5,13,307,24,66,397,1155.35,120.65,2999.91525423729,1898.14545454545,20,69,89,98.3606557377049
"./Ship3_Latin-square/2019-11-01_13h07m_Subject 46897.txt","46897",2019-11-01,"13:07",4,83,60,10,13,23,37,5,5,47,6,2,5,13,241,31,70,342,400.166666666667,113.75,2776.27118644068,1575.10526315789,21,39,60,96.7213114754098
"./Ship3_Latin-square/2019-11-02_12h58m_Subject 46897.txt","46897",2019-11-02,"12:58",2,82,60,11,11,22,46,4,7,57,3,8,1,12,249,48,50,347,980.271186440678,122.152542372881,2898.25423728814,1952.41818181818,37,32,69,96.6666666666667
"./Ship3_Latin-square/2019-11-03_13h55m_Subject 46897.txt","46897",2019-11-03,"13:55",0,81,60,8,13,21,21,2,3,26,12,5,10,27,317,37,52,406,336.383333333333,138.483333333333,2999.86440677966,1673.11538461538,82,45,127,93.4426229508197
"./Ship3_Latin-square/2019-11-04_13h29m_Subject 46897.txt","46897",2019-11-04,"13:29",2,84,60,10,14,24,21,3,8,32,10,2,6,18,243,25,96,364,397.716666666667,125.45,2888.08474576271,1740.30434782609,32,74,106,86.8852459016393
"./Ship3_Latin-square/2019-11-05_13h30m_Subject 46897.txt","46897",2019-11-05,"13:30",24,50,39,9,2,11,87,13,5,105,33,5,2,40,86,3,4,93,2863.97368421053,845.289473684211,2242.02631578947,2644.54054054054,40,9,49,97.4358974358974
"./Ship3_Latin-square/2019-11-06_13h35m_Subject 46897.txt","46897",2019-11-06,"13:35",4,81,60,9,12,21,19,6,3,28,12,2,3,17,157,22,44,223,350.966666666667,158.116666666667,2783.03389830508,2050.04081632653,38,39,77,86.8852459016393
"./Ship3_Latin-square/2019-11-07_13h10m_Subject 46897.txt","46897",2019-11-07,"13:10",16,67,49,10,8,18,62,17,14,93,62,39,8,109,136,12,32,180,1109.97916666667,566.875,2266.64583333333,1377.20930232558,18,48,66,89.7959183673469
