"filename","subject","date","time","tot_num_trials","tot_num_free","tot_num_fd","tot_num_fi","tot_forced_trials","events_before_center","events_before_center_fd","events_before_center_fi","events_before_center_tot","events_before_choice","events_before_choice_fd","events_before_choice_fi","events_before_choice_tot","events_during_to","events_during_to_fd","events_during_to_fi","events_during_to_tot"
"./Ship3_Latin-square/2019-08-24_12h55m_Subject 47754.txt","47754",2019-08-24,"12:55",61,46,10,5,15,121,18,18,157,72,47,5,124,160,0,32,192
"./Ship3_Latin-square/2019-08-24_13h00m_Subject 46894.txt","46894",2019-08-24,"13:00",83,60,10,13,23,105,11,41,157,57,24,25,106,761,137,142,1040
"./Ship3_Latin-square/2019-08-24_13h00m_Subject 47088.txt","47088",2019-08-24,"13:00",76,56,10,10,20,86,18,11,115,82,21,35,138,319,55,60,434
"./Ship3_Latin-square/2019-08-24_13h00m_Subject 47228.txt","47228",2019-08-24,"13:00",79,56,10,13,23,81,13,22,116,116,16,25,157,573,114,142,829
"./Ship3_Latin-square/2019-08-24_13h00m_Subject 47243.txt","47243",2019-08-24,"13:00",27,19,8,0,8,40,40,0,80,10,10,0,20,85,50,0,135
"./Ship3_Latin-square/2019-08-24_13h00m_Subject 47249.txt","47249",2019-08-24,"13:00",79,60,5,14,19,133,16,15,164,129,13,34,176,469,18,151,638
"./Ship3_Latin-square/2019-08-24_13h00m_Subject 47639.txt","47639",2019-08-24,"13:00",80,60,12,8,20,179,14,10,203,80,39,44,163,744,113,108,965
"./Ship3_Latin-square/2019-08-24_13h00m_Subject 47758.txt","47758",2019-08-24,"13:00",86,60,12,14,26,73,10,8,91,40,25,67,132,652,71,239,962
"./Ship3_Latin-square/2019-08-24_13h00m_Subject 47759.txt","47759",2019-08-24,"13:00",79,60,7,12,19,78,16,12,106,74,11,32,117,498,70,122,690
"./Ship3_Latin-square/2019-08-24_13h00m_Subject 47776.txt","47776",2019-08-24,"13:00",81,60,6,15,21,66,6,7,79,83,21,54,158,756,64,227,1047
"./Ship3_Latin-square/2019-08-24_13h00m_Subject 47799.txt","47799",2019-08-24,"13:00",79,60,10,9,19,54,6,6,66,96,47,10,153,449,59,104,612
"./Ship3_Latin-square/2019-08-24_14h03m_Subject 46892.txt","46892",2019-08-24,"14:03",83,60,8,15,23,62,5,15,82,29,9,16,54,623,77,163,863
"./Ship3_Latin-square/2019-08-24_14h03m_Subject 47099.txt","47099",2019-08-24,"14:03",81,60,10,11,21,108,24,15,147,129,78,71,278,572,69,138,779
"./Ship3_Latin-square/2019-08-24_14h20m_Subject 46893.txt","46893",2019-08-24,"14:20",82,60,8,14,22,84,9,11,104,81,11,40,132,856,117,238,1211
"./Ship3_Latin-square/2019-08-24_14h20m_Subject 47638.txt","47638",2019-08-24,"14:20",68,51,8,9,17,149,50,14,213,95,37,120,252,447,54,69,570
"./Ship3_Latin-square/2019-08-24_14h20m_Subject 47757.txt","47757",2019-08-24,"14:20",64,47,10,7,17,118,30,18,166,85,52,20,157,354,80,70,504
"./Ship3_Latin-square/2019-08-24_14h20m_Subject 47769.txt","47769",2019-08-24,"14:20",79,60,8,11,19,63,6,16,85,68,19,26,113,892,103,188,1183
"./Ship3_Latin-square/2019-08-24_14h20m_Subject 47782.txt","47782",2019-08-24,"14:20",79,60,10,9,19,48,8,6,62,17,5,22,44,683,65,116,864
"./Ship3_Latin-square/2019-08-24_14h20m_Subject 47788.txt","47788",2019-08-24,"14:20",82,60,7,15,22,90,12,9,111,70,11,37,118,360,39,123,522
"./Ship3_Latin-square/2019-08-24_15h15m_Subject 47080.txt","47080",2019-08-24,"15:15",82,60,10,12,22,62,14,16,92,81,24,12,117,536,86,117,739
"./Ship3_Latin-square/2019-08-25_10h51m_Subject 47229.txt","47229",2019-08-25,"10:51",78,60,6,12,18,99,29,8,136,157,65,46,268,699,62,160,921
"./Ship3_Latin-square/2019-08-25_11h07m_Subject 47250.txt","47250",2019-08-25,"11:07",78,57,11,10,21,168,86,9,263,33,26,77,136,618,94,117,829
"./Ship3_Latin-square/2019-08-25_11h56m_Subject 47754.txt","47754",2019-08-25,"11:56",66,50,8,8,16,169,19,4,192,57,17,11,85,313,31,58,402
"./Ship3_Latin-square/2019-08-25_11h56m_Subject 47800.txt","47800",2019-08-25,"11:56",71,52,12,7,19,113,15,16,144,94,30,20,144,381,74,39,494
"./Ship3_Latin-square/2019-08-25_12h23m_Subject 46894.txt","46894",2019-08-25,"12:23",80,60,8,12,20,66,10,10,86,28,14,5,47,527,69,144,740
"./Ship3_Latin-square/2019-08-25_12h23m_Subject 47088.txt","47088",2019-08-25,"12:23",80,60,3,17,20,59,3,13,75,131,8,113,252,567,34,132,733
"./Ship3_Latin-square/2019-08-25_12h23m_Subject 47228.txt","47228",2019-08-25,"12:23",83,60,10,13,23,71,8,11,90,70,16,17,103,583,103,167,853
"./Ship3_Latin-square/2019-08-25_12h23m_Subject 47243.txt","47243",2019-08-25,"12:23",33,24,8,1,9,48,13,21,82,142,71,4,217,264,65,0,329
"./Ship3_Latin-square/2019-08-25_12h23m_Subject 47249.txt","47249",2019-08-25,"12:23",81,60,6,15,21,104,12,15,131,162,29,83,274,540,55,152,747
"./Ship3_Latin-square/2019-08-25_12h23m_Subject 47639.txt","47639",2019-08-25,"12:23",76,60,7,9,16,41,5,10,56,41,11,20,72,829,81,142,1052
"./Ship3_Latin-square/2019-08-25_12h23m_Subject 47758.txt","47758",2019-08-25,"12:23",84,60,11,13,24,54,12,18,84,66,15,31,112,569,83,166,818
"./Ship3_Latin-square/2019-08-25_12h23m_Subject 47759.txt","47759",2019-08-25,"12:23",84,60,7,17,24,38,17,5,60,72,42,24,138,453,54,192,699
"./Ship3_Latin-square/2019-08-25_12h23m_Subject 47776.txt","47776",2019-08-25,"12:23",81,60,6,15,21,36,1,9,46,76,16,32,124,794,71,264,1129
"./Ship3_Latin-square/2019-08-25_12h23m_Subject 47799.txt","47799",2019-08-25,"12:23",82,59,4,19,23,62,6,15,83,137,4,121,262,424,40,150,614
"./Ship3_Latin-square/2019-08-25_13h05m_Subject 46888.txt","46888",2019-08-25,"13:05",77,60,4,13,17,88,6,22,116,113,15,44,172,984,60,237,1281
"./Ship3_Latin-square/2019-08-25_13h05m_Subject 46892.txt","46892",2019-08-25,"13:05",83,60,9,14,23,49,5,14,68,70,28,20,118,736,117,167,1020
"./Ship3_Latin-square/2019-08-25_13h05m_Subject 47099.txt","47099",2019-08-25,"13:05",80,60,10,10,20,33,0,4,37,120,89,14,223,829,147,142,1118
"./Ship3_Latin-square/2019-08-25_13h37m_Subject 46893.txt","46893",2019-08-25,"13:37",79,60,8,11,19,38,4,14,56,51,12,29,92,863,99,171,1133
"./Ship3_Latin-square/2019-08-25_13h37m_Subject 47638.txt","47638",2019-08-25,"13:37",79,59,12,8,20,83,26,11,120,45,14,46,105,480,89,43,612
"./Ship3_Latin-square/2019-08-25_13h37m_Subject 47757.txt","47757",2019-08-25,"13:37",70,52,8,10,18,109,19,27,155,108,32,29,169,370,67,89,526
"./Ship3_Latin-square/2019-08-25_13h37m_Subject 47769.txt","47769",2019-08-25,"13:37",81,60,13,8,21,62,10,12,84,67,29,15,111,810,130,105,1045
"./Ship3_Latin-square/2019-08-25_13h37m_Subject 47771.txt","47771",2019-08-25,"13:37",83,60,10,13,23,107,43,15,165,65,23,48,136,517,76,154,747
"./Ship3_Latin-square/2019-08-25_13h37m_Subject 47775.txt","47775",2019-08-25,"13:37",85,59,8,18,26,96,22,13,131,88,69,43,200,652,72,242,966
"./Ship3_Latin-square/2019-08-25_13h37m_Subject 47782.txt","47782",2019-08-25,"13:37",83,60,5,18,23,56,3,10,69,22,1,42,65,573,45,155,773
"./Ship3_Latin-square/2019-08-25_13h37m_Subject 47788.txt","47788",2019-08-25,"13:37",77,60,2,15,17,50,1,11,62,96,2,25,123,486,16,121,623
"./Ship3_Latin-square/2019-08-25_14h12m_Subject 47080.txt","47080",2019-08-25,"14:12",82,60,9,13,22,24,3,4,31,47,7,8,62,565,67,149,781
"./Ship3_Latin-square/2019-08-25_14h12m_Subject 47089.txt","47089",2019-08-25,"14:12",57,42,11,4,15,112,44,4,160,97,64,52,213,280,61,13,354
"./Ship3_Latin-square/2019-08-26_10h07m_Subject 47238.txt","47238",2019-08-26,"10:07",78,56,10,12,22,106,35,23,164,78,19,71,168,472,79,128,679
"./Ship3_Latin-square/2019-08-26_10h07m_Subject 47242.txt","47242",2019-08-26,"10:07",56,42,12,2,14,281,66,2,349,48,20,2,70,456,91,28,575
"./Ship3_Latin-square/2019-08-26_10h07m_Subject 47767.txt","47767",2019-08-26,"10:07",7,5,2,0,2,125,6,0,131,87,12,0,99,16,8,0,24
"./Ship3_Latin-square/2019-08-26_11h19m_Subject 47229.txt","47229",2019-08-26,"11:19",86,60,14,12,26,95,9,15,119,70,34,22,126,650,144,118,912
"./Ship3_Latin-square/2019-08-26_11h19m_Subject 47777.txt","47777",2019-08-26,"11:19",76,57,8,11,19,131,24,19,174,54,11,7,72,355,51,81,487
"./Ship3_Latin-square/2019-08-26_11h24m_Subject 47076.txt","47076",2019-08-26,"11:24",85,60,11,14,25,101,47,41,189,83,38,80,201,668,99,205,972
"./Ship3_Latin-square/2019-08-26_11h24m_Subject 47082.txt","47082",2019-08-26,"11:24",70,52,12,6,18,147,52,27,226,57,53,6,116,527,96,81,704
"./Ship3_Latin-square/2019-08-26_11h24m_Subject 47226.txt","47226",2019-08-26,"11:24",80,56,12,12,24,143,24,30,197,59,5,16,80,442,76,124,642
"./Ship3_Latin-square/2019-08-26_11h24m_Subject 47227.txt","47227",2019-08-26,"11:24",81,60,9,12,21,127,60,17,204,53,20,99,172,510,76,147,733
"./Ship3_Latin-square/2019-08-26_11h24m_Subject 47250.txt","47250",2019-08-26,"11:24",84,60,13,11,24,55,9,10,74,45,24,33,102,619,98,130,847
"./Ship3_Latin-square/2019-08-26_11h24m_Subject 47646.txt","47646",2019-08-26,"11:24",81,60,5,16,21,103,10,22,135,56,8,23,87,584,34,257,875
"./Ship3_Latin-square/2019-08-26_11h24m_Subject 47795.txt","47795",2019-08-26,"11:24",81,60,9,12,21,128,12,19,159,94,23,17,134,574,79,137,790
"./Ship3_Latin-square/2019-08-26_12h26m_Subject 46881.txt","46881",2019-08-26,"12:26",56,41,9,6,15,146,42,21,209,49,17,75,141,220,41,61,322
"./Ship3_Latin-square/2019-08-26_12h26m_Subject 47087.txt","47087",2019-08-26,"12:26",36,28,5,3,8,275,25,4,304,45,6,9,60,208,46,21,275
"./Ship3_Latin-square/2019-08-26_12h26m_Subject 47634.txt","47634",2019-08-26,"12:26",60,41,10,9,19,105,49,23,177,39,28,33,100,220,51,63,334
"./Ship3_Latin-square/2019-08-26_12h26m_Subject 47640.txt","47640",2019-08-26,"12:26",56,41,8,7,15,107,10,12,129,60,52,5,117,279,60,51,390
"./Ship3_Latin-square/2019-08-26_12h26m_Subject 47754.txt","47754",2019-08-26,"12:26",36,28,7,1,8,117,9,0,126,49,19,4,72,179,38,6,223
"./Ship3_Latin-square/2019-08-26_12h26m_Subject 47800.txt","47800",2019-08-26,"12:26",77,60,9,8,17,111,22,14,147,92,23,16,131,437,62,59,558
"./Ship3_Latin-square/2019-08-26_12h35m_Subject 46882.txt","46882",2019-08-26,"12:35",71,52,9,10,19,156,11,18,185,54,48,38,140,399,69,140,608
"./Ship3_Latin-square/2019-08-26_12h35m_Subject 46894.txt","46894",2019-08-26,"12:35",80,60,4,16,20,41,1,7,49,90,6,10,106,568,43,161,772
"./Ship3_Latin-square/2019-08-26_12h35m_Subject 47088.txt","47088",2019-08-26,"12:35",84,60,14,10,24,94,15,12,121,76,27,22,125,384,63,114,561
"./Ship3_Latin-square/2019-08-26_12h35m_Subject 47228.txt","47228",2019-08-26,"12:35",82,60,8,14,22,73,5,9,87,93,6,13,112,767,89,161,1017
"./Ship3_Latin-square/2019-08-26_12h35m_Subject 47243.txt","47243",2019-08-26,"12:35",79,60,7,12,19,90,13,16,119,82,20,52,154,844,83,185,1112
"./Ship3_Latin-square/2019-08-26_12h35m_Subject 47249.txt","47249",2019-08-26,"12:35",80,60,11,9,20,92,23,12,127,102,41,21,164,346,40,71,457
"./Ship3_Latin-square/2019-08-26_12h35m_Subject 47639.txt","47639",2019-08-26,"12:35",80,60,8,12,20,26,4,5,35,50,13,16,79,838,101,177,1116
"./Ship3_Latin-square/2019-08-26_12h35m_Subject 47758.txt","47758",2019-08-26,"12:35",85,60,13,12,25,46,12,12,70,34,24,15,73,507,59,148,714
"./Ship3_Latin-square/2019-08-26_12h35m_Subject 47759.txt","47759",2019-08-26,"12:35",69,51,8,10,18,89,8,18,115,57,8,13,78,238,25,64,327
"./Ship3_Latin-square/2019-08-26_12h35m_Subject 47776.txt","47776",2019-08-26,"12:35",81,60,8,13,21,48,4,6,58,108,28,22,158,864,110,210,1184
"./Ship3_Latin-square/2019-08-26_12h35m_Subject 47799.txt","47799",2019-08-26,"12:35",79,59,9,11,20,93,5,17,115,128,84,26,238,268,27,81,376
"./Ship3_Latin-square/2019-08-26_13h44m_Subject 46888.txt","46888",2019-08-26,"13:44",84,60,12,12,24,33,7,5,45,159,30,44,233,811,131,215,1157
"./Ship3_Latin-square/2019-08-26_13h44m_Subject 46892.txt","46892",2019-08-26,"13:44",86,60,12,14,26,82,16,14,112,46,6,8,60,432,46,134,612
"./Ship3_Latin-square/2019-08-26_13h44m_Subject 47097.txt","47097",2019-08-26,"13:44",79,60,10,9,19,77,17,10,104,95,16,26,137,526,76,62,664
"./Ship3_Latin-square/2019-08-26_13h44m_Subject 47099.txt","47099",2019-08-26,"13:44",84,60,14,10,24,101,3,31,135,104,50,10,164,553,100,76,729
"./Ship3_Latin-square/2019-08-26_13h48m_Subject 46893.txt","46893",2019-08-26,"13:48",82,60,11,11,22,32,9,6,47,45,10,14,69,1150,192,228,1570
"./Ship3_Latin-square/2019-08-26_13h48m_Subject 47638.txt","47638",2019-08-26,"13:48",74,56,11,7,18,129,28,9,166,91,28,74,193,425,101,55,581
"./Ship3_Latin-square/2019-08-26_13h48m_Subject 47757.txt","47757",2019-08-26,"13:48",70,53,9,8,17,118,26,30,174,78,13,13,104,357,50,51,458
"./Ship3_Latin-square/2019-08-26_13h48m_Subject 47769.txt","47769",2019-08-26,"13:48",83,60,10,13,23,47,1,8,56,71,24,32,127,1026,126,282,1434
"./Ship3_Latin-square/2019-08-26_13h48m_Subject 47771.txt","47771",2019-08-26,"13:48",79,60,10,9,19,55,6,10,71,47,17,21,85,572,87,127,786
"./Ship3_Latin-square/2019-08-26_13h48m_Subject 47775.txt","47775",2019-08-26,"13:48",85,60,11,14,25,60,11,10,81,46,11,10,67,544,85,141,770
"./Ship3_Latin-square/2019-08-26_13h48m_Subject 47781.txt","47781",2019-08-26,"13:48",80,60,8,12,20,87,5,8,100,160,21,68,249,841,96,201,1138
"./Ship3_Latin-square/2019-08-26_13h48m_Subject 47782.txt","47782",2019-08-26,"13:48",78,60,12,6,18,49,10,4,63,21,7,5,33,548,45,92,685
"./Ship3_Latin-square/2019-08-26_13h48m_Subject 47783.txt","47783",2019-08-26,"13:48",73,53,11,9,20,164,33,26,223,62,5,21,88,468,37,115,620
"./Ship3_Latin-square/2019-08-26_13h48m_Subject 47785.txt","47785",2019-08-26,"13:48",85,60,12,13,25,63,4,17,84,36,24,28,88,806,150,164,1120
"./Ship3_Latin-square/2019-08-26_13h48m_Subject 47788.txt","47788",2019-08-26,"13:48",79,60,7,12,19,69,6,17,92,87,11,28,126,322,19,83,424
"./Ship3_Latin-square/2019-08-26_15h05m_Subject 47080.txt","47080",2019-08-26,"15:05",77,60,8,9,17,31,3,7,41,35,5,10,50,580,94,77,751
"./Ship3_Latin-square/2019-08-26_15h05m_Subject 47089.txt","47089",2019-08-26,"15:05",60,42,5,13,18,85,16,26,127,109,9,25,143,232,19,77,328
"./Ship3_Latin-square/2019-08-27_10h00m_Subject 47238.txt","47238",2019-08-27,"10:00",82,60,10,12,22,39,4,8,51,70,5,42,117,520,90,123,733
"./Ship3_Latin-square/2019-08-27_10h00m_Subject 47242.txt","47242",2019-08-27,"10:00",83,60,10,13,23,184,28,17,229,102,29,77,208,621,99,160,880
"./Ship3_Latin-square/2019-08-27_10h00m_Subject 47767.txt","47767",2019-08-27,"10:00",77,60,9,8,17,80,18,5,103,25,30,4,59,434,51,76,561
"./Ship3_Latin-square/2019-08-27_10h03m_Subject 46884.txt","46884",2019-08-27,"10:03",58,44,9,5,14,94,16,37,147,83,45,5,133,184,66,17,267
"./Ship3_Latin-square/2019-08-27_10h03m_Subject 47246.txt","47246",2019-08-27,"10:03",82,60,5,17,22,68,19,8,95,72,22,39,133,642,32,193,867
"./Ship3_Latin-square/2019-08-27_11h13m_Subject 46900.txt","46900",2019-08-27,"11:13",77,59,9,9,18,78,31,15,124,290,160,109,559,543,64,135,742
"./Ship3_Latin-square/2019-08-27_11h13m_Subject 47076.txt","47076",2019-08-27,"11:13",83,60,14,9,23,47,12,6,65,67,22,22,111,541,102,96,739
"./Ship3_Latin-square/2019-08-27_11h13m_Subject 47082.txt","47082",2019-08-27,"11:13",81,60,9,12,21,104,11,6,121,35,12,22,69,449,51,105,605
"./Ship3_Latin-square/2019-08-27_11h13m_Subject 47226.txt","47226",2019-08-27,"11:13",86,60,11,15,26,100,21,11,132,46,15,26,87,374,47,138,559
"./Ship3_Latin-square/2019-08-27_11h13m_Subject 47227.txt","47227",2019-08-27,"11:13",82,60,10,12,22,50,8,8,66,23,14,22,59,573,93,136,802
"./Ship3_Latin-square/2019-08-27_11h13m_Subject 47250.txt","47250",2019-08-27,"11:13",78,60,10,8,18,55,3,4,62,39,10,15,64,612,96,92,800
"./Ship3_Latin-square/2019-08-27_11h13m_Subject 47646.txt","47646",2019-08-27,"11:13",84,59,11,14,25,65,9,9,83,65,22,25,112,550,84,160,794
"./Ship3_Latin-square/2019-08-27_11h13m_Subject 47795.txt","47795",2019-08-27,"11:13",86,60,11,15,26,89,11,8,108,55,13,36,104,430,61,195,686
"./Ship3_Latin-square/2019-08-27_11h17m_Subject 47229.txt","47229",2019-08-27,"11:17",82,60,8,14,22,43,5,3,51,119,19,22,160,881,152,188,1221
"./Ship3_Latin-square/2019-08-27_11h17m_Subject 47233.txt","47233",2019-08-27,"11:17",80,60,8,12,20,52,9,7,68,84,21,17,122,529,59,158,746
"./Ship3_Latin-square/2019-08-27_11h17m_Subject 47777.txt","47777",2019-08-27,"11:17",82,60,10,12,22,87,15,13,115,27,2,2,31,471,64,87,622
"./Ship3_Latin-square/2019-08-27_12h30m_Subject 46880.txt","46880",2019-08-27,"12:30",51,37,11,3,14,187,35,9,231,48,77,9,134,252,92,13,357
"./Ship3_Latin-square/2019-08-27_12h30m_Subject 46882.txt","46882",2019-08-27,"12:30",83,60,10,13,23,41,4,9,54,110,19,66,195,758,94,196,1048
"./Ship3_Latin-square/2019-08-27_12h30m_Subject 46894.txt","46894",2019-08-27,"12:30",81,60,10,11,21,71,8,14,93,49,10,2,61,424,44,100,568
"./Ship3_Latin-square/2019-08-27_12h30m_Subject 47088.txt","47088",2019-08-27,"12:30",84,60,9,15,24,70,9,7,86,78,22,43,143,735,110,163,1008
"./Ship3_Latin-square/2019-08-27_12h30m_Subject 47228.txt","47228",2019-08-27,"12:30",81,60,11,10,21,80,10,8,98,43,9,7,59,407,49,82,538
"./Ship3_Latin-square/2019-08-27_12h30m_Subject 47243.txt","47243",2019-08-27,"12:30",82,58,16,8,24,108,25,9,142,185,56,23,264,537,79,107,723
"./Ship3_Latin-square/2019-08-27_12h30m_Subject 47249.txt","47249",2019-08-27,"12:30",79,60,6,13,19,93,6,11,110,93,26,26,145,495,50,138,683
"./Ship3_Latin-square/2019-08-27_12h30m_Subject 47639.txt","47639",2019-08-27,"12:30",81,60,14,7,21,49,5,6,60,39,21,19,79,457,54,76,587
"./Ship3_Latin-square/2019-08-27_12h30m_Subject 47758.txt","47758",2019-08-27,"12:30",83,60,10,13,23,64,8,7,79,34,5,23,62,1103,202,255,1560
"./Ship3_Latin-square/2019-08-27_12h30m_Subject 47759.txt","47759",2019-08-27,"12:30",84,60,3,21,24,45,6,7,58,108,8,39,155,500,15,221,736
"./Ship3_Latin-square/2019-08-27_12h30m_Subject 47776.txt","47776",2019-08-27,"12:30",82,60,11,11,22,38,2,4,44,100,37,29,166,577,51,158,786
"./Ship3_Latin-square/2019-08-27_12h30m_Subject 47799.txt","47799",2019-08-27,"12:30",82,60,6,16,22,107,10,51,168,101,10,45,156,553,60,137,750
"./Ship3_Latin-square/2019-08-27_12h33m_Subject 46881.txt","46881",2019-08-27,"12:33",74,53,10,11,21,84,20,35,139,155,28,49,232,320,43,71,434
"./Ship3_Latin-square/2019-08-27_12h33m_Subject 47087.txt","47087",2019-08-27,"12:33",51,35,10,6,16,148,21,33,202,61,41,9,111,288,72,70,430
"./Ship3_Latin-square/2019-08-27_12h33m_Subject 47626.txt","47626",2019-08-27,"12:33",59,42,12,5,17,114,10,6,130,49,47,10,106,353,77,41,471
"./Ship3_Latin-square/2019-08-27_12h33m_Subject 47634.txt","47634",2019-08-27,"12:33",78,54,11,13,24,119,27,27,173,20,18,18,56,317,61,113,491
"./Ship3_Latin-square/2019-08-27_12h33m_Subject 47640.txt","47640",2019-08-27,"12:33",52,38,6,8,14,67,13,14,94,79,12,74,165,198,44,46,288
"./Ship3_Latin-square/2019-08-27_12h33m_Subject 47754.txt","47754",2019-08-27,"12:33",40,28,9,3,12,67,27,7,101,57,34,1,92,122,35,13,170
"./Ship3_Latin-square/2019-08-27_12h33m_Subject 47800.txt","47800",2019-08-27,"12:33",81,60,9,12,21,78,6,13,97,109,28,37,174,485,61,91,637
"./Ship3_Latin-square/2019-08-27_13h39m_Subject 46876.txt","46876",2019-08-27,"13:39",57,43,10,4,14,155,43,28,226,12,17,0,29,210,51,22,283
"./Ship3_Latin-square/2019-08-27_13h39m_Subject 46888.txt","46888",2019-08-27,"13:39",84,60,7,17,24,30,7,8,45,116,13,74,203,999,141,296,1436
"./Ship3_Latin-square/2019-08-27_13h39m_Subject 46892.txt","46892",2019-08-27,"13:39",80,60,2,18,20,51,0,9,60,24,3,6,33,939,34,253,1226
"./Ship3_Latin-square/2019-08-27_13h39m_Subject 46893.txt","46893",2019-08-27,"13:39",80,60,9,11,20,47,1,5,53,68,7,28,103,776,74,191,1041
"./Ship3_Latin-square/2019-08-27_13h39m_Subject 47097.txt","47097",2019-08-27,"13:39",77,60,7,10,17,32,3,10,45,108,11,13,132,588,74,109,771
"./Ship3_Latin-square/2019-08-27_13h39m_Subject 47099.txt","47099",2019-08-27,"13:39",87,60,7,20,27,28,6,19,53,83,58,55,196,1014,90,363,1467
"./Ship3_Latin-square/2019-08-27_13h39m_Subject 47638.txt","47638",2019-08-27,"13:39",77,56,10,11,21,90,9,17,116,49,20,19,88,215,32,34,281
"./Ship3_Latin-square/2019-08-27_13h39m_Subject 47757.txt","47757",2019-08-27,"13:39",73,56,5,12,17,134,7,31,172,106,10,31,147,401,40,110,551
"./Ship3_Latin-square/2019-08-27_13h39m_Subject 47769.txt","47769",2019-08-27,"13:39",84,60,14,10,24,55,10,14,79,49,16,21,86,546,63,121,730
"./Ship3_Latin-square/2019-08-27_13h39m_Subject 47771.txt","47771",2019-08-27,"13:39",81,60,9,12,21,45,10,5,60,25,19,22,66,632,95,160,887
"./Ship3_Latin-square/2019-08-27_13h39m_Subject 47775.txt","47775",2019-08-27,"13:39",82,60,8,14,22,57,5,10,72,17,5,7,29,562,85,113,760
"./Ship3_Latin-square/2019-08-27_13h39m_Subject 47781.txt","47781",2019-08-27,"13:39",80,60,8,12,20,73,8,7,88,63,13,23,99,587,40,207,834
"./Ship3_Latin-square/2019-08-27_13h39m_Subject 47782.txt","47782",2019-08-27,"13:39",79,60,8,11,19,16,6,7,29,23,1,19,43,903,124,139,1166
"./Ship3_Latin-square/2019-08-27_13h39m_Subject 47783.txt","47783",2019-08-27,"13:39",78,60,8,10,18,76,12,6,94,72,4,13,89,536,76,123,735
"./Ship3_Latin-square/2019-08-27_13h39m_Subject 47785.txt","47785",2019-08-27,"13:39",82,60,8,14,22,40,7,8,55,39,12,39,90,714,85,175,974
"./Ship3_Latin-square/2019-08-27_13h39m_Subject 47788.txt","47788",2019-08-27,"13:39",79,60,6,13,19,67,3,15,85,95,13,28,136,546,78,90,714
"./Ship3_Latin-square/2019-08-27_15h01m_Subject 47080.txt","47080",2019-08-27,"15:01",86,60,12,14,26,50,7,13,70,31,10,11,52,493,37,189,719
"./Ship3_Latin-square/2019-08-27_15h01m_Subject 47089.txt","47089",2019-08-27,"15:01",51,38,10,3,13,136,25,2,163,181,45,6,232,201,37,31,269
"./Ship3_Latin-square/2019-08-27_15h01m_Subject 47791.txt","47791",2019-08-27,"15:01",73,50,9,14,23,71,33,44,148,58,63,43,164,297,52,109,458
"./Ship3_Latin-square/2019-08-28_10h03m_Subject 46885.txt","46885",2019-08-28,"10:03",78,55,9,14,23,180,23,32,235,62,4,42,108,491,74,97,662
"./Ship3_Latin-square/2019-08-28_10h03m_Subject 47238.txt","47238",2019-08-28,"10:03",77,60,7,10,17,41,7,4,52,88,14,27,129,727,92,95,914
"./Ship3_Latin-square/2019-08-28_10h03m_Subject 47242.txt","47242",2019-08-28,"10:03",78,60,5,13,18,57,2,8,67,131,16,65,212,611,51,123,785
"./Ship3_Latin-square/2019-08-28_10h03m_Subject 47244.txt","47244",2019-08-28,"10:03",67,48,11,8,19,197,60,28,285,107,55,121,283,396,86,92,574
"./Ship3_Latin-square/2019-08-28_10h03m_Subject 47767.txt","47767",2019-08-28,"10:03",80,60,7,13,20,61,7,14,82,19,9,7,35,492,56,115,663
"./Ship3_Latin-square/2019-08-28_10h07m_Subject 46884.txt","46884",2019-08-28,"10:07",55,40,6,9,15,88,11,25,124,44,12,28,84,185,30,47,262
"./Ship3_Latin-square/2019-08-28_10h07m_Subject 47083.txt","47083",2019-08-28,"10:07",60,42,10,8,18,146,20,21,187,48,16,12,76,279,53,61,393
"./Ship3_Latin-square/2019-08-28_10h07m_Subject 47246.txt","47246",2019-08-28,"10:07",83,60,7,16,23,57,10,11,78,63,14,23,100,515,56,171,742
"./Ship3_Latin-square/2019-08-28_11h18m_Subject 46900.txt","46900",2019-08-28,"11:18",83,60,11,12,23,51,10,8,69,73,54,48,175,574,66,175,815
"./Ship3_Latin-square/2019-08-28_11h18m_Subject 47076.txt","47076",2019-08-28,"11:18",86,60,13,13,26,41,4,8,53,32,18,29,79,852,180,257,1289
"./Ship3_Latin-square/2019-08-28_11h18m_Subject 47079.txt","47079",2019-08-28,"11:18",79,59,13,7,20,77,11,9,97,112,21,10,143,419,104,54,577
"./Ship3_Latin-square/2019-08-28_11h18m_Subject 47082.txt","47082",2019-08-28,"11:18",66,48,9,9,18,90,11,11,112,60,20,49,129,237,64,33,334
"./Ship3_Latin-square/2019-08-28_11h18m_Subject 47092.txt","47092",2019-08-28,"11:18",80,60,8,12,20,37,4,5,46,109,18,23,150,711,98,178,987
"./Ship3_Latin-square/2019-08-28_11h18m_Subject 47226.txt","47226",2019-08-28,"11:18",79,60,8,11,19,86,7,20,113,47,7,23,77,488,94,117,699
"./Ship3_Latin-square/2019-08-28_11h18m_Subject 47227.txt","47227",2019-08-28,"11:18",79,60,9,10,19,65,6,4,75,25,29,11,65,590,82,135,807
"./Ship3_Latin-square/2019-08-28_11h18m_Subject 47250.txt","47250",2019-08-28,"11:18",82,60,12,10,22,61,14,6,81,45,21,21,87,516,53,107,676
"./Ship3_Latin-square/2019-08-28_11h18m_Subject 47646.txt","47646",2019-08-28,"11:18",77,60,10,7,17,85,5,5,95,62,26,2,90,877,89,136,1102
"./Ship3_Latin-square/2019-08-28_11h18m_Subject 47760.txt","47760",2019-08-28,"11:18",72,53,10,9,19,123,9,25,157,80,45,25,150,456,86,78,620
"./Ship3_Latin-square/2019-08-28_11h18m_Subject 47795.txt","47795",2019-08-28,"11:18",81,60,10,11,21,95,22,13,130,70,16,12,98,547,115,82,744
"./Ship3_Latin-square/2019-08-28_11h22m_Subject 47229.txt","47229",2019-08-28,"11:22",78,60,6,12,18,60,4,14,78,99,8,24,131,596,34,208,838
"./Ship3_Latin-square/2019-08-28_11h22m_Subject 47233.txt","47233",2019-08-28,"11:22",86,60,12,14,26,40,15,15,70,113,42,26,181,672,118,169,959
"./Ship3_Latin-square/2019-08-28_11h22m_Subject 47247.txt","47247",2019-08-28,"11:22",80,60,7,13,20,58,11,11,80,99,11,11,121,401,49,73,523
"./Ship3_Latin-square/2019-08-28_11h22m_Subject 47777.txt","47777",2019-08-28,"11:22",80,60,9,11,20,71,8,16,95,11,5,8,24,490,77,109,676
"./Ship3_Latin-square/2019-08-28_11h22m_Subject 47784.txt","47784",2019-08-28,"11:22",86,60,6,20,26,149,10,10,169,64,7,53,124,1011,87,383,1481
"./Ship3_Latin-square/2019-08-28_12h36m_Subject 46880.txt","46880",2019-08-28,"12:36",84,60,10,14,24,64,6,10,80,36,5,17,58,344,48,84,476
"./Ship3_Latin-square/2019-08-28_12h36m_Subject 46882.txt","46882",2019-08-28,"12:36",79,60,8,11,19,49,4,2,55,85,10,38,133,836,105,216,1157
"./Ship3_Latin-square/2019-08-28_12h36m_Subject 46894.txt","46894",2019-08-28,"12:36",80,60,3,17,20,65,2,12,79,25,0,15,40,742,68,169,979
"./Ship3_Latin-square/2019-08-28_12h36m_Subject 47088.txt","47088",2019-08-28,"12:36",79,60,12,7,19,123,23,19,165,105,23,15,143,268,15,57,340
"./Ship3_Latin-square/2019-08-28_12h36m_Subject 47228.txt","47228",2019-08-28,"12:36",79,60,7,12,19,51,4,5,60,65,2,20,87,550,69,106,725
"./Ship3_Latin-square/2019-08-28_12h36m_Subject 47243.txt","47243",2019-08-28,"12:36",82,60,6,16,22,147,11,9,167,97,40,27,164,839,89,299,1227
"./Ship3_Latin-square/2019-08-28_12h36m_Subject 47249.txt","47249",2019-08-28,"12:36",76,54,14,8,22,81,19,11,111,87,38,17,142,189,15,41,245
"./Ship3_Latin-square/2019-08-28_12h36m_Subject 47639.txt","47639",2019-08-28,"12:36",82,60,9,13,22,35,9,8,52,32,7,37,76,783,114,178,1075
"./Ship3_Latin-square/2019-08-28_12h36m_Subject 47758.txt","47758",2019-08-28,"12:36",81,60,15,6,21,133,14,19,166,30,11,4,45,396,6,58,460
"./Ship3_Latin-square/2019-08-28_12h36m_Subject 47759.txt","47759",2019-08-28,"12:36",80,60,11,9,20,55,15,8,78,55,17,16,88,251,8,63,322
"./Ship3_Latin-square/2019-08-28_12h36m_Subject 47776.txt","47776",2019-08-28,"12:36",82,60,5,17,22,32,2,11,45,78,16,60,154,964,101,222,1287
"./Ship3_Latin-square/2019-08-28_12h36m_Subject 47799.txt","47799",2019-08-28,"12:36",76,56,10,10,20,142,12,25,179,191,94,39,324,245,3,67,315
"./Ship3_Latin-square/2019-08-28_12h40m_Subject 46881.txt","46881",2019-08-28,"12:40",79,56,7,16,23,117,10,15,142,175,31,50,256,425,54,142,621
"./Ship3_Latin-square/2019-08-28_12h40m_Subject 47087.txt","47087",2019-08-28,"12:40",66,49,6,11,17,133,5,41,179,115,6,15,136,350,47,79,476
"./Ship3_Latin-square/2019-08-28_12h40m_Subject 47626.txt","47626",2019-08-28,"12:40",82,60,9,13,22,102,13,13,128,116,21,34,171,376,42,73,491
"./Ship3_Latin-square/2019-08-28_12h40m_Subject 47634.txt","47634",2019-08-28,"12:40",83,60,12,11,23,95,21,20,136,37,16,18,71,468,80,109,657
"./Ship3_Latin-square/2019-08-28_12h40m_Subject 47640.txt","47640",2019-08-28,"12:40",79,60,9,10,19,103,9,19,131,61,10,33,104,805,117,127,1049
"./Ship3_Latin-square/2019-08-28_12h40m_Subject 47754.txt","47754",2019-08-28,"12:40",57,40,7,10,17,93,25,11,129,40,29,62,131,253,41,87,381
"./Ship3_Latin-square/2019-08-28_12h40m_Subject 47800.txt","47800",2019-08-28,"12:40",82,60,5,17,22,102,10,32,144,83,9,45,137,298,19,147,464
"./Ship3_Latin-square/2019-08-28_13h47m_Subject 46876.txt","46876",2019-08-28,"13:47",80,58,10,12,22,92,27,19,138,40,10,63,113,293,35,106,434
"./Ship3_Latin-square/2019-08-28_13h47m_Subject 46893.txt","46893",2019-08-28,"13:47",81,60,9,12,21,46,10,3,59,51,6,13,70,1057,159,263,1479
"./Ship3_Latin-square/2019-08-28_13h47m_Subject 47638.txt","47638",2019-08-28,"13:47",74,54,11,9,20,126,18,16,160,53,20,70,143,401,71,43,515
"./Ship3_Latin-square/2019-08-28_13h47m_Subject 47757.txt","47757",2019-08-28,"13:47",67,50,10,7,17,130,30,14,174,67,20,13,100,221,11,63,295
"./Ship3_Latin-square/2019-08-28_13h47m_Subject 47769.txt","47769",2019-08-28,"13:47",83,60,14,9,23,46,13,10,69,26,19,52,97,970,262,152,1384
"./Ship3_Latin-square/2019-08-28_13h47m_Subject 47771.txt","47771",2019-08-28,"13:47",79,60,12,7,19,40,2,4,46,16,18,0,34,568,56,110,734
"./Ship3_Latin-square/2019-08-28_13h47m_Subject 47775.txt","47775",2019-08-28,"13:47",85,60,12,13,25,94,8,12,114,48,19,11,78,321,39,126,486
"./Ship3_Latin-square/2019-08-28_13h47m_Subject 47781.txt","47781",2019-08-28,"13:47",78,60,7,11,18,57,8,9,74,95,20,14,129,913,90,179,1182
"./Ship3_Latin-square/2019-08-28_13h47m_Subject 47782.txt","47782",2019-08-28,"13:47",81,60,11,10,21,55,3,15,73,25,59,8,92,413,7,115,535
"./Ship3_Latin-square/2019-08-28_13h47m_Subject 47783.txt","47783",2019-08-28,"13:47",79,60,9,10,19,65,10,10,85,54,12,10,76,633,101,134,868
"./Ship3_Latin-square/2019-08-28_13h47m_Subject 47785.txt","47785",2019-08-28,"13:47",84,60,13,11,24,29,1,7,37,40,19,24,83,864,190,138,1192
"./Ship3_Latin-square/2019-08-28_13h47m_Subject 47788.txt","47788",2019-08-28,"13:47",77,60,9,8,17,140,14,27,181,93,18,13,124,222,2,44,268
"./Ship3_Latin-square/2019-08-28_13h50m_Subject 46888.txt","46888",2019-08-28,"13:50",83,60,12,11,23,46,3,11,60,129,28,64,221,753,85,214,1052
"./Ship3_Latin-square/2019-08-28_13h50m_Subject 46889.txt","46889",2019-08-28,"13:50",83,60,8,15,23,96,12,10,118,46,13,15,74,870,138,213,1221
"./Ship3_Latin-square/2019-08-28_13h50m_Subject 46892.txt","46892",2019-08-28,"13:50",88,60,16,12,28,79,20,17,116,40,26,37,103,429,17,142,588
"./Ship3_Latin-square/2019-08-28_13h50m_Subject 47097.txt","47097",2019-08-28,"13:50",74,60,8,6,14,58,2,5,65,85,17,8,110,753,70,95,918
"./Ship3_Latin-square/2019-08-28_13h50m_Subject 47099.txt","47099",2019-08-28,"13:50",78,56,15,7,22,233,12,55,300,106,30,10,146,555,21,60,636
"./Ship3_Latin-square/2019-08-28_15h01m_Subject 47080.txt","47080",2019-08-28,"15:01",79,60,7,12,19,43,4,14,61,48,7,7,62,629,75,109,813
"./Ship3_Latin-square/2019-08-28_15h01m_Subject 47089.txt","47089",2019-08-28,"15:01",62,47,12,3,15,83,25,5,113,54,25,4,83,243,27,11,281
"./Ship3_Latin-square/2019-08-28_15h01m_Subject 47791.txt","47791",2019-08-28,"15:01",82,60,11,11,22,61,22,10,93,66,18,28,112,591,84,119,794
"./Ship3_Latin-square/2019-08-29_10h12m_Subject 46885.txt","46885",2019-08-29,"10:12",83,60,11,12,23,87,10,17,114,33,12,20,65,394,61,91,546
"./Ship3_Latin-square/2019-08-29_10h12m_Subject 46899.txt","46899",2019-08-29,"10:12",67,51,13,3,16,121,20,42,183,40,28,4,72,534,97,40,671
"./Ship3_Latin-square/2019-08-29_10h12m_Subject 47091.txt","47091",2019-08-29,"10:12",68,54,7,7,14,122,13,10,145,76,18,19,113,260,40,45,345
"./Ship3_Latin-square/2019-08-29_10h12m_Subject 47231.txt","47231",2019-08-29,"10:12",69,51,13,5,18,103,30,10,143,37,26,11,74,225,41,38,304
"./Ship3_Latin-square/2019-08-29_10h12m_Subject 47238.txt","47238",2019-08-29,"10:12",78,60,14,4,18,40,7,8,55,84,19,2,105,462,59,29,550
"./Ship3_Latin-square/2019-08-29_10h12m_Subject 47242.txt","47242",2019-08-29,"10:12",84,60,10,14,24,40,8,7,55,83,15,37,135,491,50,183,724
"./Ship3_Latin-square/2019-08-29_10h12m_Subject 47244.txt","47244",2019-08-29,"10:12",82,60,7,15,22,78,7,10,95,107,23,31,161,675,62,210,947
"./Ship3_Latin-square/2019-08-29_10h12m_Subject 47752.txt","47752",2019-08-29,"10:12",82,60,11,11,22,113,23,7,143,48,33,43,124,659,76,225,960
"./Ship3_Latin-square/2019-08-29_10h12m_Subject 47767.txt","47767",2019-08-29,"10:12",80,60,10,10,20,58,5,9,72,29,21,5,55,335,52,106,493
"./Ship3_Latin-square/2019-08-29_10h15m_Subject 46884.txt","46884",2019-08-29,"10:15",81,60,8,13,21,76,21,10,107,84,16,27,127,395,40,77,512
"./Ship3_Latin-square/2019-08-29_10h15m_Subject 47083.txt","47083",2019-08-29,"10:15",79,58,8,13,21,99,11,17,127,65,13,18,96,488,51,155,694
"./Ship3_Latin-square/2019-08-29_10h15m_Subject 47246.txt","47246",2019-08-29,"10:15",81,60,7,14,21,83,11,16,110,81,16,20,117,650,89,140,879
"./Ship3_Latin-square/2019-08-29_11h23m_Subject 47229.txt","47229",2019-08-29,"11:23",76,60,7,9,16,31,4,1,36,90,13,9,112,883,97,122,1102
"./Ship3_Latin-square/2019-08-29_11h23m_Subject 47233.txt","47233",2019-08-29,"11:23",81,60,9,12,21,45,3,12,60,95,20,25,140,586,74,137,797
"./Ship3_Latin-square/2019-08-29_11h23m_Subject 47247.txt","47247",2019-08-29,"11:23",78,60,7,11,18,38,2,9,49,59,8,11,78,323,27,82,432
"./Ship3_Latin-square/2019-08-29_11h23m_Subject 47777.txt","47777",2019-08-29,"11:23",79,60,10,9,19,91,8,19,118,19,4,3,26,408,43,86,537
"./Ship3_Latin-square/2019-08-29_11h23m_Subject 47784.txt","47784",2019-08-29,"11:23",74,60,9,5,14,81,6,6,93,83,20,11,114,941,83,87,1111
"./Ship3_Latin-square/2019-08-29_11h32m_Subject 46900.txt","46900",2019-08-29,"11:32",79,60,9,10,19,48,10,7,65,62,17,15,94,794,116,146,1056
"./Ship3_Latin-square/2019-08-29_11h32m_Subject 47076.txt","47076",2019-08-29,"11:32",85,60,13,12,25,62,5,13,80,40,22,23,85,444,51,137,632
"./Ship3_Latin-square/2019-08-29_11h32m_Subject 47079.txt","47079",2019-08-29,"11:32",78,60,10,8,18,75,6,4,85,58,8,16,82,407,43,68,518
"./Ship3_Latin-square/2019-08-29_11h32m_Subject 47082.txt","47082",2019-08-29,"11:32",78,60,9,9,18,47,3,8,58,34,5,18,57,426,39,67,532
"./Ship3_Latin-square/2019-08-29_11h32m_Subject 47092.txt","47092",2019-08-29,"11:32",73,60,7,6,13,44,3,4,51,124,16,15,155,597,59,71,727
"./Ship3_Latin-square/2019-08-29_11h32m_Subject 47226.txt","47226",2019-08-29,"11:32",80,60,9,11,20,93,15,13,121,79,6,22,107,281,16,116,413
"./Ship3_Latin-square/2019-08-29_11h32m_Subject 47227.txt","47227",2019-08-29,"11:32",79,60,9,10,19,50,5,11,66,39,10,35,84,446,26,99,571
"./Ship3_Latin-square/2019-08-29_11h32m_Subject 47250.txt","47250",2019-08-29,"11:32",80,60,10,10,20,48,6,10,64,22,8,25,55,857,152,129,1138
"./Ship3_Latin-square/2019-08-29_11h32m_Subject 47646.txt","47646",2019-08-29,"11:32",79,60,10,9,19,63,8,7,78,66,11,8,85,472,39,128,639
"./Ship3_Latin-square/2019-08-29_11h32m_Subject 47755.txt","47755",2019-08-29,"11:32",77,60,6,11,17,97,8,13,118,100,31,13,144,600,55,121,776
"./Ship3_Latin-square/2019-08-29_11h32m_Subject 47760.txt","47760",2019-08-29,"11:32",84,60,10,14,24,96,14,14,124,57,14,26,97,578,74,168,820
"./Ship3_Latin-square/2019-08-29_11h32m_Subject 47795.txt","47795",2019-08-29,"11:32",81,60,12,9,21,75,13,14,102,72,14,11,97,370,46,60,476
"./Ship3_Latin-square/2019-08-29_12h42m_Subject 46880.txt","46880",2019-08-29,"12:42",83,60,8,15,23,63,3,7,73,60,21,36,117,577,70,144,791
"./Ship3_Latin-square/2019-08-29_12h42m_Subject 46882.txt","46882",2019-08-29,"12:42",81,60,8,13,21,43,1,10,54,69,9,37,115,370,21,124,515
"./Ship3_Latin-square/2019-08-29_12h42m_Subject 46894.txt","46894",2019-08-29,"12:42",83,60,13,10,23,82,9,22,113,22,10,8,40,366,11,74,451
"./Ship3_Latin-square/2019-08-29_12h42m_Subject 47088.txt","47088",2019-08-29,"12:42",81,60,8,13,21,73,3,3,79,113,20,26,159,959,182,257,1398
"./Ship3_Latin-square/2019-08-29_12h42m_Subject 47228.txt","47228",2019-08-29,"12:42",82,60,10,12,22,77,5,9,91,48,3,24,75,297,11,116,424
"./Ship3_Latin-square/2019-08-29_12h42m_Subject 47243.txt","47243",2019-08-29,"12:42",51,37,13,1,14,194,11,9,214,20,55,0,75,356,11,11,378
"./Ship3_Latin-square/2019-08-29_12h42m_Subject 47249.txt","47249",2019-08-29,"12:42",83,59,13,11,24,120,29,13,162,141,49,101,291,425,91,93,609
"./Ship3_Latin-square/2019-08-29_12h42m_Subject 47639.txt","47639",2019-08-29,"12:42",84,60,14,10,24,63,7,23,93,51,25,9,85,464,12,143,619
"./Ship3_Latin-square/2019-08-29_12h42m_Subject 47649.txt","47649",2019-08-29,"12:42",75,60,6,9,15,106,20,19,145,70,6,17,93,316,39,64,419
"./Ship3_Latin-square/2019-08-29_12h42m_Subject 47758.txt","47758",2019-08-29,"12:42",84,60,7,17,24,27,3,0,30,38,2,11,51,886,91,266,1243
"./Ship3_Latin-square/2019-08-29_12h42m_Subject 47759.txt","47759",2019-08-29,"12:42",80,60,3,17,20,73,0,21,94,63,15,25,103,619,23,172,814
"./Ship3_Latin-square/2019-08-29_12h42m_Subject 47776.txt","47776",2019-08-29,"12:42",78,60,10,8,18,71,9,14,94,67,19,10,96,563,7,126,696
"./Ship3_Latin-square/2019-08-29_12h42m_Subject 47799.txt","47799",2019-08-29,"12:42",83,60,7,16,23,97,3,12,112,152,23,93,268,548,64,119,731
"./Ship3_Latin-square/2019-08-29_12h45m_Subject 46881.txt","46881",2019-08-29,"12:45",82,60,10,12,22,71,6,12,89,49,5,22,76,395,48,111,554
"./Ship3_Latin-square/2019-08-29_12h45m_Subject 47087.txt","47087",2019-08-29,"12:45",82,60,9,13,22,83,13,34,130,48,22,16,86,338,39,74,451
"./Ship3_Latin-square/2019-08-29_12h45m_Subject 47626.txt","47626",2019-08-29,"12:45",77,60,9,8,17,64,2,7,73,148,72,12,232,394,59,46,499
"./Ship3_Latin-square/2019-08-29_12h45m_Subject 47634.txt","47634",2019-08-29,"12:45",76,54,12,10,22,111,26,20,157,44,19,21,84,245,30,70,345
"./Ship3_Latin-square/2019-08-29_12h45m_Subject 47640.txt","47640",2019-08-29,"12:45",77,60,9,8,17,112,8,11,131,61,11,24,96,474,28,123,625
"./Ship3_Latin-square/2019-08-29_12h45m_Subject 47754.txt","47754",2019-08-29,"12:45",58,42,11,5,16,88,14,9,111,52,15,10,77,211,3,26,240
"./Ship3_Latin-square/2019-08-29_12h45m_Subject 47800.txt","47800",2019-08-29,"12:45",81,60,7,14,21,98,9,21,128,101,14,38,153,601,95,157,853
"./Ship3_Latin-square/2019-08-29_13h55m_Subject 46876.txt","46876",2019-08-29,"13:55",77,60,8,9,17,128,9,19,156,37,16,24,77,437,60,76,573
"./Ship3_Latin-square/2019-08-29_13h55m_Subject 46893.txt","46893",2019-08-29,"13:55",86,60,11,15,26,78,4,29,111,65,17,46,128,672,15,246,933
"./Ship3_Latin-square/2019-08-29_13h55m_Subject 46895.txt","46895",2019-08-29,"13:55",47,33,14,0,14,84,40,0,124,59,76,0,135,159,50,0,209
"./Ship3_Latin-square/2019-08-29_13h55m_Subject 47638.txt","47638",2019-08-29,"13:55",80,60,11,9,20,107,12,19,138,72,21,11,104,235,14,70,319
"./Ship3_Latin-square/2019-08-29_13h55m_Subject 47757.txt","47757",2019-08-29,"13:55",67,50,11,6,17,117,21,8,146,71,37,9,117,291,72,50,413
"./Ship3_Latin-square/2019-08-29_13h55m_Subject 47769.txt","47769",2019-08-29,"13:55",85,60,16,9,25,89,14,15,118,44,17,46,107,562,13,131,706
"./Ship3_Latin-square/2019-08-29_13h55m_Subject 47771.txt","47771",2019-08-29,"13:55",78,60,8,10,18,28,3,2,33,26,9,18,53,883,114,183,1180
"./Ship3_Latin-square/2019-08-29_13h55m_Subject 47775.txt","47775",2019-08-29,"13:55",79,60,7,12,19,33,1,3,37,37,9,1,47,954,129,174,1257
"./Ship3_Latin-square/2019-08-29_13h55m_Subject 47781.txt","47781",2019-08-29,"13:55",79,60,10,9,19,60,2,11,73,55,13,10,78,622,22,113,757
"./Ship3_Latin-square/2019-08-29_13h55m_Subject 47782.txt","47782",2019-08-29,"13:55",79,60,6,13,19,62,3,19,84,24,18,20,62,922,91,172,1185
"./Ship3_Latin-square/2019-08-29_13h55m_Subject 47783.txt","47783",2019-08-29,"13:55",78,60,9,9,18,58,5,7,70,22,0,8,30,501,40,97,638
"./Ship3_Latin-square/2019-08-29_13h55m_Subject 47785.txt","47785",2019-08-29,"13:55",82,60,10,12,22,50,8,13,71,23,7,13,43,498,33,136,667
"./Ship3_Latin-square/2019-08-29_13h55m_Subject 47788.txt","47788",2019-08-29,"13:55",80,60,6,14,20,65,6,9,80,107,11,44,162,649,64,146,859
"./Ship3_Latin-square/2019-08-29_13h58m_Subject 46888.txt","46888",2019-08-29,"13:58",80,60,4,16,20,32,2,8,42,65,7,53,125,1058,78,231,1367
"./Ship3_Latin-square/2019-08-29_13h58m_Subject 46889.txt","46889",2019-08-29,"13:58",80,60,9,11,20,39,5,7,51,23,7,15,45,966,145,185,1296
"./Ship3_Latin-square/2019-08-29_13h58m_Subject 46892.txt","46892",2019-08-29,"13:58",79,60,7,12,19,46,4,3,53,20,7,10,37,974,86,206,1266
"./Ship3_Latin-square/2019-08-29_13h58m_Subject 47097.txt","47097",2019-08-29,"13:58",81,60,11,10,21,137,3,30,170,86,16,39,141,482,31,136,649
"./Ship3_Latin-square/2019-08-29_13h58m_Subject 47099.txt","47099",2019-08-29,"13:58",82,60,8,14,22,70,10,6,86,110,44,84,238,1268,135,380,1783
"./Ship3_Latin-square/2019-08-29_15h19m_Subject 47080.txt","47080",2019-08-29,"15:19",86,60,13,13,26,110,13,40,163,27,8,5,40,299,4,104,407
"./Ship3_Latin-square/2019-08-29_15h19m_Subject 47089.txt","47089",2019-08-29,"15:19",60,43,10,7,17,88,13,18,119,60,35,15,110,243,47,42,332
"./Ship3_Latin-square/2019-08-29_15h19m_Subject 47762.txt","47762",2019-08-29,"15:19",76,55,9,12,21,87,10,20,117,22,0,17,39,314,53,78,445
"./Ship3_Latin-square/2019-08-29_15h19m_Subject 47791.txt","47791",2019-08-29,"15:19",84,60,11,13,24,45,3,7,55,48,9,15,72,608,113,142,863
"./Ship3_Latin-square/2019-08-30_09h53m_Subject 46878.txt","46878",2019-08-30,"09:53",82,59,12,11,23,44,83,11,138,170,48,69,287,664,126,129,919
"./Ship3_Latin-square/2019-08-30_09h53m_Subject 46885.txt","46885",2019-08-30,"09:53",85,60,9,16,25,78,16,13,107,34,24,14,72,340,53,115,508
"./Ship3_Latin-square/2019-08-30_09h53m_Subject 46899.txt","46899",2019-08-30,"09:53",82,60,10,12,22,70,11,12,93,56,3,31,90,497,64,107,668
"./Ship3_Latin-square/2019-08-30_09h53m_Subject 47091.txt","47091",2019-08-30,"09:53",77,60,8,9,17,49,10,9,68,82,18,18,118,388,46,110,544
"./Ship3_Latin-square/2019-08-30_09h53m_Subject 47231.txt","47231",2019-08-30,"09:53",72,56,5,11,16,101,12,20,133,35,16,13,64,328,17,103,448
"./Ship3_Latin-square/2019-08-30_09h53m_Subject 47238.txt","47238",2019-08-30,"09:53",82,60,14,8,22,48,14,9,71,74,24,11,109,586,158,66,810
"./Ship3_Latin-square/2019-08-30_09h53m_Subject 47242.txt","47242",2019-08-30,"09:53",84,60,9,15,24,66,1,7,74,64,15,122,201,813,113,212,1138
"./Ship3_Latin-square/2019-08-30_09h53m_Subject 47244.txt","47244",2019-08-30,"09:53",83,60,8,15,23,72,7,11,90,112,32,30,174,676,73,171,920
"./Ship3_Latin-square/2019-08-30_09h53m_Subject 47633.txt","47633",2019-08-30,"09:53",81,60,9,12,21,81,7,5,93,107,16,47,170,470,66,93,629
"./Ship3_Latin-square/2019-08-30_09h53m_Subject 47752.txt","47752",2019-08-30,"09:53",82,60,11,11,22,64,15,8,87,24,34,6,64,707,133,180,1020
"./Ship3_Latin-square/2019-08-30_09h53m_Subject 47767.txt","47767",2019-08-30,"09:53",88,60,15,13,28,75,3,19,97,30,22,56,108,377,49,141,567
"./Ship3_Latin-square/2019-08-30_09h57m_Subject 46884.txt","46884",2019-08-30,"09:57",64,47,7,10,17,100,5,37,142,45,6,18,69,196,18,30,244
"./Ship3_Latin-square/2019-08-30_09h57m_Subject 47083.txt","47083",2019-08-30,"09:57",75,52,7,16,23,107,17,29,153,42,4,8,54,418,28,166,612
"./Ship3_Latin-square/2019-08-30_09h57m_Subject 47246.txt","47246",2019-08-30,"09:57",79,60,8,11,19,80,6,19,105,64,8,13,85,392,46,99,537
"./Ship3_Latin-square/2019-08-30_09h57m_Subject 47635.txt","47635",2019-08-30,"09:57",83,60,9,14,23,109,8,23,140,91,13,17,121,542,93,138,773
"./Ship3_Latin-square/2019-08-30_09h57m_Subject 47779.txt","47779",2019-08-30,"09:57",58,41,8,9,17,115,16,10,141,20,15,16,51,121,26,47,194
"./Ship3_Latin-square/2019-08-30_11h04m_Subject 47229.txt","47229",2019-08-30,"11:04",78,60,12,6,18,135,15,24,174,80,15,2,97,509,13,80,602
"./Ship3_Latin-square/2019-08-30_11h04m_Subject 47233.txt","47233",2019-08-30,"11:04",84,60,14,10,24,68,23,16,107,79,15,20,114,391,52,104,547
"./Ship3_Latin-square/2019-08-30_11h04m_Subject 47247.txt","47247",2019-08-30,"11:04",81,60,13,8,21,45,11,9,65,38,15,11,64,396,76,62,534
"./Ship3_Latin-square/2019-08-30_11h04m_Subject 47777.txt","47777",2019-08-30,"11:04",81,60,4,17,21,94,12,11,117,18,0,5,23,572,44,167,783
"./Ship3_Latin-square/2019-08-30_11h04m_Subject 47784.txt","47784",2019-08-30,"11:04",86,60,5,21,26,64,25,9,98,94,33,80,207,1129,85,433,1647
"./Ship3_Latin-square/2019-08-30_11h10m_Subject 46900.txt","46900",2019-08-30,"11:10",77,60,10,7,17,41,5,4,50,83,23,7,113,522,45,102,669
"./Ship3_Latin-square/2019-08-30_11h10m_Subject 47076.txt","47076",2019-08-30,"11:10",81,60,10,11,21,38,15,4,57,30,3,23,56,825,118,197,1140
"./Ship3_Latin-square/2019-08-30_11h10m_Subject 47079.txt","47079",2019-08-30,"11:10",81,60,12,9,21,33,3,2,38,67,18,8,93,401,93,67,561
"./Ship3_Latin-square/2019-08-30_11h10m_Subject 47082.txt","47082",2019-08-30,"11:10",79,60,8,11,19,55,4,5,64,27,9,45,81,563,77,126,766
"./Ship3_Latin-square/2019-08-30_11h10m_Subject 47092.txt","47092",2019-08-30,"11:10",80,60,9,11,20,44,6,9,59,104,23,23,150,568,91,112,771
"./Ship3_Latin-square/2019-08-30_11h10m_Subject 47226.txt","47226",2019-08-30,"11:10",81,60,9,12,21,90,8,20,118,39,14,22,75,614,100,115,829
"./Ship3_Latin-square/2019-08-30_11h10m_Subject 47227.txt","47227",2019-08-30,"11:10",79,60,5,14,19,86,0,9,95,41,7,9,57,689,76,168,933
"./Ship3_Latin-square/2019-08-30_11h10m_Subject 47250.txt","47250",2019-08-30,"11:10",58,42,14,2,16,62,17,2,81,136,17,0,153,288,6,18,312
"./Ship3_Latin-square/2019-08-30_11h10m_Subject 47646.txt","47646",2019-08-30,"11:10",83,60,5,18,23,60,4,4,68,55,3,68,126,1164,73,334,1571
"./Ship3_Latin-square/2019-08-30_11h10m_Subject 47755.txt","47755",2019-08-30,"11:10",77,60,9,8,17,98,9,10,117,76,15,10,101,497,63,67,627
"./Ship3_Latin-square/2019-08-30_11h10m_Subject 47760.txt","47760",2019-08-30,"11:10",82,60,9,13,22,91,29,28,148,68,16,39,123,608,82,141,831
"./Ship3_Latin-square/2019-08-30_11h10m_Subject 47770.txt","47770",2019-08-30,"11:10",51,38,4,9,13,112,7,30,149,162,26,20,208,229,30,41,300
"./Ship3_Latin-square/2019-08-30_11h10m_Subject 47795.txt","47795",2019-08-30,"11:10",84,60,6,18,24,66,6,33,105,61,6,40,107,559,48,160,767
"./Ship3_Latin-square/2019-08-30_12h17m_Subject 46880.txt","46880",2019-08-30,"12:17",80,60,11,9,20,15,5,1,21,21,2,4,27,482,46,95,623
"./Ship3_Latin-square/2019-08-30_12h17m_Subject 46882.txt","46882",2019-08-30,"12:17",76,60,6,10,16,19,1,0,20,82,10,42,134,848,81,182,1111
"./Ship3_Latin-square/2019-08-30_12h17m_Subject 46883.txt","46883",2019-08-30,"12:17",78,56,12,10,22,143,13,24,180,78,61,118,257,381,99,75,555
"./Ship3_Latin-square/2019-08-30_12h17m_Subject 46894.txt","46894",2019-08-30,"12:17",74,60,6,8,14,51,22,5,78,38,2,28,68,575,36,71,682
"./Ship3_Latin-square/2019-08-30_12h17m_Subject 47088.txt","47088",2019-08-30,"12:17",80,60,8,12,20,45,3,10,58,48,7,13,68,689,74,137,900
"./Ship3_Latin-square/2019-08-30_12h17m_Subject 47228.txt","47228",2019-08-30,"12:17",78,60,8,10,18,29,1,9,39,58,9,9,76,697,103,85,885
"./Ship3_Latin-square/2019-08-30_12h17m_Subject 47243.txt","47243",2019-08-30,"12:17",84,60,10,14,24,64,15,7,86,53,43,2,98,834,106,269,1209
"./Ship3_Latin-square/2019-08-30_12h17m_Subject 47249.txt","47249",2019-08-30,"12:17",79,60,9,10,19,88,23,8,119,82,26,14,122,360,62,46,468
"./Ship3_Latin-square/2019-08-30_12h17m_Subject 47639.txt","47639",2019-08-30,"12:17",82,60,10,12,22,26,32,3,61,48,13,37,98,685,115,193,993
"./Ship3_Latin-square/2019-08-30_12h17m_Subject 47649.txt","47649",2019-08-30,"12:17",84,60,13,11,24,60,7,4,71,89,25,45,159,464,115,98,677
"./Ship3_Latin-square/2019-08-30_12h17m_Subject 47758.txt","47758",2019-08-30,"12:17",81,60,11,10,21,26,6,1,33,32,3,10,45,811,145,158,1114
"./Ship3_Latin-square/2019-08-30_12h17m_Subject 47759.txt","47759",2019-08-30,"12:17",80,60,11,9,20,17,4,2,23,65,26,15,106,592,83,104,779
"./Ship3_Latin-square/2019-08-30_12h17m_Subject 47776.txt","47776",2019-08-30,"12:17",83,60,15,8,23,78,58,5,141,57,27,26,110,999,191,185,1375
"./Ship3_Latin-square/2019-08-30_12h17m_Subject 47799.txt","47799",2019-08-30,"12:17",76,60,8,8,16,35,3,7,45,132,26,35,193,570,78,94,742
"./Ship3_Latin-square/2019-08-30_12h20m_Subject 46881.txt","46881",2019-08-30,"12:20",78,60,8,10,18,80,12,10,102,37,2,13,52,731,104,162,997
"./Ship3_Latin-square/2019-08-30_12h20m_Subject 47087.txt","47087",2019-08-30,"12:20",82,60,9,13,22,183,5,16,204,80,21,42,143,456,97,110,663
"./Ship3_Latin-square/2019-08-30_12h20m_Subject 47626.txt","47626",2019-08-30,"12:20",82,60,14,8,22,72,17,14,103,75,22,8,105,322,54,55,431
"./Ship3_Latin-square/2019-08-30_12h20m_Subject 47634.txt","47634",2019-08-30,"12:20",82,60,10,12,22,109,11,22,142,45,25,16,86,547,88,121,756
"./Ship3_Latin-square/2019-08-30_12h20m_Subject 47640.txt","47640",2019-08-30,"12:20",78,59,10,9,19,152,13,8,173,58,20,26,104,922,159,157,1238
"./Ship3_Latin-square/2019-08-30_12h20m_Subject 47754.txt","47754",2019-08-30,"12:20",68,50,5,13,18,114,13,15,142,60,12,28,100,436,37,124,597
"./Ship3_Latin-square/2019-08-30_12h20m_Subject 47800.txt","47800",2019-08-30,"12:20",81,60,9,12,21,101,15,22,138,75,22,28,125,257,4,114,375
"./Ship3_Latin-square/2019-08-30_13h49m_Subject 46876.txt","46876",2019-08-30,"13:49",78,60,10,8,18,99,15,13,127,18,5,15,38,238,18,37,293
"./Ship3_Latin-square/2019-08-30_13h49m_Subject 46893.txt","46893",2019-08-30,"13:49",82,60,5,17,22,39,0,5,44,35,2,14,51,1162,87,362,1611
"./Ship3_Latin-square/2019-08-30_13h49m_Subject 46895.txt","46895",2019-08-30,"13:49",81,56,12,13,25,110,17,34,161,94,46,80,220,474,67,207,748
"./Ship3_Latin-square/2019-08-30_13h49m_Subject 47638.txt","47638",2019-08-30,"13:49",76,54,12,10,22,133,17,21,171,53,16,33,102,424,72,80,576
"./Ship3_Latin-square/2019-08-30_13h49m_Subject 47757.txt","47757",2019-08-30,"13:49",71,51,7,13,20,88,13,21,122,52,6,25,83,353,39,101,493
"./Ship3_Latin-square/2019-08-30_13h49m_Subject 47769.txt","47769",2019-08-30,"13:49",83,60,14,9,23,48,15,6,69,37,21,12,70,815,223,130,1168
"./Ship3_Latin-square/2019-08-30_13h49m_Subject 47771.txt","47771",2019-08-30,"13:49",85,60,14,11,25,63,16,17,96,22,11,11,44,425,10,116,551
"./Ship3_Latin-square/2019-08-30_13h49m_Subject 47775.txt","47775",2019-08-30,"13:49",83,60,13,10,23,96,14,20,130,70,26,3,99,296,8,113,417
"./Ship3_Latin-square/2019-08-30_13h49m_Subject 47781.txt","47781",2019-08-30,"13:49",82,60,6,16,22,22,2,3,27,50,8,22,80,1178,136,294,1608
"./Ship3_Latin-square/2019-08-30_13h49m_Subject 47782.txt","47782",2019-08-30,"13:49",82,60,12,10,22,35,3,4,42,30,19,6,55,827,176,161,1164
"./Ship3_Latin-square/2019-08-30_13h49m_Subject 47783.txt","47783",2019-08-30,"13:49",81,60,7,14,21,35,4,10,49,83,9,18,110,975,120,259,1354
"./Ship3_Latin-square/2019-08-30_13h49m_Subject 47785.txt","47785",2019-08-30,"13:49",80,60,7,13,20,52,4,9,65,19,8,11,38,1018,145,191,1354
"./Ship3_Latin-square/2019-08-30_13h49m_Subject 47788.txt","47788",2019-08-30,"13:49",81,60,9,12,21,49,4,3,56,74,18,22,114,638,104,116,858
"./Ship3_Latin-square/2019-08-30_13h52m_Subject 46888.txt","46888",2019-08-30,"13:52",81,60,12,9,21,37,3,11,51,165,21,19,205,543,10,193,746
"./Ship3_Latin-square/2019-08-30_13h52m_Subject 46889.txt","46889",2019-08-30,"13:52",83,60,9,14,23,27,8,9,44,37,12,27,76,1127,161,233,1521
"./Ship3_Latin-square/2019-08-30_13h52m_Subject 46892.txt","46892",2019-08-30,"13:52",81,60,9,12,21,35,1,2,38,13,8,2,23,848,145,169,1162
"./Ship3_Latin-square/2019-08-30_13h52m_Subject 47097.txt","47097",2019-08-30,"13:52",80,60,10,10,20,49,8,10,67,94,22,13,129,986,180,177,1343
"./Ship3_Latin-square/2019-08-30_13h52m_Subject 47099.txt","47099",2019-08-30,"13:52",82,60,11,11,22,24,59,8,91,24,15,14,53,1281,221,319,1821
"./Ship3_Latin-square/2019-08-30_13h52m_Subject 47798.txt","47798",2019-08-30,"13:52",73,52,4,17,21,102,11,21,134,49,4,18,71,270,22,100,392
"./Ship3_Latin-square/2019-08-30_15h06m_Subject 47080.txt","47080",2019-08-30,"15:06",83,60,9,14,23,51,4,4,59,14,1,3,18,556,102,131,789
"./Ship3_Latin-square/2019-08-30_15h06m_Subject 47089.txt","47089",2019-08-30,"15:06",43,30,10,3,13,113,26,15,154,69,19,0,88,126,5,5,136
"./Ship3_Latin-square/2019-08-30_15h06m_Subject 47762.txt","47762",2019-08-30,"15:06",77,58,8,11,19,158,14,24,196,24,5,14,43,340,36,72,448
"./Ship3_Latin-square/2019-08-30_15h06m_Subject 47791.txt","47791",2019-08-30,"15:06",83,60,11,12,23,51,11,9,71,75,8,13,96,369,32,97,498
"./Ship3_Latin-square/2019-09-03_10h07m_Subject 46878.txt","46878",2019-09-03,"10:07",80,60,8,12,20,37,25,14,76,70,27,80,177,556,74,151,781
"./Ship3_Latin-square/2019-09-03_10h07m_Subject 46885.txt","46885",2019-09-03,"10:07",77,57,17,3,20,104,31,8,143,36,21,1,58,286,43,24,353
"./Ship3_Latin-square/2019-09-03_10h07m_Subject 46899.txt","46899",2019-09-03,"10:07",83,60,14,9,23,62,14,6,82,66,19,12,97,628,119,110,857
"./Ship3_Latin-square/2019-09-03_10h07m_Subject 47091.txt","47091",2019-09-03,"10:07",79,60,5,14,19,43,3,9,55,74,15,26,115,267,12,55,334
"./Ship3_Latin-square/2019-09-03_10h07m_Subject 47231.txt","47231",2019-09-03,"10:07",80,59,11,10,21,79,16,15,110,51,33,14,98,352,74,76,502
"./Ship3_Latin-square/2019-09-03_10h07m_Subject 47238.txt","47238",2019-09-03,"10:07",69,48,21,0,21,53,14,0,67,32,37,0,69,267,36,0,303
"./Ship3_Latin-square/2019-09-03_10h07m_Subject 47242.txt","47242",2019-09-03,"10:07",81,60,15,6,21,51,29,6,86,78,45,46,169,362,16,63,441
"./Ship3_Latin-square/2019-09-03_10h07m_Subject 47244.txt","47244",2019-09-03,"10:07",67,49,15,3,18,115,14,7,136,154,28,8,190,329,45,27,401
"./Ship3_Latin-square/2019-09-03_10h07m_Subject 47633.txt","47633",2019-09-03,"10:07",81,60,13,8,21,50,6,7,63,71,19,16,106,384,44,76,504
"./Ship3_Latin-square/2019-09-03_10h07m_Subject 47636.txt","47636",2019-09-03,"10:07",58,44,8,6,14,361,91,8,460,94,25,10,129,246,34,38,318
"./Ship3_Latin-square/2019-09-03_10h07m_Subject 47752.txt","47752",2019-09-03,"10:07",77,60,9,8,17,55,5,4,64,42,19,10,71,580,62,69,711
"./Ship3_Latin-square/2019-09-03_10h07m_Subject 47767.txt","47767",2019-09-03,"10:07",63,45,17,1,18,100,15,3,118,28,70,1,99,220,17,5,242
"./Ship3_Latin-square/2019-09-03_10h07m_Subject 47768.txt","47768",2019-09-03,"10:07",41,30,7,4,11,109,29,11,149,64,14,3,81,210,37,11,258
"./Ship3_Latin-square/2019-09-03_10h10m_Subject 46884.txt","46884",2019-09-03,"10:10",79,60,7,12,19,48,4,5,57,47,25,3,75,317,31,59,407
"./Ship3_Latin-square/2019-09-03_10h10m_Subject 47083.txt","47083",2019-09-03,"10:10",86,60,13,13,26,108,16,19,143,33,15,7,55,398,38,121,557
"./Ship3_Latin-square/2019-09-03_10h10m_Subject 47246.txt","47246",2019-09-03,"10:10",88,60,1,27,28,78,0,17,95,44,0,41,85,632,14,218,864
"./Ship3_Latin-square/2019-09-03_10h10m_Subject 47635.txt","47635",2019-09-03,"10:10",80,60,11,9,20,63,8,11,82,55,15,13,83,551,80,88,719
"./Ship3_Latin-square/2019-09-03_10h10m_Subject 47779.txt","47779",2019-09-03,"10:10",77,57,10,10,20,71,4,5,80,46,21,8,75,199,14,40,253
"./Ship3_Latin-square/2019-09-03_11h33m_Subject 46900.txt","46900",2019-09-03,"11:33",78,60,6,12,18,36,1,14,51,73,15,9,97,847,82,162,1091
"./Ship3_Latin-square/2019-09-03_11h33m_Subject 47076.txt","47076",2019-09-03,"11:33",78,56,16,6,22,49,4,12,65,135,145,92,372,420,17,56,493
"./Ship3_Latin-square/2019-09-03_11h33m_Subject 47079.txt","47079",2019-09-03,"11:33",82,60,13,9,22,40,1,3,44,60,11,10,81,348,52,75,475
"./Ship3_Latin-square/2019-09-03_11h33m_Subject 47082.txt","47082",2019-09-03,"11:33",83,60,16,7,23,68,14,7,89,27,10,6,43,315,21,58,394
"./Ship3_Latin-square/2019-09-03_11h33m_Subject 47092.txt","47092",2019-09-03,"11:33",80,60,12,8,20,87,5,19,111,68,20,12,100,405,39,81,525
"./Ship3_Latin-square/2019-09-03_11h33m_Subject 47226.txt","47226",2019-09-03,"11:33",79,60,10,9,19,93,4,21,118,53,5,13,71,262,5,52,319
"./Ship3_Latin-square/2019-09-03_11h33m_Subject 47227.txt","47227",2019-09-03,"11:33",85,60,16,9,25,84,6,13,103,53,29,18,100,378,11,94,483
"./Ship3_Latin-square/2019-09-03_11h33m_Subject 47250.txt","47250",2019-09-03,"11:33",84,60,8,16,24,66,11,12,89,6,5,33,44,708,76,240,1024
"./Ship3_Latin-square/2019-09-03_11h33m_Subject 47646.txt","47646",2019-09-03,"11:33",59,44,13,2,15,113,13,4,130,36,5,36,77,368,4,16,388
"./Ship3_Latin-square/2019-09-03_11h33m_Subject 47755.txt","47755",2019-09-03,"11:33",80,59,3,18,21,77,5,16,98,77,4,38,119,568,26,163,757
"./Ship3_Latin-square/2019-09-03_11h33m_Subject 47760.txt","47760",2019-09-03,"11:33",81,60,13,8,21,59,12,8,79,50,14,10,74,514,43,91,648
"./Ship3_Latin-square/2019-09-03_11h33m_Subject 47770.txt","47770",2019-09-03,"11:33",56,44,6,6,12,92,13,7,112,70,44,9,123,196,25,31,252
"./Ship3_Latin-square/2019-09-03_11h33m_Subject 47795.txt","47795",2019-09-03,"11:33",43,32,10,1,11,54,9,1,64,35,168,0,203,185,6,13,204
"./Ship3_Latin-square/2019-09-03_11h37m_Subject 47229.txt","47229",2019-09-03,"11:37",79,60,8,11,19,25,1,3,29,55,8,3,66,668,94,109,871
"./Ship3_Latin-square/2019-09-03_11h37m_Subject 47233.txt","47233",2019-09-03,"11:37",81,60,4,17,21,40,3,6,49,77,7,48,132,430,33,125,588
"./Ship3_Latin-square/2019-09-03_11h37m_Subject 47247.txt","47247",2019-09-03,"11:37",81,60,12,9,21,62,10,14,86,49,8,6,63,343,35,72,450
"./Ship3_Latin-square/2019-09-03_11h37m_Subject 47777.txt","47777",2019-09-03,"11:37",78,60,11,7,18,143,12,21,176,28,7,3,38,280,11,59,350
"./Ship3_Latin-square/2019-09-03_11h37m_Subject 47784.txt","47784",2019-09-03,"11:37",70,60,7,3,10,91,6,11,108,77,7,4,88,540,19,37,596
"./Ship3_Latin-square/2019-09-03_13h13m_Subject 46880.txt","46880",2019-09-03,"13:13",80,60,7,13,20,43,6,10,59,24,1,14,39,684,90,153,927
"./Ship3_Latin-square/2019-09-03_13h13m_Subject 46882.txt","46882",2019-09-03,"13:13",72,52,12,8,20,72,3,12,87,58,23,14,95,325,6,66,397
"./Ship3_Latin-square/2019-09-03_13h13m_Subject 46883.txt","46883",2019-09-03,"13:13",80,60,11,9,20,99,15,13,127,35,11,7,53,296,31,50,377
"./Ship3_Latin-square/2019-09-03_13h13m_Subject 46894.txt","46894",2019-09-03,"13:13",81,60,8,13,21,54,2,6,62,25,22,1,48,517,54,119,690
"./Ship3_Latin-square/2019-09-03_13h13m_Subject 47088.txt","47088",2019-09-03,"13:13",79,60,10,9,19,52,3,5,60,57,21,8,86,769,174,116,1059
"./Ship3_Latin-square/2019-09-03_13h13m_Subject 47228.txt","47228",2019-09-03,"13:13",81,60,9,12,21,28,7,5,40,43,5,23,71,525,76,95,696
"./Ship3_Latin-square/2019-09-03_13h13m_Subject 47243.txt","47243",2019-09-03,"13:13",81,60,11,10,21,66,10,6,82,34,14,10,58,831,132,162,1125
"./Ship3_Latin-square/2019-09-03_13h13m_Subject 47249.txt","47249",2019-09-03,"13:13",78,60,9,9,18,54,10,9,73,83,20,36,139,596,49,98,743
"./Ship3_Latin-square/2019-09-03_13h13m_Subject 47639.txt","47639",2019-09-03,"13:13",76,60,10,6,16,17,7,5,29,16,15,0,31,759,89,82,930
"./Ship3_Latin-square/2019-09-03_13h13m_Subject 47649.txt","47649",2019-09-03,"13:13",74,59,8,7,15,80,8,7,95,55,14,44,113,326,45,35,406
"./Ship3_Latin-square/2019-09-03_13h13m_Subject 47758.txt","47758",2019-09-03,"13:13",78,60,6,12,18,16,1,1,18,27,4,4,35,829,99,168,1096
"./Ship3_Latin-square/2019-09-03_13h13m_Subject 47759.txt","47759",2019-09-03,"13:13",84,60,9,15,24,27,1,2,30,47,6,33,86,544,82,138,764
"./Ship3_Latin-square/2019-09-03_13h13m_Subject 47776.txt","47776",2019-09-03,"13:13",82,60,2,20,22,26,2,7,35,102,3,43,148,917,24,335,1276
"./Ship3_Latin-square/2019-09-03_13h13m_Subject 47799.txt","47799",2019-09-03,"13:13",79,60,9,10,19,28,4,6,38,70,25,26,121,642,117,96,855
"./Ship3_Latin-square/2019-09-03_13h16m_Subject 46881.txt","46881",2019-09-03,"13:16",82,60,14,8,22,137,14,30,181,40,4,21,65,261,10,45,316
"./Ship3_Latin-square/2019-09-03_13h16m_Subject 47087.txt","47087",2019-09-03,"13:16",57,42,11,4,15,106,17,22,145,39,12,3,54,199,11,24,234
"./Ship3_Latin-square/2019-09-03_13h16m_Subject 47626.txt","47626",2019-09-03,"13:16",78,60,9,9,18,65,9,5,79,98,25,51,174,452,79,63,594
"./Ship3_Latin-square/2019-09-03_13h16m_Subject 47634.txt","47634",2019-09-03,"13:16",73,53,17,3,20,141,28,9,178,37,27,2,66,222,10,9,241
"./Ship3_Latin-square/2019-09-03_13h16m_Subject 47640.txt","47640",2019-09-03,"13:16",76,57,14,5,19,117,25,14,156,41,27,4,72,393,5,48,446
"./Ship3_Latin-square/2019-09-03_13h16m_Subject 47754.txt","47754",2019-09-03,"13:16",76,60,9,7,16,59,4,5,68,104,22,15,141,629,66,72,767
"./Ship3_Latin-square/2019-09-03_13h16m_Subject 47800.txt","47800",2019-09-03,"13:16",80,60,10,10,20,83,12,5,100,72,18,17,107,459,89,75,623
"./Ship3_Latin-square/2019-09-03_14h33m_Subject 46876.txt","46876",2019-09-03,"14:33",55,43,6,6,12,74,9,10,93,7,4,30,41,258,36,38,332
"./Ship3_Latin-square/2019-09-03_14h33m_Subject 46877.txt","46877",2019-09-03,"14:33",82,60,13,9,22,170,24,5,199,50,18,78,146,933,203,170,1306
"./Ship3_Latin-square/2019-09-03_14h33m_Subject 46893.txt","46893",2019-09-03,"14:33",75,60,6,9,15,28,4,3,35,45,0,6,51,828,55,123,1006
"./Ship3_Latin-square/2019-09-03_14h33m_Subject 46895.txt","46895",2019-09-03,"14:33",84,60,7,17,24,68,12,11,91,84,22,44,150,467,51,146,664
"./Ship3_Latin-square/2019-09-03_14h33m_Subject 47638.txt","47638",2019-09-03,"14:33",79,57,11,11,22,80,20,15,115,56,19,88,163,266,50,47,363
"./Ship3_Latin-square/2019-09-03_14h33m_Subject 47757.txt","47757",2019-09-03,"14:33",77,58,8,11,19,94,13,16,123,71,18,30,119,424,55,73,552
"./Ship3_Latin-square/2019-09-03_14h33m_Subject 47769.txt","47769",2019-09-03,"14:33",83,60,13,10,23,44,4,9,57,44,17,32,93,633,137,100,870
"./Ship3_Latin-square/2019-09-03_14h33m_Subject 47771.txt","47771",2019-09-03,"14:33",81,60,7,14,21,34,6,9,49,35,3,92,130,667,71,206,944
"./Ship3_Latin-square/2019-09-03_14h33m_Subject 47775.txt","47775",2019-09-03,"14:33",80,60,8,12,20,53,12,4,69,26,1,4,31,574,91,150,815
"./Ship3_Latin-square/2019-09-03_14h33m_Subject 47781.txt","47781",2019-09-03,"14:33",84,60,22,2,24,66,11,9,86,51,42,0,93,625,5,28,658
"./Ship3_Latin-square/2019-09-03_14h33m_Subject 47782.txt","47782",2019-09-03,"14:33",77,60,5,12,17,34,0,3,37,12,6,14,32,726,91,146,963
"./Ship3_Latin-square/2019-09-03_14h33m_Subject 47783.txt","47783",2019-09-03,"14:33",83,60,13,10,23,94,10,25,129,37,10,9,56,294,4,68,366
"./Ship3_Latin-square/2019-09-03_14h33m_Subject 47785.txt","47785",2019-09-03,"14:33",73,51,13,9,22,93,12,26,131,30,17,22,69,332,7,64,403
"./Ship3_Latin-square/2019-09-03_14h33m_Subject 47788.txt","47788",2019-09-03,"14:33",78,60,7,11,18,43,5,9,57,105,23,21,149,419,59,88,566
"./Ship3_Latin-square/2019-09-03_14h37m_Subject 46888.txt","46888",2019-09-03,"14:37",80,60,7,13,20,27,2,1,30,149,13,43,205,775,88,147,1010
"./Ship3_Latin-square/2019-09-03_14h37m_Subject 46889.txt","46889",2019-09-03,"14:37",80,60,10,10,20,62,12,12,86,39,7,12,58,534,38,121,693
"./Ship3_Latin-square/2019-09-03_14h37m_Subject 46892.txt","46892",2019-09-03,"14:37",75,60,4,11,15,25,1,4,30,21,6,1,28,971,74,177,1222
"./Ship3_Latin-square/2019-09-03_14h37m_Subject 47097.txt","47097",2019-09-03,"14:37",82,60,13,9,22,151,3,45,199,85,24,14,123,324,0,116,440
"./Ship3_Latin-square/2019-09-03_14h37m_Subject 47099.txt","47099",2019-09-03,"14:37",78,60,7,11,18,42,2,2,46,33,2,3,38,1378,182,238,1798
"./Ship3_Latin-square/2019-09-03_14h37m_Subject 47798.txt","47798",2019-09-03,"14:37",79,59,11,9,20,65,4,19,88,57,13,6,76,245,31,68,344
"./Ship3_Latin-square/2019-09-03_15h45m_Subject 47080.txt","47080",2019-09-03,"15:45",78,60,9,9,18,46,4,2,52,14,1,10,25,594,82,129,805
"./Ship3_Latin-square/2019-09-03_15h45m_Subject 47089.txt","47089",2019-09-03,"15:45",66,50,9,7,16,85,20,16,121,131,47,46,224,255,40,38,333
"./Ship3_Latin-square/2019-09-03_15h45m_Subject 47762.txt","47762",2019-09-03,"15:45",77,60,9,8,17,73,9,4,86,42,8,15,65,334,59,58,451
"./Ship3_Latin-square/2019-09-03_15h45m_Subject 47791.txt","47791",2019-09-03,"15:45",83,60,5,18,23,44,4,14,62,54,14,23,91,621,57,212,890
"./Ship3_Latin-square/2019-09-04_09h35m_Subject 46878.txt","46878",2019-09-04,"09:35",81,60,10,11,21,36,10,3,49,70,43,31,144,919,144,172,1235
"./Ship3_Latin-square/2019-09-04_09h35m_Subject 46885.txt","46885",2019-09-04,"09:35",84,60,9,15,24,73,8,10,91,61,9,4,74,330,56,82,468
"./Ship3_Latin-square/2019-09-04_09h35m_Subject 46899.txt","46899",2019-09-04,"09:35",80,60,12,8,20,70,10,18,98,55,10,10,75,414,45,81,540
"./Ship3_Latin-square/2019-09-04_09h35m_Subject 47091.txt","47091",2019-09-04,"09:35",77,60,9,8,17,52,2,4,58,68,26,6,100,230,23,51,304
"./Ship3_Latin-square/2019-09-04_09h35m_Subject 47231.txt","47231",2019-09-04,"09:35",73,60,9,4,13,85,17,8,110,36,7,2,45,236,23,15,274
"./Ship3_Latin-square/2019-09-04_09h35m_Subject 47238.txt","47238",2019-09-04,"09:35",81,60,12,9,21,43,6,7,56,93,30,42,165,616,108,143,867
"./Ship3_Latin-square/2019-09-04_09h35m_Subject 47242.txt","47242",2019-09-04,"09:35",83,60,11,12,23,38,3,5,46,121,17,87,225,683,133,166,982
"./Ship3_Latin-square/2019-09-04_09h35m_Subject 47244.txt","47244",2019-09-04,"09:35",84,60,8,16,24,72,21,5,98,84,26,44,154,739,103,207,1049
"./Ship3_Latin-square/2019-09-04_09h35m_Subject 47633.txt","47633",2019-09-04,"09:35",81,60,11,10,21,75,12,10,97,79,19,26,124,444,63,75,582
"./Ship3_Latin-square/2019-09-04_09h35m_Subject 47636.txt","47636",2019-09-04,"09:35",74,54,10,10,20,323,25,15,363,77,24,16,117,292,39,56,387
"./Ship3_Latin-square/2019-09-04_09h35m_Subject 47752.txt","47752",2019-09-04,"09:35",83,60,14,9,23,68,7,9,84,28,30,26,84,580,66,139,785
"./Ship3_Latin-square/2019-09-04_09h35m_Subject 47767.txt","47767",2019-09-04,"09:35",86,60,10,16,26,64,26,2,92,60,79,81,220,420,69,121,610
"./Ship3_Latin-square/2019-09-04_09h35m_Subject 47768.txt","47768",2019-09-04,"09:35",80,60,10,10,20,88,14,13,115,71,14,17,102,406,39,93,538
"./Ship3_Latin-square/2019-09-04_09h35m_Subject 47780.txt","47780",2019-09-04,"09:35",65,48,12,5,17,101,32,12,145,82,110,114,306,401,59,28,488
"./Ship3_Latin-square/2019-09-04_09h38m_Subject 46884.txt","46884",2019-09-04,"09:38",71,51,11,9,20,110,5,26,141,42,34,11,87,140,3,35,178
"./Ship3_Latin-square/2019-09-04_09h38m_Subject 47083.txt","47083",2019-09-04,"09:38",74,54,7,13,20,71,7,14,92,97,18,6,121,489,72,158,719
"./Ship3_Latin-square/2019-09-04_09h38m_Subject 47246.txt","47246",2019-09-04,"09:38",73,60,9,4,13,104,9,10,123,70,6,6,82,353,2,41,396
"./Ship3_Latin-square/2019-09-04_09h38m_Subject 47635.txt","47635",2019-09-04,"09:38",79,60,12,7,19,38,9,4,51,77,20,14,111,667,115,93,875
"./Ship3_Latin-square/2019-09-04_09h38m_Subject 47779.txt","47779",2019-09-04,"09:38",78,60,6,12,18,40,1,3,44,57,15,18,90,185,23,40,248
"./Ship3_Latin-square/2019-09-04_09h38m_Subject 47797.txt","47797",2019-09-04,"09:38",49,38,2,9,11,55,4,4,63,26,2,10,38,156,3,14,173
"./Ship3_Latin-square/2019-09-04_10h55m_Subject 46900.txt","46900",2019-09-04,"10:55",83,60,13,10,23,62,3,23,88,66,7,7,80,427,5,121,553
"./Ship3_Latin-square/2019-09-04_10h55m_Subject 47076.txt","47076",2019-09-04,"10:55",82,60,9,13,22,11,7,2,20,48,9,2,59,784,120,197,1101
"./Ship3_Latin-square/2019-09-04_10h55m_Subject 47079.txt","47079",2019-09-04,"10:55",81,60,11,10,21,25,2,3,30,70,11,8,89,396,87,72,555
"./Ship3_Latin-square/2019-09-04_10h55m_Subject 47082.txt","47082",2019-09-04,"10:55",79,60,7,12,19,93,3,26,122,23,0,22,45,689,98,145,932
"./Ship3_Latin-square/2019-09-04_10h55m_Subject 47092.txt","47092",2019-09-04,"10:55",80,60,9,11,20,19,6,3,28,79,8,18,105,709,107,131,947
"./Ship3_Latin-square/2019-09-04_10h55m_Subject 47226.txt","47226",2019-09-04,"10:55",78,60,6,12,18,43,6,17,66,42,3,22,67,494,54,122,670
"./Ship3_Latin-square/2019-09-04_10h55m_Subject 47227.txt","47227",2019-09-04,"10:55",78,60,4,14,18,53,1,22,76,22,8,23,53,549,34,122,705
"./Ship3_Latin-square/2019-09-04_10h55m_Subject 47250.txt","47250",2019-09-04,"10:55",80,60,11,9,20,33,3,3,39,13,7,8,28,765,98,153,1016
"./Ship3_Latin-square/2019-09-04_10h55m_Subject 47646.txt","47646",2019-09-04,"10:55",83,60,12,11,23,26,1,2,29,70,28,35,133,931,189,219,1339
"./Ship3_Latin-square/2019-09-04_10h55m_Subject 47755.txt","47755",2019-09-04,"10:55",82,60,12,10,22,71,14,16,101,81,15,11,107,493,61,115,669
"./Ship3_Latin-square/2019-09-04_10h55m_Subject 47760.txt","47760",2019-09-04,"10:55",79,60,7,12,19,94,8,11,113,41,10,15,66,781,84,158,1023
"./Ship3_Latin-square/2019-09-04_10h55m_Subject 47770.txt","47770",2019-09-04,"10:55",57,44,6,7,13,74,19,9,102,85,14,6,105,203,40,26,269
"./Ship3_Latin-square/2019-09-04_10h55m_Subject 47795.txt","47795",2019-09-04,"10:55",86,60,8,18,26,44,14,14,72,30,48,52,130,458,26,221,705
"./Ship3_Latin-square/2019-09-04_10h58m_Subject 47229.txt","47229",2019-09-04,"10:58",74,60,6,8,14,26,1,2,29,37,6,6,49,788,66,104,958
"./Ship3_Latin-square/2019-09-04_10h58m_Subject 47233.txt","47233",2019-09-04,"10:58",77,54,19,4,23,126,60,5,191,121,96,22,239,389,6,32,427
"./Ship3_Latin-square/2019-09-04_10h58m_Subject 47241.txt","47241",2019-09-04,"10:58",87,60,4,23,27,43,7,13,63,18,12,22,52,685,45,319,1049
"./Ship3_Latin-square/2019-09-04_10h58m_Subject 47247.txt","47247",2019-09-04,"10:58",77,60,5,12,17,30,4,7,41,42,5,9,56,378,48,83,509
"./Ship3_Latin-square/2019-09-04_10h58m_Subject 47777.txt","47777",2019-09-04,"10:58",84,60,11,13,24,44,3,10,57,22,7,7,36,526,121,123,770
"./Ship3_Latin-square/2019-09-04_10h58m_Subject 47784.txt","47784",2019-09-04,"10:58",84,60,3,21,24,71,4,11,86,31,3,45,79,1154,44,324,1522
"./Ship3_Latin-square/2019-09-04_12h01m_Subject 46881.txt","46881",2019-09-04,"12:01",79,60,8,11,19,83,3,16,102,28,2,18,48,494,93,92,679
"./Ship3_Latin-square/2019-09-04_12h01m_Subject 47087.txt","47087",2019-09-04,"12:01",80,58,6,16,22,81,25,19,125,86,13,60,159,358,41,84,483
"./Ship3_Latin-square/2019-09-04_12h01m_Subject 47626.txt","47626",2019-09-04,"12:01",69,55,9,5,14,129,7,12,148,69,22,6,97,176,1,15,192
"./Ship3_Latin-square/2019-09-04_12h01m_Subject 47634.txt","47634",2019-09-04,"12:01",78,57,10,11,21,123,31,19,173,49,24,43,116,350,60,93,503
"./Ship3_Latin-square/2019-09-04_12h01m_Subject 47640.txt","47640",2019-09-04,"12:01",77,56,10,11,21,78,12,8,98,50,7,40,97,536,92,161,789
"./Ship3_Latin-square/2019-09-04_12h01m_Subject 47754.txt","47754",2019-09-04,"12:01",78,60,5,13,18,38,1,3,42,64,1,16,81,671,53,146,870
"./Ship3_Latin-square/2019-09-04_12h01m_Subject 47800.txt","47800",2019-09-04,"12:01",80,60,6,14,20,48,2,5,55,73,9,16,98,550,46,151,747
"./Ship3_Latin-square/2019-09-04_12h08m_Subject 46880.txt","46880",2019-09-04,"12:08",84,59,14,11,25,99,5,28,132,37,8,11,56,197,0,60,257
"./Ship3_Latin-square/2019-09-04_12h08m_Subject 46882.txt","46882",2019-09-04,"12:08",83,60,11,12,23,16,0,1,17,109,15,29,153,873,143,181,1197
"./Ship3_Latin-square/2019-09-04_12h08m_Subject 46883.txt","46883",2019-09-04,"12:08",84,60,11,13,24,66,23,16,105,41,23,70,134,333,58,96,487
"./Ship3_Latin-square/2019-09-04_12h08m_Subject 46894.txt","46894",2019-09-04,"12:08",76,60,6,10,16,43,9,3,55,24,3,5,32,423,50,70,543
"./Ship3_Latin-square/2019-09-04_12h08m_Subject 47088.txt","47088",2019-09-04,"12:08",76,60,7,9,16,30,4,4,38,71,12,15,98,665,85,103,853
"./Ship3_Latin-square/2019-09-04_12h08m_Subject 47228.txt","47228",2019-09-04,"12:08",79,60,8,11,19,42,5,10,57,24,5,9,38,454,88,61,603
"./Ship3_Latin-square/2019-09-04_12h08m_Subject 47243.txt","47243",2019-09-04,"12:08",84,60,7,17,24,52,7,6,65,31,8,18,57,657,67,216,940
"./Ship3_Latin-square/2019-09-04_12h08m_Subject 47249.txt","47249",2019-09-04,"12:08",81,60,12,9,21,58,8,11,77,100,69,15,184,272,46,45,363
"./Ship3_Latin-square/2019-09-04_12h08m_Subject 47639.txt","47639",2019-09-04,"12:08",78,60,8,10,18,35,2,1,38,8,0,9,17,757,105,114,976
"./Ship3_Latin-square/2019-09-04_12h08m_Subject 47649.txt","47649",2019-09-04,"12:08",74,54,9,11,20,48,7,10,65,32,12,21,65,262,25,57,344
"./Ship3_Latin-square/2019-09-04_12h08m_Subject 47758.txt","47758",2019-09-04,"12:08",79,60,9,10,19,10,1,5,16,22,1,9,32,651,82,136,869
"./Ship3_Latin-square/2019-09-04_12h08m_Subject 47759.txt","47759",2019-09-04,"12:08",83,60,12,11,23,21,0,6,27,27,7,15,49,442,55,90,587
"./Ship3_Latin-square/2019-09-04_12h08m_Subject 47776.txt","47776",2019-09-04,"12:08",82,60,5,17,22,36,2,3,41,75,9,35,119,930,73,254,1257
"./Ship3_Latin-square/2019-09-04_12h08m_Subject 47799.txt","47799",2019-09-04,"12:08",77,60,6,11,17,9,1,2,12,65,18,15,98,413,38,101,552
"./Ship3_Latin-square/2019-09-04_13h16m_Subject 46876.txt","46876",2019-09-04,"13:16",56,43,11,2,13,74,10,4,88,10,4,2,16,187,1,8,196
"./Ship3_Latin-square/2019-09-04_13h16m_Subject 46877.txt","46877",2019-09-04,"13:16",84,60,14,10,24,29,2,8,39,47,17,46,110,705,167,142,1014
"./Ship3_Latin-square/2019-09-04_13h16m_Subject 46893.txt","46893",2019-09-04,"13:16",79,60,7,12,19,14,2,1,17,53,4,10,67,861,110,223,1194
"./Ship3_Latin-square/2019-09-04_13h16m_Subject 46895.txt","46895",2019-09-04,"13:16",58,43,11,4,15,94,28,12,134,81,24,6,111,185,27,13,225
"./Ship3_Latin-square/2019-09-04_13h16m_Subject 47638.txt","47638",2019-09-04,"13:16",82,60,9,13,22,63,10,16,89,35,14,54,103,485,91,68,644
"./Ship3_Latin-square/2019-09-04_13h16m_Subject 47757.txt","47757",2019-09-04,"13:16",73,57,9,7,16,79,15,11,105,41,10,11,62,332,52,58,442
"./Ship3_Latin-square/2019-09-04_13h16m_Subject 47769.txt","47769",2019-09-04,"13:16",84,60,14,10,24,20,2,3,25,37,19,29,85,862,186,131,1179
"./Ship3_Latin-square/2019-09-04_13h16m_Subject 47771.txt","47771",2019-09-04,"13:16",84,60,10,14,24,18,2,7,27,26,6,23,55,696,112,160,968
"./Ship3_Latin-square/2019-09-04_13h16m_Subject 47775.txt","47775",2019-09-04,"13:16",83,60,13,10,23,77,10,11,98,69,22,3,94,465,100,77,642
"./Ship3_Latin-square/2019-09-04_13h16m_Subject 47781.txt","47781",2019-09-04,"13:16",80,60,9,11,20,24,3,2,29,61,10,10,81,1063,153,234,1450
"./Ship3_Latin-square/2019-09-04_13h16m_Subject 47782.txt","47782",2019-09-04,"13:16",78,60,8,10,18,40,2,9,51,5,16,3,24,609,56,160,825
"./Ship3_Latin-square/2019-09-04_13h16m_Subject 47783.txt","47783",2019-09-04,"13:16",82,60,10,12,22,60,4,4,68,50,11,20,81,700,138,158,996
"./Ship3_Latin-square/2019-09-04_13h16m_Subject 47785.txt","47785",2019-09-04,"13:16",81,60,8,13,21,14,7,6,27,20,8,14,42,1007,109,203,1319
"./Ship3_Latin-square/2019-09-04_13h16m_Subject 47788.txt","47788",2019-09-04,"13:16",80,60,9,11,20,48,6,7,61,87,30,25,142,409,59,110,578
"./Ship3_Latin-square/2019-09-04_13h19m_Subject 46888.txt","46888",2019-09-04,"13:19",76,60,8,8,16,13,0,3,16,117,11,14,142,720,88,111,919
"./Ship3_Latin-square/2019-09-04_13h19m_Subject 46889.txt","46889",2019-09-04,"13:19",79,60,3,16,19,26,0,4,30,27,4,9,40,921,65,261,1247
"./Ship3_Latin-square/2019-09-04_13h19m_Subject 46892.txt","46892",2019-09-04,"13:19",84,60,12,12,24,15,1,5,21,14,4,6,24,723,155,180,1058
"./Ship3_Latin-square/2019-09-04_13h19m_Subject 46898.txt","46898",2019-09-04,"13:19",81,60,15,6,21,53,27,7,87,73,41,39,153,500,144,76,720
"./Ship3_Latin-square/2019-09-04_13h19m_Subject 47097.txt","47097",2019-09-04,"13:19",80,60,9,11,20,13,1,3,17,87,28,42,157,723,85,143,951
"./Ship3_Latin-square/2019-09-04_13h19m_Subject 47099.txt","47099",2019-09-04,"13:19",80,60,10,10,20,24,4,1,29,31,1,2,34,780,88,177,1045
"./Ship3_Latin-square/2019-09-04_13h19m_Subject 47798.txt","47798",2019-09-04,"13:19",84,60,3,21,24,32,0,11,43,29,2,9,40,241,12,100,353
"./Ship3_Latin-square/2019-09-04_14h35m_Subject 47080.txt","47080",2019-09-04,"14:35",80,60,7,13,20,28,1,4,33,14,2,4,20,395,43,90,528
"./Ship3_Latin-square/2019-09-04_14h35m_Subject 47089.txt","47089",2019-09-04,"14:35",65,48,10,7,17,54,4,3,61,80,28,22,130,161,32,22,215
"./Ship3_Latin-square/2019-09-04_14h35m_Subject 47762.txt","47762",2019-09-04,"14:35",80,60,10,10,20,55,3,13,71,18,4,7,29,264,32,56,352
"./Ship3_Latin-square/2019-09-04_14h35m_Subject 47791.txt","47791",2019-09-04,"14:35",85,60,15,10,25,51,20,9,80,47,26,16,89,282,3,38,323
"./Ship3_Latin-square/2019-09-05_10h05m_Subject 46878.txt","46878",2019-09-05,"10:05",80,60,9,11,20,20,6,7,33,70,10,12,92,558,48,187,793
"./Ship3_Latin-square/2019-09-05_10h05m_Subject 46885.txt","46885",2019-09-05,"10:05",69,51,13,5,18,135,31,21,187,18,15,14,47,188,4,18,210
"./Ship3_Latin-square/2019-09-05_10h05m_Subject 46899.txt","46899",2019-09-05,"10:05",82,60,10,12,22,53,10,8,71,37,10,14,61,662,111,157,930
"./Ship3_Latin-square/2019-09-05_10h05m_Subject 47081.txt","47081",2019-09-05,"10:05",82,60,11,11,22,94,15,3,112,143,3,51,197,578,96,147,821
"./Ship3_Latin-square/2019-09-05_10h05m_Subject 47091.txt","47091",2019-09-05,"10:05",79,60,5,14,19,53,2,6,61,78,9,26,113,507,51,106,664
"./Ship3_Latin-square/2019-09-05_10h05m_Subject 47231.txt","47231",2019-09-05,"10:05",84,59,6,19,25,59,4,18,81,40,12,17,69,346,29,145,520
"./Ship3_Latin-square/2019-09-05_10h05m_Subject 47238.txt","47238",2019-09-05,"10:05",81,60,9,12,21,29,0,2,31,83,8,37,128,563,96,157,816
"./Ship3_Latin-square/2019-09-05_10h05m_Subject 47242.txt","47242",2019-09-05,"10:05",77,60,6,11,17,51,0,7,58,84,9,32,125,565,58,136,759
"./Ship3_Latin-square/2019-09-05_10h05m_Subject 47244.txt","47244",2019-09-05,"10:05",59,45,11,3,14,74,7,8,89,132,32,28,192,340,5,18,363
"./Ship3_Latin-square/2019-09-05_10h05m_Subject 47633.txt","47633",2019-09-05,"10:05",80,60,10,10,20,113,11,23,147,84,20,26,130,330,38,69,437
"./Ship3_Latin-square/2019-09-05_10h05m_Subject 47636.txt","47636",2019-09-05,"10:05",79,60,11,8,19,149,10,16,175,162,61,12,235,366,71,62,499
"./Ship3_Latin-square/2019-09-05_10h05m_Subject 47752.txt","47752",2019-09-05,"10:05",84,60,9,15,24,44,7,11,62,41,20,51,112,788,84,223,1095
"./Ship3_Latin-square/2019-09-05_10h05m_Subject 47767.txt","47767",2019-09-05,"10:05",82,60,14,8,22,43,5,7,55,22,28,6,56,366,69,62,497
"./Ship3_Latin-square/2019-09-05_10h05m_Subject 47768.txt","47768",2019-09-05,"10:05",84,60,13,11,24,78,10,4,92,51,8,14,73,503,142,73,718
"./Ship3_Latin-square/2019-09-05_10h05m_Subject 47780.txt","47780",2019-09-05,"10:05",77,60,8,9,17,68,9,8,85,53,26,47,126,328,39,72,439
"./Ship3_Latin-square/2019-09-05_10h08m_Subject 46884.txt","46884",2019-09-05,"10:08",35,27,3,5,8,48,1,2,51,61,0,5,66,244,26,65,335
"./Ship3_Latin-square/2019-09-05_10h08m_Subject 47083.txt","47083",2019-09-05,"10:08",34,24,10,0,10,45,10,0,55,19,45,0,64,186,3,0,189
"./Ship3_Latin-square/2019-09-05_10h08m_Subject 47086.txt","47086",2019-09-05,"10:08",37,28,5,4,9,36,2,2,40,57,16,3,76,227,23,50,300
"./Ship3_Latin-square/2019-09-05_10h08m_Subject 47246.txt","47246",2019-09-05,"10:08",38,28,0,10,10,33,0,4,37,14,0,23,37,305,0,101,406
"./Ship3_Latin-square/2019-09-05_10h08m_Subject 47635.txt","47635",2019-09-05,"10:08",40,33,2,5,7,32,0,5,37,36,4,5,45,262,10,56,328
"./Ship3_Latin-square/2019-09-05_10h08m_Subject 47779.txt","47779",2019-09-05,"10:08",34,24,7,3,10,23,1,6,30,25,11,2,38,90,7,20,117
"./Ship3_Latin-square/2019-09-05_10h08m_Subject 47797.txt","47797",2019-09-05,"10:08",19,16,1,2,3,45,1,2,48,20,0,2,22,46,0,23,69
"./Ship3_Latin-square/2019-09-05_11h33m_Subject 46900.txt","46900",2019-09-05,"11:33",83,60,10,13,23,81,28,2,111,67,15,9,91,794,144,162,1100
"./Ship3_Latin-square/2019-09-05_11h33m_Subject 47076.txt","47076",2019-09-05,"11:33",79,60,10,9,19,26,2,1,29,32,6,14,52,634,92,146,872
"./Ship3_Latin-square/2019-09-05_11h33m_Subject 47079.txt","47079",2019-09-05,"11:33",66,49,13,4,17,71,11,3,85,45,10,3,58,159,2,16,177
"./Ship3_Latin-square/2019-09-05_11h33m_Subject 47082.txt","47082",2019-09-05,"11:33",79,60,8,11,19,44,17,6,67,72,4,28,104,418,44,75,537
"./Ship3_Latin-square/2019-09-05_11h33m_Subject 47092.txt","47092",2019-09-05,"11:33",69,52,9,8,17,178,5,54,237,73,17,23,113,260,0,51,311
"./Ship3_Latin-square/2019-09-05_11h33m_Subject 47226.txt","47226",2019-09-05,"11:33",83,60,7,16,23,33,7,9,49,35,1,26,62,509,39,180,728
"./Ship3_Latin-square/2019-09-05_11h33m_Subject 47227.txt","47227",2019-09-05,"11:33",80,60,7,13,20,38,1,4,43,24,15,13,52,496,75,87,658
"./Ship3_Latin-square/2019-09-05_11h33m_Subject 47250.txt","47250",2019-09-05,"11:33",80,60,9,11,20,20,5,7,32,14,1,17,32,1017,129,228,1374
"./Ship3_Latin-square/2019-09-05_11h33m_Subject 47646.txt","47646",2019-09-05,"11:33",80,60,7,13,20,68,3,9,80,66,10,36,112,607,47,207,861
"./Ship3_Latin-square/2019-09-05_11h33m_Subject 47755.txt","47755",2019-09-05,"11:33",82,60,5,17,22,38,1,5,44,58,4,19,81,816,66,194,1076
"./Ship3_Latin-square/2019-09-05_11h33m_Subject 47760.txt","47760",2019-09-05,"11:33",86,60,15,11,26,96,12,34,142,82,23,14,119,316,0,92,408
"./Ship3_Latin-square/2019-09-05_11h33m_Subject 47770.txt","47770",2019-09-05,"11:33",56,40,10,6,16,62,26,10,98,61,30,10,101,151,24,26,201
"./Ship3_Latin-square/2019-09-05_11h33m_Subject 47795.txt","47795",2019-09-05,"11:33",81,60,7,14,21,34,3,4,41,17,3,11,31,484,57,142,683
"./Ship3_Latin-square/2019-09-05_11h36m_Subject 47229.txt","47229",2019-09-05,"11:36",78,60,6,12,18,24,0,4,28,54,9,19,82,915,121,137,1173
"./Ship3_Latin-square/2019-09-05_11h36m_Subject 47233.txt","47233",2019-09-05,"11:36",78,60,6,12,18,65,5,10,80,73,9,9,91,521,45,115,681
"./Ship3_Latin-square/2019-09-05_11h36m_Subject 47234.txt","47234",2019-09-05,"11:36",73,51,14,8,22,105,43,37,185,208,88,67,363,369,137,73,579
"./Ship3_Latin-square/2019-09-05_11h36m_Subject 47241.txt","47241",2019-09-05,"11:36",80,60,4,16,20,51,1,7,59,12,1,11,24,639,43,234,916
"./Ship3_Latin-square/2019-09-05_11h36m_Subject 47247.txt","47247",2019-09-05,"11:36",67,52,10,5,15,115,10,18,143,73,17,5,95,160,2,32,194
"./Ship3_Latin-square/2019-09-05_11h36m_Subject 47777.txt","47777",2019-09-05,"11:36",76,60,7,9,16,33,0,6,39,16,3,8,27,505,59,79,643
"./Ship3_Latin-square/2019-09-05_11h36m_Subject 47784.txt","47784",2019-09-05,"11:36",72,52,16,4,20,191,38,16,245,78,15,7,100,447,0,39,486
"./Ship3_Latin-square/2019-09-05_12h42m_Subject 46880.txt","46880",2019-09-05,"12:42",82,60,11,11,22,24,2,3,29,36,9,13,58,497,93,83,673
"./Ship3_Latin-square/2019-09-05_12h42m_Subject 46882.txt","46882",2019-09-05,"12:42",76,60,8,8,16,14,0,1,15,58,9,10,77,872,77,159,1108
"./Ship3_Latin-square/2019-09-05_12h42m_Subject 46883.txt","46883",2019-09-05,"12:42",83,60,13,10,23,49,12,7,68,34,14,10,58,404,49,93,546
"./Ship3_Latin-square/2019-09-05_12h42m_Subject 46894.txt","46894",2019-09-05,"12:42",81,60,10,11,21,35,4,9,48,16,1,13,30,293,43,49,385
"./Ship3_Latin-square/2019-09-05_12h42m_Subject 47088.txt","47088",2019-09-05,"12:42",81,60,15,6,21,87,24,5,116,86,37,10,133,266,0,68,334
"./Ship3_Latin-square/2019-09-05_12h42m_Subject 47228.txt","47228",2019-09-05,"12:42",79,60,8,11,19,29,4,4,37,23,6,9,38,510,61,76,647
"./Ship3_Latin-square/2019-09-05_12h42m_Subject 47243.txt","47243",2019-09-05,"12:42",82,60,12,10,22,44,7,13,64,48,5,10,63,633,114,122,869
"./Ship3_Latin-square/2019-09-05_12h42m_Subject 47249.txt","47249",2019-09-05,"12:42",76,55,14,7,21,89,23,21,133,86,70,13,169,212,18,40,270
"./Ship3_Latin-square/2019-09-05_12h42m_Subject 47639.txt","47639",2019-09-05,"12:42",78,60,9,9,18,23,1,4,28,14,2,4,20,581,68,118,767
"./Ship3_Latin-square/2019-09-05_12h42m_Subject 47649.txt","47649",2019-09-05,"12:42",79,60,9,10,19,40,4,10,54,37,5,18,60,483,81,89,653
"./Ship3_Latin-square/2019-09-05_12h42m_Subject 47758.txt","47758",2019-09-05,"12:42",78,60,13,5,18,76,5,9,90,21,11,1,33,501,0,70,571
"./Ship3_Latin-square/2019-09-05_12h42m_Subject 47759.txt","47759",2019-09-05,"12:42",78,56,14,8,22,78,9,20,107,52,19,56,127,226,2,46,274
"./Ship3_Latin-square/2019-09-05_12h42m_Subject 47776.txt","47776",2019-09-05,"12:42",78,60,6,12,18,27,2,1,30,69,8,20,97,858,69,223,1150
"./Ship3_Latin-square/2019-09-05_12h42m_Subject 47799.txt","47799",2019-09-05,"12:42",85,60,12,13,25,73,4,21,98,72,61,31,164,229,3,95,327
"./Ship3_Latin-square/2019-09-05_12h45m_Subject 46881.txt","46881",2019-09-05,"12:45",80,60,10,10,20,49,17,4,70,48,4,27,79,474,81,96,651
"./Ship3_Latin-square/2019-09-05_12h45m_Subject 47087.txt","47087",2019-09-05,"12:45",80,60,8,12,20,45,11,9,65,87,14,9,110,429,70,105,604
"./Ship3_Latin-square/2019-09-05_12h45m_Subject 47626.txt","47626",2019-09-05,"12:45",82,60,12,10,22,122,8,15,145,61,26,23,110,324,49,55,428
"./Ship3_Latin-square/2019-09-05_12h45m_Subject 47634.txt","47634",2019-09-05,"12:45",81,60,10,11,21,66,8,16,90,52,14,19,85,585,65,151,801
"./Ship3_Latin-square/2019-09-05_12h45m_Subject 47640.txt","47640",2019-09-05,"12:45",82,60,12,10,22,38,5,5,48,19,9,4,32,887,134,226,1247
"./Ship3_Latin-square/2019-09-05_12h45m_Subject 47754.txt","47754",2019-09-05,"12:45",76,60,7,9,16,48,3,4,55,45,8,31,84,334,47,61,442
"./Ship3_Latin-square/2019-09-05_12h45m_Subject 47800.txt","47800",2019-09-05,"12:45",81,60,11,10,21,45,10,2,57,55,13,18,86,572,78,89,739
"./Ship3_Latin-square/2019-09-05_14h00m_Subject 46876.txt","46876",2019-09-05,"14:00",76,60,8,8,16,57,7,3,67,39,6,6,51,427,51,63,541
"./Ship3_Latin-square/2019-09-05_14h00m_Subject 46877.txt","46877",2019-09-05,"14:00",87,60,10,17,27,105,23,4,132,149,16,155,320,1066,175,339,1580
"./Ship3_Latin-square/2019-09-05_14h00m_Subject 46893.txt","46893",2019-09-05,"14:00",78,60,9,9,18,16,0,0,16,44,3,7,54,801,94,199,1094
"./Ship3_Latin-square/2019-09-05_14h00m_Subject 46895.txt","46895",2019-09-05,"14:00",80,55,6,19,25,50,7,16,73,29,16,13,58,367,24,133,524
"./Ship3_Latin-square/2019-09-05_14h00m_Subject 47638.txt","47638",2019-09-05,"14:00",77,60,9,8,17,54,10,9,73,51,10,23,84,291,38,40,369
"./Ship3_Latin-square/2019-09-05_14h00m_Subject 47757.txt","47757",2019-09-05,"14:00",71,50,14,7,21,122,26,21,169,48,15,12,75,217,17,44,278
"./Ship3_Latin-square/2019-09-05_14h00m_Subject 47769.txt","47769",2019-09-05,"14:00",82,60,12,10,22,38,2,7,47,39,16,14,69,621,108,175,904
"./Ship3_Latin-square/2019-09-05_14h00m_Subject 47771.txt","47771",2019-09-05,"14:00",82,60,9,13,22,21,3,0,24,26,1,18,45,965,114,205,1284
"./Ship3_Latin-square/2019-09-05_14h00m_Subject 47775.txt","47775",2019-09-05,"14:00",81,60,7,14,21,64,6,13,83,10,6,4,20,455,55,104,614
"./Ship3_Latin-square/2019-09-05_14h00m_Subject 47781.txt","47781",2019-09-05,"14:00",80,60,9,11,20,25,3,3,31,50,22,25,97,906,74,209,1189
"./Ship3_Latin-square/2019-09-05_14h00m_Subject 47782.txt","47782",2019-09-05,"14:00",77,60,12,5,17,57,5,5,67,22,24,3,49,472,1,51,524
"./Ship3_Latin-square/2019-09-05_14h00m_Subject 47783.txt","47783",2019-09-05,"14:00",83,60,12,11,23,47,12,10,69,47,10,11,68,584,122,126,832
"./Ship3_Latin-square/2019-09-05_14h00m_Subject 47785.txt","47785",2019-09-05,"14:00",82,60,11,11,22,21,4,3,28,31,11,22,64,890,172,167,1229
"./Ship3_Latin-square/2019-09-05_14h00m_Subject 47786.txt","47786",2019-09-05,"14:00",74,51,8,15,23,102,21,48,171,87,10,124,221,378,51,204,633
"./Ship3_Latin-square/2019-09-05_14h00m_Subject 47788.txt","47788",2019-09-05,"14:00",87,60,16,11,27,97,12,33,142,95,33,16,144,257,3,71,331
"./Ship3_Latin-square/2019-09-05_14h03m_Subject 46888.txt","46888",2019-09-05,"14:03",83,60,2,21,23,27,1,5,33,87,9,54,150,1076,36,388,1500
"./Ship3_Latin-square/2019-09-05_14h03m_Subject 46889.txt","46889",2019-09-05,"14:03",80,60,13,7,20,99,16,14,129,35,10,4,49,408,10,62,480
"./Ship3_Latin-square/2019-09-05_14h03m_Subject 46892.txt","46892",2019-09-05,"14:03",86,60,16,10,26,50,31,12,93,38,29,6,73,468,21,112,601
"./Ship3_Latin-square/2019-09-05_14h03m_Subject 46898.txt","46898",2019-09-05,"14:03",83,60,4,19,23,36,2,15,53,32,5,29,66,412,24,148,584
"./Ship3_Latin-square/2019-09-05_14h03m_Subject 47097.txt","47097",2019-09-05,"14:03",81,60,10,11,21,16,3,1,20,72,13,16,101,761,107,173,1041
"./Ship3_Latin-square/2019-09-05_14h03m_Subject 47099.txt","47099",2019-09-05,"14:03",79,60,13,6,19,111,7,20,138,55,34,8,97,412,1,65,478
"./Ship3_Latin-square/2019-09-05_14h03m_Subject 47798.txt","47798",2019-09-05,"14:03",73,53,14,6,20,25,11,3,39,21,18,4,43,192,25,24,241
"./Ship3_Latin-square/2019-09-05_15h10m_Subject 47080.txt","47080",2019-09-05,"15:10",80,60,10,10,20,37,3,2,42,17,1,7,25,482,66,92,640
"./Ship3_Latin-square/2019-09-05_15h10m_Subject 47089.txt","47089",2019-09-05,"15:10",85,60,12,13,25,61,3,9,73,101,50,32,183,407,49,108,564
"./Ship3_Latin-square/2019-09-05_15h10m_Subject 47762.txt","47762",2019-09-05,"15:10",81,60,7,14,21,44,5,14,63,40,5,19,64,325,44,90,459
"./Ship3_Latin-square/2019-09-05_15h10m_Subject 47791.txt","47791",2019-09-05,"15:10",78,60,9,9,18,30,4,12,46,54,12,19,85,714,90,123,927
"./Ship3_Latin-square/2019-09-06_10h00m_Subject 46878.txt","46878",2019-09-06,"10:00",84,60,10,14,24,83,1,1,85,66,24,45,135,832,172,179,1183
"./Ship3_Latin-square/2019-09-06_10h00m_Subject 46885.txt","46885",2019-09-06,"10:00",80,58,10,12,22,86,23,17,126,22,21,36,79,295,43,78,416
"./Ship3_Latin-square/2019-09-06_10h00m_Subject 46899.txt","46899",2019-09-06,"10:00",84,60,14,10,24,130,14,39,183,64,8,8,80,342,2,96,440
"./Ship3_Latin-square/2019-09-06_10h00m_Subject 47081.txt","47081",2019-09-06,"10:00",77,60,6,11,17,53,2,8,63,55,14,22,91,316,35,73,424
"./Ship3_Latin-square/2019-09-06_10h00m_Subject 47091.txt","47091",2019-09-06,"10:00",68,52,9,7,16,134,11,25,170,88,17,77,182,181,4,26,211
"./Ship3_Latin-square/2019-09-06_10h00m_Subject 47231.txt","47231",2019-09-06,"10:00",59,44,11,4,15,81,8,10,99,32,30,7,69,103,4,9,116
"./Ship3_Latin-square/2019-09-06_10h00m_Subject 47238.txt","47238",2019-09-06,"10:00",78,60,3,15,18,49,0,2,51,75,10,34,119,373,16,105,494
"./Ship3_Latin-square/2019-09-06_10h00m_Subject 47242.txt","47242",2019-09-06,"10:00",84,60,10,14,24,48,4,2,54,65,12,26,103,827,147,175,1149
"./Ship3_Latin-square/2019-09-06_10h00m_Subject 47244.txt","47244",2019-09-06,"10:00",81,60,9,12,21,61,7,7,75,122,24,18,164,638,99,131,868
"./Ship3_Latin-square/2019-09-06_10h00m_Subject 47633.txt","47633",2019-09-06,"10:00",78,60,10,8,18,40,5,4,49,92,17,33,142,456,90,79,625
"./Ship3_Latin-square/2019-09-06_10h00m_Subject 47636.txt","47636",2019-09-06,"10:00",75,55,13,7,20,132,18,12,162,72,23,11,106,287,33,43,363
"./Ship3_Latin-square/2019-09-06_10h00m_Subject 47752.txt","47752",2019-09-06,"10:00",84,60,15,9,24,91,19,14,124,57,29,1,87,354,22,141,517
"./Ship3_Latin-square/2019-09-06_10h00m_Subject 47767.txt","47767",2019-09-06,"10:00",82,60,9,13,22,79,6,10,95,19,13,8,40,231,32,50,313
"./Ship3_Latin-square/2019-09-06_10h00m_Subject 47768.txt","47768",2019-09-06,"10:00",70,54,10,6,16,119,17,21,157,96,16,8,120,204,22,42,268
"./Ship3_Latin-square/2019-09-06_10h00m_Subject 47780.txt","47780",2019-09-06,"10:00",77,57,8,12,20,102,9,9,120,79,29,21,129,325,32,84,441
"./Ship3_Latin-square/2019-09-06_10h05m_Subject 46884.txt","46884",2019-09-06,"10:05",81,60,11,10,21,38,6,53,97,75,24,5,104,277,67,53,397
"./Ship3_Latin-square/2019-09-06_10h05m_Subject 47083.txt","47083",2019-09-06,"10:05",55,39,9,7,16,116,18,30,164,76,41,26,143,193,33,42,268
"./Ship3_Latin-square/2019-09-06_10h05m_Subject 47086.txt","47086",2019-09-06,"10:05",82,60,7,15,22,72,10,10,92,116,36,41,193,399,36,143,578
"./Ship3_Latin-square/2019-09-06_10h05m_Subject 47246.txt","47246",2019-09-06,"10:05",80,60,8,12,20,90,9,7,106,71,18,12,101,398,54,76,528
"./Ship3_Latin-square/2019-09-06_10h05m_Subject 47635.txt","47635",2019-09-06,"10:05",79,60,7,12,19,62,2,9,73,66,11,14,91,509,53,100,662
"./Ship3_Latin-square/2019-09-06_10h05m_Subject 47779.txt","47779",2019-09-06,"10:05",81,60,11,10,21,39,5,12,56,55,11,3,69,276,55,62,393
"./Ship3_Latin-square/2019-09-06_10h05m_Subject 47797.txt","47797",2019-09-06,"10:05",31,22,1,8,9,40,1,9,50,22,0,2,24,69,8,18,95
"./Ship3_Latin-square/2019-09-06_11h36m_Subject 46900.txt","46900",2019-09-06,"11:36",81,60,12,9,21,22,3,7,32,75,28,20,123,628,127,129,884
"./Ship3_Latin-square/2019-09-06_11h36m_Subject 46986.txt","46986",2019-09-06,"11:36",37,26,11,0,11,156,22,0,178,24,138,0,162,120,35,0,155
"./Ship3_Latin-square/2019-09-06_11h36m_Subject 47076.txt","47076",2019-09-06,"11:36",80,58,9,13,22,31,4,5,40,23,9,33,65,531,72,155,758
"./Ship3_Latin-square/2019-09-06_11h36m_Subject 47079.txt","47079",2019-09-06,"11:36",78,60,10,8,18,36,9,5,50,70,12,9,91,318,52,51,421
"./Ship3_Latin-square/2019-09-06_11h36m_Subject 47082.txt","47082",2019-09-06,"11:36",81,60,8,13,21,102,9,3,114,74,5,80,159,409,57,88,554
"./Ship3_Latin-square/2019-09-06_11h36m_Subject 47092.txt","47092",2019-09-06,"11:36",78,60,8,10,18,28,3,4,35,90,19,27,136,651,88,120,859
"./Ship3_Latin-square/2019-09-06_11h36m_Subject 47226.txt","47226",2019-09-06,"11:36",78,60,6,12,18,30,7,18,55,55,11,18,84,708,69,132,909
"./Ship3_Latin-square/2019-09-06_11h36m_Subject 47227.txt","47227",2019-09-06,"11:36",81,60,8,13,21,49,4,5,58,14,12,13,39,511,53,102,666
"./Ship3_Latin-square/2019-09-06_11h36m_Subject 47250.txt","47250",2019-09-06,"11:36",79,60,10,9,19,23,2,3,28,9,9,1,19,656,47,122,825
"./Ship3_Latin-square/2019-09-06_11h36m_Subject 47645.txt","47645",2019-09-06,"11:36",36,24,12,0,12,106,80,0,186,15,32,0,47,103,51,0,154
"./Ship3_Latin-square/2019-09-06_11h36m_Subject 47646.txt","47646",2019-09-06,"11:36",81,60,8,13,21,44,2,13,59,68,11,9,88,1031,145,256,1432
"./Ship3_Latin-square/2019-09-06_11h36m_Subject 47755.txt","47755",2019-09-06,"11:36",64,47,9,8,17,210,12,40,262,76,19,29,124,191,5,64,260
"./Ship3_Latin-square/2019-09-06_11h36m_Subject 47760.txt","47760",2019-09-06,"11:36",82,60,9,13,22,70,5,16,91,72,14,30,116,657,127,183,967
"./Ship3_Latin-square/2019-09-06_11h36m_Subject 47770.txt","47770",2019-09-06,"11:36",61,49,6,6,12,97,2,6,105,67,13,10,90,217,44,20,281
"./Ship3_Latin-square/2019-09-06_11h36m_Subject 47795.txt","47795",2019-09-06,"11:36",86,60,4,22,26,25,3,9,37,18,3,18,39,306,16,139,461
"./Ship3_Latin-square/2019-09-06_11h40m_Subject 47229.txt","47229",2019-09-06,"11:40",79,60,10,9,19,11,2,4,17,43,11,12,66,808,135,113,1056
"./Ship3_Latin-square/2019-09-06_11h40m_Subject 47233.txt","47233",2019-09-06,"11:40",84,60,10,14,24,22,4,4,30,67,6,24,97,489,70,130,689
"./Ship3_Latin-square/2019-09-06_11h40m_Subject 47234.txt","47234",2019-09-06,"11:40",79,60,12,7,19,108,25,9,142,96,26,7,129,404,79,60,543
"./Ship3_Latin-square/2019-09-06_11h40m_Subject 47241.txt","47241",2019-09-06,"11:40",87,60,0,27,27,22,0,10,32,13,0,10,23,835,0,241,1076
"./Ship3_Latin-square/2019-09-06_11h40m_Subject 47247.txt","47247",2019-09-06,"11:40",80,60,8,12,20,34,4,9,47,45,13,5,63,435,49,100,584
"./Ship3_Latin-square/2019-09-06_11h40m_Subject 47777.txt","47777",2019-09-06,"11:40",83,59,3,21,24,44,2,12,58,19,0,25,44,523,28,181,732
"./Ship3_Latin-square/2019-09-06_11h40m_Subject 47784.txt","47784",2019-09-06,"11:40",75,60,3,12,15,38,0,9,47,45,0,33,78,1016,35,202,1253
"./Ship3_Latin-square/2019-09-06_12h52m_Subject 46880.txt","46880",2019-09-06,"12:52",84,60,12,12,24,18,5,3,26,60,22,8,90,396,98,88,582
"./Ship3_Latin-square/2019-09-06_12h52m_Subject 46882.txt","46882",2019-09-06,"12:52",83,60,9,14,23,31,1,2,34,135,36,22,193,955,139,250,1344
"./Ship3_Latin-square/2019-09-06_12h52m_Subject 46883.txt","46883",2019-09-06,"12:52",64,44,8,12,20,80,29,7,116,76,71,73,220,237,45,59,341
"./Ship3_Latin-square/2019-09-06_12h52m_Subject 46894.txt","46894",2019-09-06,"12:52",66,48,9,9,18,99,11,23,133,44,20,5,69,118,1,49,168
"./Ship3_Latin-square/2019-09-06_12h52m_Subject 47088.txt","47088",2019-09-06,"12:52",67,49,13,5,18,109,22,11,142,112,31,74,217,230,45,40,315
"./Ship3_Latin-square/2019-09-06_12h52m_Subject 47228.txt","47228",2019-09-06,"12:52",84,58,12,14,26,78,6,30,114,64,40,23,127,167,15,83,265
"./Ship3_Latin-square/2019-09-06_12h52m_Subject 47243.txt","47243",2019-09-06,"12:52",68,51,12,5,17,211,11,29,251,88,18,4,110,311,6,36,353
"./Ship3_Latin-square/2019-09-06_12h52m_Subject 47249.txt","47249",2019-09-06,"12:52",76,56,15,5,20,66,22,8,96,113,43,19,175,220,49,28,297
"./Ship3_Latin-square/2019-09-06_12h52m_Subject 47639.txt","47639",2019-09-06,"12:52",84,60,16,8,24,64,21,13,98,44,25,6,75,401,5,86,492
"./Ship3_Latin-square/2019-09-06_12h52m_Subject 47649.txt","47649",2019-09-06,"12:52",84,60,16,8,24,89,7,11,107,61,5,15,81,297,0,54,351
"./Ship3_Latin-square/2019-09-06_12h52m_Subject 47758.txt","47758",2019-09-06,"12:52",80,60,11,9,20,49,4,9,62,68,63,9,140,303,31,74,408
"./Ship3_Latin-square/2019-09-06_12h52m_Subject 47759.txt","47759",2019-09-06,"12:52",81,58,11,12,23,154,24,12,190,93,23,175,291,310,25,96,431
"./Ship3_Latin-square/2019-09-06_12h52m_Subject 47776.txt","47776",2019-09-06,"12:52",77,60,11,6,17,71,5,11,87,64,29,6,99,585,1,91,677
"./Ship3_Latin-square/2019-09-06_12h52m_Subject 47799.txt","47799",2019-09-06,"12:52",78,60,10,8,18,82,13,4,99,116,50,9,175,315,40,58,413
"./Ship3_Latin-square/2019-09-06_12h55m_Subject 46881.txt","46881",2019-09-06,"12:55",78,60,6,12,18,29,1,1,31,16,1,6,23,577,60,141,778
"./Ship3_Latin-square/2019-09-06_12h55m_Subject 47087.txt","47087",2019-09-06,"12:55",80,60,7,13,20,44,6,7,57,63,4,30,97,499,55,95,649
"./Ship3_Latin-square/2019-09-06_12h55m_Subject 47626.txt","47626",2019-09-06,"12:55",77,60,9,8,17,29,4,1,34,109,33,8,150,315,37,41,393
"./Ship3_Latin-square/2019-09-06_12h55m_Subject 47634.txt","47634",2019-09-06,"12:55",82,60,12,10,22,87,13,16,116,49,9,24,82,364,71,76,511
"./Ship3_Latin-square/2019-09-06_12h55m_Subject 47640.txt","47640",2019-09-06,"12:55",79,60,9,10,19,34,7,4,45,26,11,8,45,665,69,158,892
"./Ship3_Latin-square/2019-09-06_12h55m_Subject 47754.txt","47754",2019-09-06,"12:55",46,32,8,6,14,74,12,10,96,38,12,34,84,94,0,18,112
"./Ship3_Latin-square/2019-09-06_12h55m_Subject 47800.txt","47800",2019-09-06,"12:55",78,60,11,7,18,56,14,6,76,78,20,9,107,453,73,68,594
"./Ship3_Latin-square/2019-09-06_14h05m_Subject 46876.txt","46876",2019-09-06,"14:05",78,60,8,10,18,45,4,5,54,17,8,20,45,324,48,69,441
"./Ship3_Latin-square/2019-09-06_14h05m_Subject 46877.txt","46877",2019-09-06,"14:05",86,60,13,13,26,42,2,18,62,80,16,25,121,713,91,267,1071
"./Ship3_Latin-square/2019-09-06_14h05m_Subject 46893.txt","46893",2019-09-06,"14:05",83,60,11,12,23,69,4,15,88,52,18,18,88,443,10,178,631
"./Ship3_Latin-square/2019-09-06_14h05m_Subject 46895.txt","46895",2019-09-06,"14:05",34,24,10,0,10,47,14,0,61,51,137,0,188,72,3,0,75
"./Ship3_Latin-square/2019-09-06_14h05m_Subject 47638.txt","47638",2019-09-06,"14:05",79,60,10,9,19,86,30,17,133,66,13,29,108,224,4,43,271
"./Ship3_Latin-square/2019-09-06_14h05m_Subject 47757.txt","47757",2019-09-06,"14:05",74,52,13,9,22,96,25,10,131,42,30,11,83,326,68,72,466
"./Ship3_Latin-square/2019-09-06_14h05m_Subject 47769.txt","47769",2019-09-06,"14:05",85,60,16,9,25,86,14,13,113,46,39,32,117,398,26,55,479
"./Ship3_Latin-square/2019-09-06_14h05m_Subject 47771.txt","47771",2019-09-06,"14:05",80,60,10,10,20,15,2,3,20,35,23,8,66,797,76,150,1023
"./Ship3_Latin-square/2019-09-06_14h05m_Subject 47775.txt","47775",2019-09-06,"14:05",84,60,9,15,24,104,7,26,137,20,7,20,47,311,44,94,449
"./Ship3_Latin-square/2019-09-06_14h05m_Subject 47781.txt","47781",2019-09-06,"14:05",81,60,7,14,21,17,2,0,19,52,8,17,77,1193,143,239,1575
"./Ship3_Latin-square/2019-09-06_14h05m_Subject 47782.txt","47782",2019-09-06,"14:05",80,60,12,8,20,33,8,9,50,12,8,5,25,535,50,83,668
"./Ship3_Latin-square/2019-09-06_14h05m_Subject 47783.txt","47783",2019-09-06,"14:05",81,60,9,12,21,33,5,5,43,48,12,14,74,709,105,202,1016
"./Ship3_Latin-square/2019-09-06_14h05m_Subject 47785.txt","47785",2019-09-06,"14:05",80,60,8,12,20,37,0,4,41,35,7,18,60,840,145,113,1098
"./Ship3_Latin-square/2019-09-06_14h05m_Subject 47786.txt","47786",2019-09-06,"14:05",81,60,9,12,21,47,9,9,65,36,34,23,93,499,31,170,700
"./Ship3_Latin-square/2019-09-06_14h05m_Subject 47788.txt","47788",2019-09-06,"14:05",79,60,11,8,19,49,18,7,74,77,25,10,112,401,46,82,529
"./Ship3_Latin-square/2019-09-06_14h10m_Subject 46888.txt","46888",2019-09-06,"14:10",79,60,8,11,19,25,0,1,26,49,13,15,77,895,75,211,1181
"./Ship3_Latin-square/2019-09-06_14h10m_Subject 46889.txt","46889",2019-09-06,"14:10",78,60,5,13,18,17,0,7,24,27,3,35,65,908,64,201,1173
"./Ship3_Latin-square/2019-09-06_14h10m_Subject 46892.txt","46892",2019-09-06,"14:10",85,60,13,12,25,37,53,10,100,27,9,5,41,555,69,139,763
"./Ship3_Latin-square/2019-09-06_14h10m_Subject 46898.txt","46898",2019-09-06,"14:10",80,60,7,13,20,35,1,3,39,36,10,5,51,545,51,100,696
"./Ship3_Latin-square/2019-09-06_14h10m_Subject 47097.txt","47097",2019-09-06,"14:10",82,60,9,13,22,42,3,2,47,108,17,43,168,851,114,206,1171
"./Ship3_Latin-square/2019-09-06_14h10m_Subject 47099.txt","47099",2019-09-06,"14:10",79,60,10,9,19,60,1,6,67,56,29,16,101,434,24,80,538
"./Ship3_Latin-square/2019-09-06_14h10m_Subject 47798.txt","47798",2019-09-06,"14:10",86,60,0,26,26,21,0,7,28,24,0,7,31,288,0,129,417
"./Ship3_Latin-square/2019-09-06_15h20m_Subject 47080.txt","47080",2019-09-06,"15:20",82,60,9,13,22,93,9,30,132,17,2,7,26,257,2,120,379
"./Ship3_Latin-square/2019-09-06_15h20m_Subject 47089.txt","47089",2019-09-06,"15:20",83,60,12,11,23,30,5,2,37,61,14,19,94,336,45,88,469
"./Ship3_Latin-square/2019-09-06_15h20m_Subject 47762.txt","47762",2019-09-06,"15:20",53,38,9,6,15,103,6,25,134,24,9,1,34,98,7,12,117
"./Ship3_Latin-square/2019-09-06_15h20m_Subject 47791.txt","47791",2019-09-06,"15:20",80,60,8,12,20,23,3,3,29,30,5,7,42,819,113,173,1105
"./Ship3_Latin-square/2019-09-07_09h46m_Subject 46884.txt","46884",2019-09-07,"09:46",77,56,10,11,21,38,6,5,49,35,8,17,60,250,73,42,365
"./Ship3_Latin-square/2019-09-07_09h46m_Subject 47083.txt","47083",2019-09-07,"09:46",73,55,8,10,18,69,13,1,83,64,21,23,108,261,38,67,366
"./Ship3_Latin-square/2019-09-07_09h46m_Subject 47086.txt","47086",2019-09-07,"09:46",83,60,10,13,23,41,3,7,51,82,7,20,109,399,78,65,542
"./Ship3_Latin-square/2019-09-07_09h46m_Subject 47246.txt","47246",2019-09-07,"09:46",82,60,4,18,22,48,2,5,55,26,12,9,47,322,26,118,466
"./Ship3_Latin-square/2019-09-07_09h46m_Subject 47635.txt","47635",2019-09-07,"09:46",81,60,10,11,21,75,7,20,102,84,13,15,112,220,6,78,304
"./Ship3_Latin-square/2019-09-07_09h46m_Subject 47779.txt","47779",2019-09-07,"09:46",54,38,11,5,16,39,4,8,51,18,6,1,25,64,7,14,85
"./Ship3_Latin-square/2019-09-07_09h46m_Subject 47797.txt","47797",2019-09-07,"09:46",27,20,5,2,7,50,4,2,56,22,3,1,26,44,13,12,69
"./Ship3_Latin-square/2019-09-07_09h58m_Subject 46878.txt","46878",2019-09-07,"09:58",83,60,13,10,23,59,7,7,73,59,8,9,76,408,10,99,517
"./Ship3_Latin-square/2019-09-07_09h58m_Subject 46885.txt","46885",2019-09-07,"09:58",76,60,7,9,16,67,8,8,83,16,2,0,18,311,32,43,386
"./Ship3_Latin-square/2019-09-07_09h58m_Subject 46899.txt","46899",2019-09-07,"09:58",79,60,8,11,19,33,5,8,46,52,7,8,67,570,84,107,761
"./Ship3_Latin-square/2019-09-07_09h58m_Subject 47081.txt","47081",2019-09-07,"09:58",80,60,11,9,20,12,5,3,20,60,37,36,133,420,59,75,554
"./Ship3_Latin-square/2019-09-07_09h58m_Subject 47091.txt","47091",2019-09-07,"09:58",78,59,6,13,19,84,5,7,96,82,13,22,117,315,34,61,410
"./Ship3_Latin-square/2019-09-07_09h58m_Subject 47231.txt","47231",2019-09-07,"09:58",76,59,3,14,17,56,3,14,73,25,8,9,42,201,14,59,274
"./Ship3_Latin-square/2019-09-07_09h58m_Subject 47238.txt","47238",2019-09-07,"09:58",82,60,7,15,22,16,2,3,21,61,8,33,102,290,36,85,411
"./Ship3_Latin-square/2019-09-07_09h58m_Subject 47242.txt","47242",2019-09-07,"09:58",67,47,13,7,20,61,15,19,95,98,83,67,248,334,46,48,428
"./Ship3_Latin-square/2019-09-07_09h58m_Subject 47244.txt","47244",2019-09-07,"09:58",83,60,11,12,23,68,2,17,87,100,30,78,208,598,95,98,791
"./Ship3_Latin-square/2019-09-07_09h58m_Subject 47633.txt","47633",2019-09-07,"09:58",73,54,11,8,19,121,7,32,160,89,20,19,128,199,2,32,233
"./Ship3_Latin-square/2019-09-07_09h58m_Subject 47636.txt","47636",2019-09-07,"09:58",73,56,8,9,17,94,9,5,108,53,13,47,113,293,31,43,367
"./Ship3_Latin-square/2019-09-07_09h58m_Subject 47752.txt","47752",2019-09-07,"09:58",80,60,9,11,20,66,5,5,76,40,19,10,69,742,112,148,1002
"./Ship3_Latin-square/2019-09-07_09h58m_Subject 47767.txt","47767",2019-09-07,"09:58",81,60,9,12,21,33,1,4,38,19,1,12,32,247,35,69,351
"./Ship3_Latin-square/2019-09-07_09h58m_Subject 47768.txt","47768",2019-09-07,"09:58",80,60,4,16,20,116,11,19,146,63,5,21,89,492,39,102,633
"./Ship3_Latin-square/2019-09-07_09h58m_Subject 47780.txt","47780",2019-09-07,"09:58",78,60,10,8,18,87,8,14,109,57,15,6,78,239,20,46,305
"./Ship3_Latin-square/2019-09-07_10h54m_Subject 47229.txt","47229",2019-09-07,"10:54",81,60,12,9,21,111,3,23,137,97,18,6,121,392,8,114,514
"./Ship3_Latin-square/2019-09-07_10h54m_Subject 47233.txt","47233",2019-09-07,"10:54",81,60,4,17,21,18,1,2,21,36,3,8,47,379,24,124,527
"./Ship3_Latin-square/2019-09-07_10h54m_Subject 47234.txt","47234",2019-09-07,"10:54",82,60,10,12,22,71,8,8,87,172,29,35,236,615,80,170,865
"./Ship3_Latin-square/2019-09-07_10h54m_Subject 47241.txt","47241",2019-09-07,"10:54",84,60,10,14,24,21,5,4,30,13,5,3,21,696,31,246,973
"./Ship3_Latin-square/2019-09-07_10h54m_Subject 47247.txt","47247",2019-09-07,"10:54",78,60,8,10,18,14,2,6,22,21,5,4,30,388,49,76,513
"./Ship3_Latin-square/2019-09-07_10h54m_Subject 47777.txt","47777",2019-09-07,"10:54",81,60,10,11,21,38,7,11,56,11,0,4,15,363,60,95,518
"./Ship3_Latin-square/2019-09-07_10h54m_Subject 47784.txt","47784",2019-09-07,"10:54",78,60,5,13,18,39,7,10,56,100,5,51,156,1077,76,263,1416
"./Ship3_Latin-square/2019-09-07_11h11m_Subject 46900.txt","46900",2019-09-07,"11:11",75,60,6,9,15,15,2,0,17,40,4,4,48,726,68,98,892
"./Ship3_Latin-square/2019-09-07_11h11m_Subject 46986.txt","46986",2019-09-07,"11:11",57,42,10,5,15,103,18,13,134,17,8,4,29,166,43,32,241
"./Ship3_Latin-square/2019-09-07_11h11m_Subject 47076.txt","47076",2019-09-07,"11:11",82,60,12,10,22,15,1,3,19,11,2,32,45,543,88,113,744
"./Ship3_Latin-square/2019-09-07_11h11m_Subject 47079.txt","47079",2019-09-07,"11:11",79,60,8,11,19,23,3,5,31,58,8,15,81,283,40,69,392
"./Ship3_Latin-square/2019-09-07_11h11m_Subject 47082.txt","47082",2019-09-07,"11:11",80,60,8,12,20,36,6,9,51,25,9,5,39,340,48,68,456
"./Ship3_Latin-square/2019-09-07_11h11m_Subject 47092.txt","47092",2019-09-07,"11:11",78,60,6,12,18,20,0,6,26,89,16,10,115,652,50,163,865
"./Ship3_Latin-square/2019-09-07_11h11m_Subject 47226.txt","47226",2019-09-07,"11:11",83,60,12,11,23,47,16,3,66,36,8,13,57,421,63,107,591
"./Ship3_Latin-square/2019-09-07_11h11m_Subject 47227.txt","47227",2019-09-07,"11:11",83,60,9,14,23,37,6,11,54,15,12,6,33,350,45,104,499
"./Ship3_Latin-square/2019-09-07_11h11m_Subject 47250.txt","47250",2019-09-07,"11:11",73,52,13,8,21,78,9,30,117,75,18,25,118,314,0,76,390
"./Ship3_Latin-square/2019-09-07_11h11m_Subject 47645.txt","47645",2019-09-07,"11:11",40,28,9,3,12,80,24,17,121,47,29,4,80,93,27,6,126
"./Ship3_Latin-square/2019-09-07_11h11m_Subject 47646.txt","47646",2019-09-07,"11:11",80,60,7,13,20,19,0,2,21,36,6,5,47,784,79,277,1140
"./Ship3_Latin-square/2019-09-07_11h11m_Subject 47755.txt","47755",2019-09-07,"11:11",78,56,9,13,22,61,8,5,74,42,12,13,67,574,85,119,778
"./Ship3_Latin-square/2019-09-07_11h11m_Subject 47760.txt","47760",2019-09-07,"11:11",78,60,8,10,18,76,10,5,91,44,12,12,68,665,86,111,862
"./Ship3_Latin-square/2019-09-07_11h11m_Subject 47770.txt","47770",2019-09-07,"11:11",48,36,7,5,12,63,10,14,87,49,16,10,75,80,4,17,101
"./Ship3_Latin-square/2019-09-07_11h11m_Subject 47795.txt","47795",2019-09-07,"11:11",78,60,7,11,18,70,2,10,82,28,8,3,39,249,16,52,317
"./Ship3_Latin-square/2019-09-07_12h01m_Subject 46881.txt","46881",2019-09-07,"12:01",80,60,10,10,20,30,5,7,42,23,2,8,33,383,49,85,517
"./Ship3_Latin-square/2019-09-07_12h01m_Subject 47087.txt","47087",2019-09-07,"12:01",79,60,10,9,19,67,9,5,81,48,15,10,73,249,34,46,329
"./Ship3_Latin-square/2019-09-07_12h01m_Subject 47626.txt","47626",2019-09-07,"12:01",79,60,7,12,19,22,1,4,27,75,7,54,136,320,59,73,452
"./Ship3_Latin-square/2019-09-07_12h01m_Subject 47634.txt","47634",2019-09-07,"12:01",80,60,13,7,20,63,7,8,78,17,8,9,34,380,41,46,467
"./Ship3_Latin-square/2019-09-07_12h01m_Subject 47640.txt","47640",2019-09-07,"12:01",76,60,9,7,16,17,1,0,18,13,7,3,23,653,47,131,831
"./Ship3_Latin-square/2019-09-07_12h01m_Subject 47754.txt","47754",2019-09-07,"12:01",44,31,10,3,13,33,14,2,49,29,9,42,80,89,19,10,118
"./Ship3_Latin-square/2019-09-07_12h01m_Subject 47800.txt","47800",2019-09-07,"12:01",80,60,5,15,20,69,7,21,97,83,7,23,113,198,4,123,325
"./Ship3_Latin-square/2019-09-07_12h35m_Subject 46880.txt","46880",2019-09-07,"12:35",80,60,8,12,20,18,1,0,19,34,3,9,46,632,102,136,870
"./Ship3_Latin-square/2019-09-07_12h35m_Subject 46882.txt","46882",2019-09-07,"12:35",81,60,12,9,21,17,1,0,18,44,14,6,64,696,114,144,954
"./Ship3_Latin-square/2019-09-07_12h35m_Subject 46883.txt","46883",2019-09-07,"12:35",79,60,15,4,19,99,15,6,120,65,9,3,77,304,1,19,324
"./Ship3_Latin-square/2019-09-07_12h35m_Subject 46894.txt","46894",2019-09-07,"12:35",83,60,11,12,23,39,12,10,61,55,11,5,71,309,45,75,429
"./Ship3_Latin-square/2019-09-07_12h35m_Subject 47088.txt","47088",2019-09-07,"12:35",84,60,14,10,24,49,7,6,62,78,33,19,130,630,110,89,829
"./Ship3_Latin-square/2019-09-07_12h35m_Subject 47228.txt","47228",2019-09-07,"12:35",82,60,10,12,22,27,4,5,36,40,20,12,72,416,46,111,573
"./Ship3_Latin-square/2019-09-07_12h35m_Subject 47243.txt","47243",2019-09-07,"12:35",80,57,13,10,23,141,11,49,201,36,10,11,57,456,63,86,605
"./Ship3_Latin-square/2019-09-07_12h35m_Subject 47249.txt","47249",2019-09-07,"12:35",71,52,10,9,19,85,12,7,104,88,27,16,131,216,34,42,292
"./Ship3_Latin-square/2019-09-07_12h35m_Subject 47639.txt","47639",2019-09-07,"12:35",83,60,11,12,23,31,5,8,44,31,3,46,80,367,46,88,501
"./Ship3_Latin-square/2019-09-07_12h35m_Subject 47649.txt","47649",2019-09-07,"12:35",67,49,5,13,18,37,1,2,40,32,9,48,89,292,35,66,393
"./Ship3_Latin-square/2019-09-07_12h35m_Subject 47758.txt","47758",2019-09-07,"12:35",80,60,10,10,20,17,2,1,20,59,1,2,62,603,78,122,803
"./Ship3_Latin-square/2019-09-07_12h35m_Subject 47759.txt","47759",2019-09-07,"12:35",84,60,13,11,24,79,12,3,94,17,11,7,35,586,102,130,818
"./Ship3_Latin-square/2019-09-07_12h35m_Subject 47776.txt","47776",2019-09-07,"12:35",79,60,11,8,19,37,3,5,45,51,20,40,111,722,61,169,952
"./Ship3_Latin-square/2019-09-07_12h35m_Subject 47799.txt","47799",2019-09-07,"12:35",78,60,8,10,18,47,31,2,80,65,14,29,108,400,33,107,540
"./Ship3_Latin-square/2019-09-07_13h18m_Subject 46888.txt","46888",2019-09-07,"13:18",83,60,16,7,23,34,3,7,44,82,57,18,157,422,12,93,527
"./Ship3_Latin-square/2019-09-07_13h18m_Subject 46889.txt","46889",2019-09-07,"13:18",77,60,6,11,17,16,0,1,17,18,2,18,38,809,51,127,987
"./Ship3_Latin-square/2019-09-07_13h18m_Subject 46892.txt","46892",2019-09-07,"13:18",71,50,9,12,21,49,4,5,58,32,18,6,56,263,31,104,398
"./Ship3_Latin-square/2019-09-07_13h18m_Subject 46898.txt","46898",2019-09-07,"13:18",85,60,13,12,25,27,6,7,40,19,9,8,36,309,49,74,432
"./Ship3_Latin-square/2019-09-07_13h18m_Subject 47097.txt","47097",2019-09-07,"13:18",82,60,10,12,22,15,2,2,19,54,14,16,84,579,66,136,781
"./Ship3_Latin-square/2019-09-07_13h18m_Subject 47099.txt","47099",2019-09-07,"13:18",80,60,8,12,20,38,3,11,52,18,0,3,21,163,16,58,237
"./Ship3_Latin-square/2019-09-07_13h18m_Subject 47798.txt","47798",2019-09-07,"13:18",83,59,14,10,24,99,10,28,137,76,86,37,199,287,1,102,390
"./Ship3_Latin-square/2019-09-07_13h43m_Subject 46876.txt","46876",2019-09-07,"13:43",81,60,9,12,21,42,5,4,51,8,2,1,11,567,86,114,767
"./Ship3_Latin-square/2019-09-07_13h43m_Subject 46877.txt","46877",2019-09-07,"13:43",78,60,9,9,18,15,0,4,19,169,14,37,220,1046,154,171,1371
"./Ship3_Latin-square/2019-09-07_13h43m_Subject 46893.txt","46893",2019-09-07,"13:43",79,60,10,9,19,31,5,10,46,45,7,9,61,601,77,88,766
"./Ship3_Latin-square/2019-09-07_13h43m_Subject 46895.txt","46895",2019-09-07,"13:43",62,44,9,9,18,46,18,6,70,149,59,20,228,164,33,60,257
"./Ship3_Latin-square/2019-09-07_13h43m_Subject 47638.txt","47638",2019-09-07,"13:43",73,54,11,8,19,55,12,11,78,120,14,40,174,178,24,25,227
"./Ship3_Latin-square/2019-09-07_13h43m_Subject 47757.txt","47757",2019-09-07,"13:43",68,49,10,9,19,105,29,16,150,20,8,29,57,267,68,49,384
"./Ship3_Latin-square/2019-09-07_13h43m_Subject 47769.txt","47769",2019-09-07,"13:43",82,60,14,8,22,80,13,14,107,38,24,24,86,372,50,42,464
"./Ship3_Latin-square/2019-09-07_13h43m_Subject 47771.txt","47771",2019-09-07,"13:43",82,60,11,11,22,51,7,9,67,28,4,4,36,332,6,101,439
"./Ship3_Latin-square/2019-09-07_13h43m_Subject 47775.txt","47775",2019-09-07,"13:43",80,60,9,11,20,125,18,21,164,80,28,20,128,160,1,81,242
"./Ship3_Latin-square/2019-09-07_13h43m_Subject 47781.txt","47781",2019-09-07,"13:43",82,60,11,11,22,29,3,7,39,72,10,29,111,641,47,173,861
"./Ship3_Latin-square/2019-09-07_13h43m_Subject 47782.txt","47782",2019-09-07,"13:43",80,60,10,10,20,35,4,5,44,7,0,1,8,568,57,110,735
"./Ship3_Latin-square/2019-09-07_13h43m_Subject 47783.txt","47783",2019-09-07,"13:43",79,60,10,9,19,32,1,6,39,26,6,7,39,591,72,66,729
"./Ship3_Latin-square/2019-09-07_13h43m_Subject 47785.txt","47785",2019-09-07,"13:43",84,60,11,13,24,23,0,4,27,37,10,10,57,774,157,187,1118
"./Ship3_Latin-square/2019-09-07_13h43m_Subject 47786.txt","47786",2019-09-07,"13:43",78,60,7,11,18,33,3,12,48,86,22,9,117,571,37,89,697
"./Ship3_Latin-square/2019-09-07_13h43m_Subject 47788.txt","47788",2019-09-07,"13:43",83,60,13,10,23,40,9,1,50,87,29,25,141,528,110,135,773
"./Ship3_Latin-square/2019-09-07_14h23m_Subject 47080.txt","47080",2019-09-07,"14:23",83,60,11,12,23,36,1,6,43,9,5,5,19,363,43,97,503
"./Ship3_Latin-square/2019-09-07_14h23m_Subject 47089.txt","47089",2019-09-07,"14:23",57,39,17,1,18,54,17,3,74,33,63,1,97,148,9,0,157
"./Ship3_Latin-square/2019-09-07_14h23m_Subject 47762.txt","47762",2019-09-07,"14:23",85,60,12,13,25,45,5,8,58,39,18,21,78,398,97,94,589
"./Ship3_Latin-square/2019-09-07_14h23m_Subject 47791.txt","47791",2019-09-07,"14:23",75,60,4,11,15,11,0,1,12,34,3,8,45,989,55,170,1214
"./Ship3_Latin-square/2019-09-09_10h19m_Subject 46878.txt","46878",2019-09-09,"10:19",85,60,13,12,25,45,23,11,79,51,28,59,138,450,160,112,722
"./Ship3_Latin-square/2019-09-09_10h19m_Subject 46885.txt","46885",2019-09-09,"10:19",77,60,7,10,17,69,9,10,88,18,2,0,20,310,40,59,409
"./Ship3_Latin-square/2019-09-09_10h19m_Subject 46899.txt","46899",2019-09-09,"10:19",82,60,8,14,22,49,6,7,62,47,9,14,70,514,80,145,739
"./Ship3_Latin-square/2019-09-09_10h19m_Subject 47081.txt","47081",2019-09-09,"10:19",86,60,18,8,26,57,5,7,69,31,24,44,99,243,33,54,330
"./Ship3_Latin-square/2019-09-09_10h19m_Subject 47091.txt","47091",2019-09-09,"10:19",76,60,6,10,16,43,7,5,55,82,8,11,101,177,23,48,248
"./Ship3_Latin-square/2019-09-09_10h19m_Subject 47231.txt","47231",2019-09-09,"10:19",78,60,6,12,18,48,3,19,70,24,7,2,33,137,14,33,184
"./Ship3_Latin-square/2019-09-09_10h19m_Subject 47238.txt","47238",2019-09-09,"10:19",74,60,10,4,14,34,1,2,37,70,9,8,87,276,8,23,307
"./Ship3_Latin-square/2019-09-09_10h19m_Subject 47242.txt","47242",2019-09-09,"10:19",80,60,12,8,20,67,2,13,82,62,19,9,90,321,10,93,424
"./Ship3_Latin-square/2019-09-09_10h19m_Subject 47244.txt","47244",2019-09-09,"10:19",83,60,5,18,23,40,6,20,66,52,9,53,114,363,37,121,521
"./Ship3_Latin-square/2019-09-09_10h19m_Subject 47633.txt","47633",2019-09-09,"10:19",80,60,11,9,20,56,20,8,84,66,14,21,101,257,56,44,357
"./Ship3_Latin-square/2019-09-09_10h19m_Subject 47636.txt","47636",2019-09-09,"10:19",59,45,12,2,14,97,23,5,125,58,17,3,78,152,5,5,162
"./Ship3_Latin-square/2019-09-09_10h19m_Subject 47752.txt","47752",2019-09-09,"10:19",81,60,10,11,21,41,8,9,58,31,19,8,58,440,78,105,623
"./Ship3_Latin-square/2019-09-09_10h19m_Subject 47767.txt","47767",2019-09-09,"10:19",53,39,12,2,14,99,8,32,139,14,3,1,18,95,1,1,97
"./Ship3_Latin-square/2019-09-09_10h19m_Subject 47768.txt","47768",2019-09-09,"10:19",57,42,10,5,15,116,17,14,147,33,20,8,61,159,2,22,183
"./Ship3_Latin-square/2019-09-09_10h19m_Subject 47780.txt","47780",2019-09-09,"10:19",79,60,6,13,19,51,11,10,72,58,7,30,95,377,34,108,519
"./Ship3_Latin-square/2019-09-09_10h22m_Subject 46884.txt","46884",2019-09-09,"10:22",82,59,12,11,23,46,6,11,63,32,6,2,40,143,29,26,198
"./Ship3_Latin-square/2019-09-09_10h22m_Subject 47083.txt","47083",2019-09-09,"10:22",77,58,6,13,19,60,4,9,73,53,3,30,86,268,25,73,366
"./Ship3_Latin-square/2019-09-09_10h22m_Subject 47086.txt","47086",2019-09-09,"10:22",74,56,12,6,18,68,14,6,88,43,13,2,58,214,25,33,272
"./Ship3_Latin-square/2019-09-09_10h22m_Subject 47246.txt","47246",2019-09-09,"10:22",79,60,10,9,19,58,4,3,65,24,3,2,29,380,52,74,506
"./Ship3_Latin-square/2019-09-09_10h22m_Subject 47635.txt","47635",2019-09-09,"10:22",80,60,14,6,20,37,9,7,53,61,24,13,98,398,84,42,524
"./Ship3_Latin-square/2019-09-09_10h22m_Subject 47779.txt","47779",2019-09-09,"10:22",35,25,9,1,10,48,7,0,55,3,6,0,9,52,27,3,82
"./Ship3_Latin-square/2019-09-09_10h22m_Subject 47797.txt","47797",2019-09-09,"10:22",51,37,0,14,14,40,0,15,55,12,0,11,23,137,0,33,170
"./Ship3_Latin-square/2019-09-09_11h35m_Subject 46900.txt","46900",2019-09-09,"11:35",77,60,8,9,17,8,15,0,23,66,4,48,118,699,69,154,922
"./Ship3_Latin-square/2019-09-09_11h35m_Subject 46986.txt","46986",2019-09-09,"11:35",77,58,11,8,19,65,13,11,89,9,24,1,34,263,36,31,330
"./Ship3_Latin-square/2019-09-09_11h35m_Subject 47076.txt","47076",2019-09-09,"11:35",83,60,14,9,23,40,2,6,48,49,15,49,113,261,11,56,328
"./Ship3_Latin-square/2019-09-09_11h35m_Subject 47079.txt","47079",2019-09-09,"11:35",77,60,8,9,17,31,1,0,32,43,5,12,60,345,35,59,439
"./Ship3_Latin-square/2019-09-09_11h35m_Subject 47082.txt","47082",2019-09-09,"11:35",66,49,13,4,17,99,10,11,120,27,10,7,44,244,11,21,276
"./Ship3_Latin-square/2019-09-09_11h35m_Subject 47092.txt","47092",2019-09-09,"11:35",77,60,9,8,17,21,2,1,24,47,17,6,70,765,108,82,955
"./Ship3_Latin-square/2019-09-09_11h35m_Subject 47226.txt","47226",2019-09-09,"11:35",80,60,12,8,20,55,7,17,79,42,9,9,60,305,5,46,356
"./Ship3_Latin-square/2019-09-09_11h35m_Subject 47227.txt","47227",2019-09-09,"11:35",84,60,15,9,24,62,10,9,81,33,27,7,67,230,2,49,281
"./Ship3_Latin-square/2019-09-09_11h35m_Subject 47250.txt","47250",2019-09-09,"11:35",83,60,13,10,23,37,4,11,52,36,5,22,63,357,31,107,495
"./Ship3_Latin-square/2019-09-09_11h35m_Subject 47645.txt","47645",2019-09-09,"11:35",30,22,7,1,8,84,7,18,109,20,17,1,38,93,54,1,148
"./Ship3_Latin-square/2019-09-09_11h35m_Subject 47646.txt","47646",2019-09-09,"11:35",78,60,12,6,18,50,2,9,61,27,6,8,41,429,2,57,488
"./Ship3_Latin-square/2019-09-09_11h35m_Subject 47755.txt","47755",2019-09-09,"11:35",82,60,5,17,22,51,5,10,66,49,3,20,72,404,31,124,559
"./Ship3_Latin-square/2019-09-09_11h35m_Subject 47760.txt","47760",2019-09-09,"11:35",82,60,8,14,22,52,7,22,81,45,6,11,62,695,92,163,950
"./Ship3_Latin-square/2019-09-09_11h35m_Subject 47770.txt","47770",2019-09-09,"11:35",51,40,7,4,11,99,14,3,116,91,11,0,102,166,36,14,216
"./Ship3_Latin-square/2019-09-09_11h35m_Subject 47795.txt","47795",2019-09-09,"11:35",66,48,15,3,18,72,16,4,92,36,16,3,55,149,4,21,174
"./Ship3_Latin-square/2019-09-09_11h40m_Subject 47229.txt","47229",2019-09-09,"11:40",78,60,10,8,18,39,10,12,61,40,14,5,59,423,48,63,534
"./Ship3_Latin-square/2019-09-09_11h40m_Subject 47233.txt","47233",2019-09-09,"11:40",84,60,10,14,24,31,0,4,35,31,8,16,55,336,39,89,464
"./Ship3_Latin-square/2019-09-09_11h40m_Subject 47234.txt","47234",2019-09-09,"11:40",85,60,15,10,25,42,7,5,54,38,18,7,63,313,53,58,424
"./Ship3_Latin-square/2019-09-09_11h40m_Subject 47241.txt","47241",2019-09-09,"11:40",89,60,0,29,29,34,0,6,40,9,0,7,16,752,0,304,1056
"./Ship3_Latin-square/2019-09-09_11h40m_Subject 47247.txt","47247",2019-09-09,"11:40",79,60,8,11,19,32,3,3,38,19,6,7,32,215,51,43,309
"./Ship3_Latin-square/2019-09-09_11h40m_Subject 47777.txt","47777",2019-09-09,"11:40",64,45,9,10,19,104,13,28,145,32,13,14,59,124,3,29,156
"./Ship3_Latin-square/2019-09-09_11h40m_Subject 47784.txt","47784",2019-09-09,"11:40",81,60,1,20,21,37,1,5,43,43,2,21,66,1126,10,268,1404
"./Ship3_Latin-square/2019-09-09_12h47m_Subject 46880.txt","46880",2019-09-09,"12:47",87,60,11,16,27,11,1,4,16,12,1,17,30,474,79,150,703
"./Ship3_Latin-square/2019-09-09_12h47m_Subject 46882.txt","46882",2019-09-09,"12:47",77,54,13,10,23,79,9,22,110,63,19,5,87,381,1,59,441
"./Ship3_Latin-square/2019-09-09_12h47m_Subject 46883.txt","46883",2019-09-09,"12:47",81,60,9,12,21,45,56,4,105,116,32,15,163,567,78,122,767
"./Ship3_Latin-square/2019-09-09_12h47m_Subject 46894.txt","46894",2019-09-09,"12:47",81,60,10,11,21,35,9,7,51,52,17,4,73,233,34,45,312
"./Ship3_Latin-square/2019-09-09_12h47m_Subject 47088.txt","47088",2019-09-09,"12:47",82,60,11,11,22,63,6,20,89,52,15,28,95,390,45,110,545
"./Ship3_Latin-square/2019-09-09_12h47m_Subject 47228.txt","47228",2019-09-09,"12:47",79,60,11,8,19,35,10,5,50,19,6,2,27,306,74,55,435
"./Ship3_Latin-square/2019-09-09_12h47m_Subject 47243.txt","47243",2019-09-09,"12:47",81,60,12,9,21,101,10,35,146,36,7,9,52,492,83,74,649
"./Ship3_Latin-square/2019-09-09_12h47m_Subject 47249.txt","47249",2019-09-09,"12:47",72,56,12,4,16,77,12,6,95,76,27,4,107,179,26,17,222
"./Ship3_Latin-square/2019-09-09_12h47m_Subject 47639.txt","47639",2019-09-09,"12:47",77,60,9,8,17,27,2,3,32,14,4,9,27,641,76,90,807
"./Ship3_Latin-square/2019-09-09_12h47m_Subject 47649.txt","47649",2019-09-09,"12:47",77,60,8,9,17,32,1,0,33,23,5,4,32,310,37,34,381
"./Ship3_Latin-square/2019-09-09_12h47m_Subject 47758.txt","47758",2019-09-09,"12:47",80,60,13,7,20,23,0,1,24,33,58,1,92,491,45,94,630
"./Ship3_Latin-square/2019-09-09_12h47m_Subject 47759.txt","47759",2019-09-09,"12:47",81,60,12,9,21,24,8,1,33,52,19,13,84,398,33,84,515
"./Ship3_Latin-square/2019-09-09_12h47m_Subject 47776.txt","47776",2019-09-09,"12:47",81,60,8,13,21,26,4,7,37,58,12,45,115,697,128,172,997
"./Ship3_Latin-square/2019-09-09_12h47m_Subject 47799.txt","47799",2019-09-09,"12:47",79,60,8,11,19,47,4,8,59,75,12,8,95,232,16,74,322
"./Ship3_Latin-square/2019-09-09_12h54m_Subject 46881.txt","46881",2019-09-09,"12:54",83,58,12,13,25,82,3,23,108,42,4,13,59,253,10,58,321
"./Ship3_Latin-square/2019-09-09_12h54m_Subject 47087.txt","47087",2019-09-09,"12:54",82,60,12,10,22,87,12,17,116,73,18,13,104,198,11,40,249
"./Ship3_Latin-square/2019-09-09_12h54m_Subject 47626.txt","47626",2019-09-09,"12:54",82,60,10,12,22,36,3,9,48,87,9,9,105,238,27,69,334
"./Ship3_Latin-square/2019-09-09_12h54m_Subject 47634.txt","47634",2019-09-09,"12:54",79,56,12,11,23,104,15,34,153,39,10,7,56,181,3,65,249
"./Ship3_Latin-square/2019-09-09_12h54m_Subject 47640.txt","47640",2019-09-09,"12:54",65,49,13,3,16,81,12,6,99,26,13,1,40,293,3,21,317
"./Ship3_Latin-square/2019-09-09_12h54m_Subject 47754.txt","47754",2019-09-09,"12:54",48,35,8,5,13,33,52,4,89,20,18,91,129,103,23,6,132
"./Ship3_Latin-square/2019-09-09_12h54m_Subject 47800.txt","47800",2019-09-09,"12:54",75,60,10,5,15,70,2,2,74,64,16,2,82,264,30,34,328
"./Ship3_Latin-square/2019-09-09_13h59m_Subject 46876.txt","46876",2019-09-09,"13:59",79,60,11,8,19,31,5,3,39,2,0,3,5,355,45,71,471
"./Ship3_Latin-square/2019-09-09_13h59m_Subject 46877.txt","46877",2019-09-09,"13:59",84,60,13,11,24,102,3,29,134,98,119,43,260,599,21,209,829
"./Ship3_Latin-square/2019-09-09_13h59m_Subject 46893.txt","46893",2019-09-09,"13:59",82,60,9,13,22,16,1,2,19,35,5,6,46,744,84,161,989
"./Ship3_Latin-square/2019-09-09_13h59m_Subject 46895.txt","46895",2019-09-09,"13:59",78,56,10,12,22,41,7,9,57,48,24,10,82,357,55,57,469
"./Ship3_Latin-square/2019-09-09_13h59m_Subject 47638.txt","47638",2019-09-09,"13:59",79,60,11,8,19,97,13,9,119,52,21,40,113,264,38,43,345
"./Ship3_Latin-square/2019-09-09_13h59m_Subject 47757.txt","47757",2019-09-09,"13:59",58,42,11,5,16,79,29,8,116,22,11,2,35,174,50,31,255
"./Ship3_Latin-square/2019-09-09_13h59m_Subject 47769.txt","47769",2019-09-09,"13:59",78,56,13,9,22,69,10,14,93,37,14,24,75,417,60,73,550
"./Ship3_Latin-square/2019-09-09_13h59m_Subject 47771.txt","47771",2019-09-09,"13:59",81,60,11,10,21,45,2,8,55,29,14,35,78,490,56,132,678
"./Ship3_Latin-square/2019-09-09_13h59m_Subject 47775.txt","47775",2019-09-09,"13:59",83,59,14,10,24,125,32,3,160,54,39,13,106,289,40,70,399
"./Ship3_Latin-square/2019-09-09_13h59m_Subject 47781.txt","47781",2019-09-09,"13:59",78,60,10,8,18,50,1,6,57,43,22,13,78,445,2,130,577
"./Ship3_Latin-square/2019-09-09_13h59m_Subject 47782.txt","47782",2019-09-09,"13:59",75,60,7,8,15,57,1,0,58,16,2,6,24,580,37,123,740
"./Ship3_Latin-square/2019-09-09_13h59m_Subject 47783.txt","47783",2019-09-09,"13:59",75,59,13,3,16,99,14,6,119,33,8,3,44,355,7,16,378
"./Ship3_Latin-square/2019-09-09_13h59m_Subject 47785.txt","47785",2019-09-09,"13:59",85,60,14,11,25,94,12,20,126,45,6,23,74,332,1,90,423
"./Ship3_Latin-square/2019-09-09_13h59m_Subject 47786.txt","47786",2019-09-09,"13:59",71,53,11,7,18,58,13,13,84,44,9,15,68,178,22,57,257
"./Ship3_Latin-square/2019-09-09_13h59m_Subject 47788.txt","47788",2019-09-09,"13:59",82,60,13,9,22,42,11,7,60,70,25,11,106,412,55,86,553
"./Ship3_Latin-square/2019-09-09_14h03m_Subject 46888.txt","46888",2019-09-09,"14:03",80,60,13,7,20,40,6,6,52,45,16,10,71,505,47,106,658
"./Ship3_Latin-square/2019-09-09_14h03m_Subject 46889.txt","46889",2019-09-09,"14:03",82,60,3,19,22,8,0,4,12,26,4,21,51,801,59,195,1055
"./Ship3_Latin-square/2019-09-09_14h03m_Subject 46892.txt","46892",2019-09-09,"14:03",84,60,14,10,24,38,11,4,53,21,3,5,29,453,86,97,636
"./Ship3_Latin-square/2019-09-09_14h03m_Subject 46898.txt","46898",2019-09-09,"14:03",83,60,6,17,23,30,2,5,37,5,5,8,18,527,40,101,668
"./Ship3_Latin-square/2019-09-09_14h03m_Subject 47097.txt","47097",2019-09-09,"14:03",85,60,17,8,25,87,4,15,106,81,45,10,136,385,0,90,475
"./Ship3_Latin-square/2019-09-09_14h03m_Subject 47099.txt","47099",2019-09-09,"14:03",84,60,12,12,24,30,10,7,47,40,10,10,60,516,54,150,720
"./Ship3_Latin-square/2019-09-09_14h03m_Subject 47798.txt","47798",2019-09-09,"14:03",81,60,6,15,21,23,2,5,30,18,2,1,21,158,11,69,238
"./Ship3_Latin-square/2019-09-09_15h22m_Subject 47080.txt","47080",2019-09-09,"15:22",76,60,7,9,16,22,0,1,23,9,1,0,10,474,68,80,622
"./Ship3_Latin-square/2019-09-09_15h22m_Subject 47089.txt","47089",2019-09-09,"15:22",58,40,13,5,18,46,10,8,64,51,23,6,80,116,24,15,155
"./Ship3_Latin-square/2019-09-09_15h22m_Subject 47762.txt","47762",2019-09-09,"15:22",80,60,9,11,20,34,4,7,45,35,6,2,43,246,44,53,343
"./Ship3_Latin-square/2019-09-09_15h22m_Subject 47791.txt","47791",2019-09-09,"15:22",77,60,7,10,17,11,0,0,11,32,7,4,43,770,52,173,995
"./Ship3_Latin-square/2019-09-10_10h09m_Subject 46878.txt","46878",2019-09-10,"10:09",80,60,9,11,20,28,1,1,30,39,12,11,62,779,130,148,1057
"./Ship3_Latin-square/2019-09-10_10h09m_Subject 46885.txt","46885",2019-09-10,"10:09",81,60,10,11,21,56,5,8,69,7,3,2,12,291,35,48,374
"./Ship3_Latin-square/2019-09-10_10h09m_Subject 46899.txt","46899",2019-09-10,"10:09",86,60,10,16,26,56,30,12,98,38,22,14,74,752,110,239,1101
"./Ship3_Latin-square/2019-09-10_10h09m_Subject 47081.txt","47081",2019-09-10,"10:09",82,60,11,11,22,21,3,4,28,13,1,29,43,514,97,107,718
"./Ship3_Latin-square/2019-09-10_10h09m_Subject 47091.txt","47091",2019-09-10,"10:09",76,60,11,5,16,58,9,7,74,63,21,7,91,242,39,16,297
"./Ship3_Latin-square/2019-09-10_10h09m_Subject 47231.txt","47231",2019-09-10,"10:09",79,60,4,15,19,51,3,13,67,18,7,13,38,226,9,65,300
"./Ship3_Latin-square/2019-09-10_10h09m_Subject 47238.txt","47238",2019-09-10,"10:09",82,60,10,12,22,13,4,3,20,78,17,24,119,305,35,68,408
"./Ship3_Latin-square/2019-09-10_10h09m_Subject 47242.txt","47242",2019-09-10,"10:09",81,60,13,8,21,77,7,14,98,55,35,9,99,440,64,86,590
"./Ship3_Latin-square/2019-09-10_10h09m_Subject 47244.txt","47244",2019-09-10,"10:09",78,60,11,7,18,26,2,0,28,107,20,10,137,444,46,97,587
"./Ship3_Latin-square/2019-09-10_10h09m_Subject 47633.txt","47633",2019-09-10,"10:09",82,60,12,10,22,49,5,5,59,64,21,27,112,290,54,47,391
"./Ship3_Latin-square/2019-09-10_10h09m_Subject 47636.txt","47636",2019-09-10,"10:09",79,60,9,10,19,61,7,7,75,65,12,17,94,284,53,59,396
"./Ship3_Latin-square/2019-09-10_10h09m_Subject 47752.txt","47752",2019-09-10,"10:09",78,60,8,10,18,56,3,5,64,36,16,10,62,613,76,98,787
"./Ship3_Latin-square/2019-09-10_10h09m_Subject 47767.txt","47767",2019-09-10,"10:09",49,38,10,1,11,96,18,51,165,36,81,0,117,137,14,10,161
"./Ship3_Latin-square/2019-09-10_10h09m_Subject 47768.txt","47768",2019-09-10,"10:09",36,25,11,0,11,48,14,0,62,6,10,0,16,97,75,0,172
"./Ship3_Latin-square/2019-09-10_10h09m_Subject 47780.txt","47780",2019-09-10,"10:09",52,38,12,2,14,83,19,5,107,82,28,2,112,150,5,10,165
"./Ship3_Latin-square/2019-09-10_10h15m_Subject 46884.txt","46884",2019-09-10,"10:15",43,31,8,4,12,44,2,3,49,69,8,3,80,99,6,8,113
"./Ship3_Latin-square/2019-09-10_10h15m_Subject 47083.txt","47083",2019-09-10,"10:15",76,58,11,7,18,54,3,5,62,49,14,16,79,272,28,31,331
"./Ship3_Latin-square/2019-09-10_10h15m_Subject 47086.txt","47086",2019-09-10,"10:15",79,60,8,11,19,26,0,2,28,37,11,4,52,442,65,103,610
"./Ship3_Latin-square/2019-09-10_10h15m_Subject 47246.txt","47246",2019-09-10,"10:15",65,48,10,7,17,138,17,17,172,48,6,26,80,172,4,58,234
"./Ship3_Latin-square/2019-09-10_10h15m_Subject 47635.txt","47635",2019-09-10,"10:15",81,60,9,12,21,44,4,5,53,61,9,26,96,481,68,82,631
"./Ship3_Latin-square/2019-09-10_10h15m_Subject 47779.txt","47779",2019-09-10,"10:15",82,59,11,12,23,39,2,6,47,35,12,18,65,174,35,56,265
"./Ship3_Latin-square/2019-09-10_10h15m_Subject 47797.txt","47797",2019-09-10,"10:15",20,14,5,1,6,28,5,4,37,11,13,1,25,27,5,3,35
"./Ship3_Latin-square/2019-09-10_11h38m_Subject 46900.txt","46900",2019-09-10,"11:38",81,60,14,7,21,68,2,12,82,40,17,6,63,468,9,98,575
"./Ship3_Latin-square/2019-09-10_11h38m_Subject 46986.txt","46986",2019-09-10,"11:38",69,54,12,3,15,68,7,1,76,11,5,0,16,207,24,10,241
"./Ship3_Latin-square/2019-09-10_11h38m_Subject 47076.txt","47076",2019-09-10,"11:38",82,60,11,11,22,33,3,6,42,50,2,36,88,437,36,153,626
"./Ship3_Latin-square/2019-09-10_11h38m_Subject 47079.txt","47079",2019-09-10,"11:38",86,60,6,20,26,33,2,7,42,57,3,33,93,193,20,110,323
"./Ship3_Latin-square/2019-09-10_11h38m_Subject 47082.txt","47082",2019-09-10,"11:38",81,60,12,9,21,149,10,4,163,34,5,7,46,376,37,80,493
"./Ship3_Latin-square/2019-09-10_11h38m_Subject 47092.txt","47092",2019-09-10,"11:38",81,60,10,11,21,19,0,3,22,48,14,11,73,609,87,132,828
"./Ship3_Latin-square/2019-09-10_11h38m_Subject 47226.txt","47226",2019-09-10,"11:38",79,60,8,11,19,14,0,8,22,36,16,14,66,540,39,206,785
"./Ship3_Latin-square/2019-09-10_11h38m_Subject 47227.txt","47227",2019-09-10,"11:38",82,60,13,9,22,74,20,9,103,33,21,5,59,240,42,32,314
"./Ship3_Latin-square/2019-09-10_11h38m_Subject 47229.txt","47229",2019-09-10,"11:38",75,60,10,5,15,14,1,4,19,32,11,3,46,741,102,90,933
"./Ship3_Latin-square/2019-09-10_11h38m_Subject 47233.txt","47233",2019-09-10,"11:38",83,60,14,9,23,55,2,13,70,57,24,12,93,283,6,64,353
"./Ship3_Latin-square/2019-09-10_11h38m_Subject 47234.txt","47234",2019-09-10,"11:38",80,60,6,14,20,103,6,10,119,52,19,14,85,819,84,185,1088
"./Ship3_Latin-square/2019-09-10_11h38m_Subject 47241.txt","47241",2019-09-10,"11:38",77,60,10,7,17,32,3,7,42,9,5,1,15,501,8,125,634
"./Ship3_Latin-square/2019-09-10_11h38m_Subject 47247.txt","47247",2019-09-10,"11:38",78,60,7,11,18,25,0,4,29,19,0,10,29,319,36,64,419
"./Ship3_Latin-square/2019-09-10_11h38m_Subject 47250.txt","47250",2019-09-10,"11:38",79,60,10,9,19,16,3,5,24,17,0,4,21,807,110,137,1054
"./Ship3_Latin-square/2019-09-10_11h38m_Subject 47645.txt","47645",2019-09-10,"11:38",39,28,8,3,11,83,23,12,118,20,5,3,28,107,18,13,138
"./Ship3_Latin-square/2019-09-10_11h38m_Subject 47646.txt","47646",2019-09-10,"11:38",78,60,11,7,18,58,6,10,74,43,19,3,65,473,38,125,636
"./Ship3_Latin-square/2019-09-10_11h38m_Subject 47755.txt","47755",2019-09-10,"11:38",81,60,7,14,21,50,1,9,60,37,1,29,67,641,66,87,794
"./Ship3_Latin-square/2019-09-10_11h38m_Subject 47760.txt","47760",2019-09-10,"11:38",81,60,10,11,21,42,8,9,59,57,8,19,84,764,75,209,1048
"./Ship3_Latin-square/2019-09-10_11h38m_Subject 47770.txt","47770",2019-09-10,"11:38",51,39,6,6,12,73,6,6,85,50,10,3,63,178,18,23,219
"./Ship3_Latin-square/2019-09-10_11h38m_Subject 47777.txt","47777",2019-09-10,"11:38",80,60,10,10,20,59,5,15,79,34,2,7,43,337,42,118,497
"./Ship3_Latin-square/2019-09-10_11h38m_Subject 47784.txt","47784",2019-09-10,"11:38",79,60,10,9,19,34,0,4,38,59,54,8,121,943,107,208,1258
"./Ship3_Latin-square/2019-09-10_11h38m_Subject 47795.txt","47795",2019-09-10,"11:38",69,51,12,6,18,92,27,58,177,40,14,18,72,162,15,20,197
"./Ship3_Latin-square/2019-09-10_13h02m_Subject 46880.txt","46880",2019-09-10,"13:02",81,60,13,8,21,78,6,14,98,21,9,6,36,290,0,72,362
"./Ship3_Latin-square/2019-09-10_13h02m_Subject 46882.txt","46882",2019-09-10,"13:02",80,60,10,10,20,77,7,12,96,193,71,49,313,396,33,157,586
"./Ship3_Latin-square/2019-09-10_13h02m_Subject 46883.txt","46883",2019-09-10,"13:02",84,60,12,12,24,33,2,5,40,36,14,9,59,416,87,97,600
"./Ship3_Latin-square/2019-09-10_13h02m_Subject 46894.txt","46894",2019-09-10,"13:02",78,60,9,9,18,77,11,14,102,39,10,4,53,234,26,39,299
"./Ship3_Latin-square/2019-09-10_13h02m_Subject 47088.txt","47088",2019-09-10,"13:02",78,60,10,8,18,27,4,1,32,96,23,10,129,794,135,112,1041
"./Ship3_Latin-square/2019-09-10_13h02m_Subject 47228.txt","47228",2019-09-10,"13:02",79,60,9,10,19,21,5,1,27,35,16,4,55,367,46,116,529
"./Ship3_Latin-square/2019-09-10_13h02m_Subject 47243.txt","47243",2019-09-10,"13:02",81,60,12,9,21,116,15,23,154,37,11,64,112,459,56,81,596
"./Ship3_Latin-square/2019-09-10_13h02m_Subject 47249.txt","47249",2019-09-10,"13:02",77,60,9,8,17,70,5,24,99,124,23,50,197,308,50,48,406
"./Ship3_Latin-square/2019-09-10_13h02m_Subject 47639.txt","47639",2019-09-10,"13:02",81,60,12,9,21,35,7,5,47,22,7,8,37,448,38,89,575
"./Ship3_Latin-square/2019-09-10_13h02m_Subject 47649.txt","47649",2019-09-10,"13:02",78,60,6,12,18,48,4,11,63,24,1,13,38,532,59,120,711
"./Ship3_Latin-square/2019-09-10_13h02m_Subject 47758.txt","47758",2019-09-10,"13:02",83,60,12,11,23,38,9,0,47,49,3,34,86,821,149,166,1136
"./Ship3_Latin-square/2019-09-10_13h02m_Subject 47759.txt","47759",2019-09-10,"13:02",77,60,8,9,17,128,34,97,259,56,45,57,158,560,69,114,743
"./Ship3_Latin-square/2019-09-10_13h02m_Subject 47776.txt","47776",2019-09-10,"13:02",77,60,8,9,17,27,3,3,33,46,12,11,69,646,48,136,830
"./Ship3_Latin-square/2019-09-10_13h02m_Subject 47799.txt","47799",2019-09-10,"13:02",84,60,9,15,24,25,16,1,42,99,26,44,169,639,106,166,911
"./Ship3_Latin-square/2019-09-10_13h08m_Subject 46881.txt","46881",2019-09-10,"13:08",79,60,11,8,19,59,4,5,68,32,5,6,43,375,56,94,525
"./Ship3_Latin-square/2019-09-10_13h08m_Subject 47087.txt","47087",2019-09-10,"13:08",84,60,13,11,24,52,37,14,103,56,49,40,145,254,46,56,356
"./Ship3_Latin-square/2019-09-10_13h08m_Subject 47626.txt","47626",2019-09-10,"13:08",68,50,11,7,18,88,1,15,104,92,16,2,110,197,0,24,221
"./Ship3_Latin-square/2019-09-10_13h08m_Subject 47632.txt","47632",2019-09-10,"13:08",82,60,11,11,22,96,2,9,107,110,88,44,242,847,162,207,1216
"./Ship3_Latin-square/2019-09-10_13h08m_Subject 47634.txt","47634",2019-09-10,"13:08",83,58,14,11,25,90,17,21,128,24,3,11,38,243,32,81,356
"./Ship3_Latin-square/2019-09-10_13h08m_Subject 47640.txt","47640",2019-09-10,"13:08",77,58,10,9,19,51,16,10,77,33,6,6,45,300,29,93,422
"./Ship3_Latin-square/2019-09-10_13h08m_Subject 47754.txt","47754",2019-09-10,"13:08",36,27,5,4,9,31,6,4,41,25,7,61,93,59,4,7,70
"./Ship3_Latin-square/2019-09-10_13h08m_Subject 47800.txt","47800",2019-09-10,"13:08",77,60,9,8,17,55,6,7,68,56,14,7,77,329,45,40,414
"./Ship3_Latin-square/2019-09-10_14h24m_Subject 46876.txt","46876",2019-09-10,"14:24",39,29,9,1,10,53,11,1,65,15,10,1,26,109,0,6,115
"./Ship3_Latin-square/2019-09-10_14h24m_Subject 46877.txt","46877",2019-09-10,"14:24",81,60,12,9,21,56,0,4,60,61,81,165,307,1056,212,194,1462
"./Ship3_Latin-square/2019-09-10_14h24m_Subject 46893.txt","46893",2019-09-10,"14:24",81,60,13,8,21,19,2,2,23,54,13,26,93,670,72,133,875
"./Ship3_Latin-square/2019-09-10_14h24m_Subject 46895.txt","46895",2019-09-10,"14:24",79,60,6,13,19,48,5,9,62,13,13,10,36,284,33,77,394
"./Ship3_Latin-square/2019-09-10_14h24m_Subject 47638.txt","47638",2019-09-10,"14:24",79,59,13,7,20,69,13,10,92,41,18,13,72,199,28,30,257
"./Ship3_Latin-square/2019-09-10_14h24m_Subject 47757.txt","47757",2019-09-10,"14:24",66,47,10,9,19,88,38,15,141,32,13,20,65,250,64,41,355
"./Ship3_Latin-square/2019-09-10_14h24m_Subject 47769.txt","47769",2019-09-10,"14:24",79,58,15,6,21,85,10,10,105,33,15,23,71,330,50,36,416
"./Ship3_Latin-square/2019-09-10_14h24m_Subject 47771.txt","47771",2019-09-10,"14:24",78,60,11,7,18,25,5,1,31,16,10,2,28,595,91,109,795
"./Ship3_Latin-square/2019-09-10_14h24m_Subject 47775.txt","47775",2019-09-10,"14:24",83,60,12,11,23,69,17,11,97,25,20,7,52,405,67,87,559
"./Ship3_Latin-square/2019-09-10_14h24m_Subject 47781.txt","47781",2019-09-10,"14:24",77,60,11,6,17,35,4,5,44,54,18,2,74,596,29,109,734
"./Ship3_Latin-square/2019-09-10_14h24m_Subject 47782.txt","47782",2019-09-10,"14:24",79,60,7,12,19,36,4,1,41,19,3,5,27,896,118,142,1156
"./Ship3_Latin-square/2019-09-10_14h24m_Subject 47783.txt","47783",2019-09-10,"14:24",71,54,13,4,17,104,14,2,120,40,22,4,66,352,28,56,436
"./Ship3_Latin-square/2019-09-10_14h24m_Subject 47785.txt","47785",2019-09-10,"14:24",81,60,11,10,21,52,6,2,60,33,8,31,72,413,46,120,579
"./Ship3_Latin-square/2019-09-10_14h24m_Subject 47786.txt","47786",2019-09-10,"14:24",69,50,8,11,19,73,10,15,98,24,4,14,42,330,49,59,438
"./Ship3_Latin-square/2019-09-10_14h24m_Subject 47788.txt","47788",2019-09-10,"14:24",78,60,7,11,18,29,3,3,35,82,11,14,107,727,83,132,942
"./Ship3_Latin-square/2019-09-10_14h30m_Subject 46888.txt","46888",2019-09-10,"14:30",77,60,7,10,17,42,1,2,45,80,0,14,94,813,84,161,1058
"./Ship3_Latin-square/2019-09-10_14h30m_Subject 46889.txt","46889",2019-09-10,"14:30",77,60,5,12,17,8,2,0,10,22,3,3,28,988,62,246,1296
"./Ship3_Latin-square/2019-09-10_14h30m_Subject 46892.txt","46892",2019-09-10,"14:30",81,60,8,13,21,27,1,3,31,90,11,11,112,861,115,155,1131
"./Ship3_Latin-square/2019-09-10_14h30m_Subject 46898.txt","46898",2019-09-10,"14:30",74,60,9,5,14,38,4,3,45,30,8,4,42,288,19,34,341
"./Ship3_Latin-square/2019-09-10_14h30m_Subject 47097.txt","47097",2019-09-10,"14:30",81,60,13,8,21,62,6,4,72,59,41,36,136,505,66,88,659
"./Ship3_Latin-square/2019-09-10_14h30m_Subject 47099.txt","47099",2019-09-10,"14:30",81,60,9,12,21,9,2,3,14,86,28,34,148,1165,184,248,1597
"./Ship3_Latin-square/2019-09-10_14h30m_Subject 47798.txt","47798",2019-09-10,"14:30",85,60,6,19,25,21,2,3,26,17,0,6,23,243,18,98,359
"./Ship3_Latin-square/2019-09-10_15h30m_Subject 47080.txt","47080",2019-09-10,"15:30",81,60,9,12,21,27,0,5,32,12,0,4,16,376,36,110,522
"./Ship3_Latin-square/2019-09-10_15h30m_Subject 47089.txt","47089",2019-09-10,"15:30",51,36,13,2,15,49,18,1,68,79,73,6,158,108,35,6,149
"./Ship3_Latin-square/2019-09-10_15h30m_Subject 47762.txt","47762",2019-09-10,"15:30",79,60,7,12,19,24,4,3,31,32,5,9,46,229,30,48,307
"./Ship3_Latin-square/2019-09-10_15h30m_Subject 47791.txt","47791",2019-09-10,"15:30",84,60,14,10,24,41,7,4,52,63,29,15,107,361,3,71,435
"./Ship3_Latin-square/2019-09-11_09h50m_Subject 46878.txt","46878",2019-09-11,"09:50",79,60,8,11,19,24,2,4,30,13,6,32,51,1028,155,182,1365
"./Ship3_Latin-square/2019-09-11_09h50m_Subject 46885.txt","46885",2019-09-11,"09:50",80,60,12,8,20,101,14,9,124,25,8,4,37,171,7,44,222
"./Ship3_Latin-square/2019-09-11_09h50m_Subject 46899.txt","46899",2019-09-11,"09:50",79,60,11,8,19,47,5,4,56,28,14,4,46,683,93,121,897
"./Ship3_Latin-square/2019-09-11_09h50m_Subject 47081.txt","47081",2019-09-11,"09:50",84,59,16,9,25,104,4,31,139,84,14,13,111,269,3,59,331
"./Ship3_Latin-square/2019-09-11_09h50m_Subject 47091.txt","47091",2019-09-11,"09:50",78,60,6,12,18,43,0,5,48,72,8,14,94,240,26,61,327
"./Ship3_Latin-square/2019-09-11_09h50m_Subject 47231.txt","47231",2019-09-11,"09:50",80,58,13,9,22,63,6,10,79,32,23,4,59,153,30,22,205
"./Ship3_Latin-square/2019-09-11_09h50m_Subject 47238.txt","47238",2019-09-11,"09:50",82,60,10,12,22,42,3,2,47,54,12,19,85,546,58,143,747
"./Ship3_Latin-square/2019-09-11_09h50m_Subject 47242.txt","47242",2019-09-11,"09:50",83,60,13,10,23,53,5,7,65,81,46,11,138,612,123,139,874
"./Ship3_Latin-square/2019-09-11_09h50m_Subject 47244.txt","47244",2019-09-11,"09:50",78,60,10,8,18,60,5,8,73,120,24,18,162,279,11,53,343
"./Ship3_Latin-square/2019-09-11_09h50m_Subject 47633.txt","47633",2019-09-11,"09:50",78,60,7,11,18,36,4,4,44,65,10,18,93,430,51,79,560
"./Ship3_Latin-square/2019-09-11_09h50m_Subject 47636.txt","47636",2019-09-11,"09:50",69,51,11,7,18,93,21,8,122,72,12,9,93,288,58,31,377
"./Ship3_Latin-square/2019-09-11_09h50m_Subject 47752.txt","47752",2019-09-11,"09:50",80,60,8,12,20,51,6,6,63,46,7,20,73,679,76,206,961
"./Ship3_Latin-square/2019-09-11_09h50m_Subject 47767.txt","47767",2019-09-11,"09:50",83,60,13,10,23,173,26,16,215,28,5,7,40,346,58,101,505
"./Ship3_Latin-square/2019-09-11_09h50m_Subject 47768.txt","47768",2019-09-11,"09:50",82,60,12,10,22,86,8,8,102,28,37,22,87,507,63,101,671
"./Ship3_Latin-square/2019-09-11_09h50m_Subject 47780.txt","47780",2019-09-11,"09:50",79,60,9,10,19,92,8,16,116,26,12,4,42,361,35,95,491
"./Ship3_Latin-square/2019-09-11_09h55m_Subject 46884.txt","46884",2019-09-11,"09:55",68,51,10,7,17,50,5,9,64,43,2,6,51,178,23,24,225
"./Ship3_Latin-square/2019-09-11_09h55m_Subject 47083.txt","47083",2019-09-11,"09:55",59,41,12,6,18,80,12,22,114,70,25,11,106,122,1,14,137
"./Ship3_Latin-square/2019-09-11_09h55m_Subject 47086.txt","47086",2019-09-11,"09:55",82,60,16,6,22,98,18,10,126,22,50,2,74,291,12,44,347
"./Ship3_Latin-square/2019-09-11_09h55m_Subject 47246.txt","47246",2019-09-11,"09:55",70,51,12,7,19,76,21,7,104,26,6,20,52,277,44,92,413
"./Ship3_Latin-square/2019-09-11_09h55m_Subject 47635.txt","47635",2019-09-11,"09:55",76,60,2,14,16,25,0,3,28,56,7,14,77,590,19,140,749
"./Ship3_Latin-square/2019-09-11_09h55m_Subject 47779.txt","47779",2019-09-11,"09:55",77,55,11,11,22,26,4,4,34,27,10,8,45,206,32,29,267
"./Ship3_Latin-square/2019-09-11_09h55m_Subject 47797.txt","47797",2019-09-11,"09:55",74,57,5,12,17,37,4,2,43,27,10,8,45,236,21,58,315
"./Ship3_Latin-square/2019-09-11_11h09m_Subject 46900.txt","46900",2019-09-11,"11:09",78,60,8,10,18,49,1,3,53,147,94,4,245,483,30,123,636
"./Ship3_Latin-square/2019-09-11_11h09m_Subject 46986.txt","46986",2019-09-11,"11:09",70,51,8,11,19,96,7,9,112,19,6,36,61,235,54,48,337
"./Ship3_Latin-square/2019-09-11_11h09m_Subject 47076.txt","47076",2019-09-11,"11:09",80,60,10,10,20,21,0,4,25,25,17,59,101,351,39,105,495
"./Ship3_Latin-square/2019-09-11_11h09m_Subject 47079.txt","47079",2019-09-11,"11:09",77,60,12,5,17,68,12,12,92,61,12,5,78,178,10,35,223
"./Ship3_Latin-square/2019-09-11_11h09m_Subject 47082.txt","47082",2019-09-11,"11:09",82,60,11,11,22,156,6,10,172,170,33,49,252,424,83,96,603
"./Ship3_Latin-square/2019-09-11_11h09m_Subject 47092.txt","47092",2019-09-11,"11:09",83,60,12,11,23,64,0,15,79,58,21,12,91,356,12,131,499
"./Ship3_Latin-square/2019-09-11_11h09m_Subject 47226.txt","47226",2019-09-11,"11:09",80,60,7,13,20,8,0,3,11,64,3,15,82,748,87,185,1020
"./Ship3_Latin-square/2019-09-11_11h09m_Subject 47227.txt","47227",2019-09-11,"11:09",81,60,12,9,21,77,17,8,102,59,21,20,100,243,65,71,379
"./Ship3_Latin-square/2019-09-11_11h09m_Subject 47250.txt","47250",2019-09-11,"11:09",81,60,10,11,21,44,4,8,56,18,10,15,43,465,30,130,625
"./Ship3_Latin-square/2019-09-11_11h09m_Subject 47645.txt","47645",2019-09-11,"11:09",54,40,7,7,14,124,15,21,160,39,18,29,86,155,59,34,248
"./Ship3_Latin-square/2019-09-11_11h09m_Subject 47646.txt","47646",2019-09-11,"11:09",79,60,9,10,19,68,11,7,86,50,23,16,89,707,74,164,945
"./Ship3_Latin-square/2019-09-11_11h09m_Subject 47755.txt","47755",2019-09-11,"11:09",82,60,7,15,22,69,5,10,84,30,2,14,46,418,43,128,589
"./Ship3_Latin-square/2019-09-11_11h09m_Subject 47760.txt","47760",2019-09-11,"11:09",82,60,12,10,22,72,6,17,95,56,13,18,87,358,1,103,462
"./Ship3_Latin-square/2019-09-11_11h09m_Subject 47770.txt","47770",2019-09-11,"11:09",49,34,7,8,15,71,6,10,87,40,9,8,57,124,31,33,188
"./Ship3_Latin-square/2019-09-11_11h09m_Subject 47795.txt","47795",2019-09-11,"11:09",83,60,13,10,23,94,9,9,112,37,19,7,63,383,80,100,563
"./Ship3_Latin-square/2019-09-11_11h14m_Subject 47229.txt","47229",2019-09-11,"11:14",83,60,13,10,23,27,1,6,34,40,21,16,77,598,55,108,761
"./Ship3_Latin-square/2019-09-11_11h14m_Subject 47233.txt","47233",2019-09-11,"11:14",80,60,10,10,20,21,2,8,31,30,11,7,48,406,40,98,544
"./Ship3_Latin-square/2019-09-11_11h14m_Subject 47234.txt","47234",2019-09-11,"11:14",84,60,13,11,24,32,3,6,41,61,16,18,95,382,23,147,552
"./Ship3_Latin-square/2019-09-11_11h14m_Subject 47237.txt","47237",2019-09-11,"11:14",75,60,9,6,15,79,9,3,91,23,6,6,35,518,72,55,645
"./Ship3_Latin-square/2019-09-11_11h14m_Subject 47241.txt","47241",2019-09-11,"11:14",88,60,0,28,28,24,0,10,34,12,0,2,14,1033,0,372,1405
"./Ship3_Latin-square/2019-09-11_11h14m_Subject 47247.txt","47247",2019-09-11,"11:14",71,60,7,4,11,74,6,9,89,31,3,4,38,171,1,12,184
"./Ship3_Latin-square/2019-09-11_11h14m_Subject 47777.txt","47777",2019-09-11,"11:14",80,60,9,11,20,45,7,7,59,25,1,5,31,411,70,107,588
"./Ship3_Latin-square/2019-09-11_11h14m_Subject 47784.txt","47784",2019-09-11,"11:14",70,54,14,2,16,195,31,6,232,74,9,6,89,440,4,28,472
"./Ship3_Latin-square/2019-09-11_12h29m_Subject 46880.txt","46880",2019-09-11,"12:29",75,60,9,6,15,21,2,4,27,11,10,4,25,424,24,81,529
"./Ship3_Latin-square/2019-09-11_12h29m_Subject 46882.txt","46882",2019-09-11,"12:29",82,60,12,10,22,118,16,20,154,154,46,25,225,522,82,161,765
"./Ship3_Latin-square/2019-09-11_12h29m_Subject 46883.txt","46883",2019-09-11,"12:29",80,60,8,12,20,50,2,6,58,123,10,5,138,523,67,121,711
"./Ship3_Latin-square/2019-09-11_12h29m_Subject 46894.txt","46894",2019-09-11,"12:29",78,60,7,11,18,49,8,4,61,36,3,1,40,386,50,86,522
"./Ship3_Latin-square/2019-09-11_12h29m_Subject 47088.txt","47088",2019-09-11,"12:29",78,60,10,8,18,85,7,21,113,72,12,14,98,347,3,63,413
"./Ship3_Latin-square/2019-09-11_12h29m_Subject 47228.txt","47228",2019-09-11,"12:29",77,60,7,10,17,27,2,3,32,36,5,6,47,498,60,69,627
"./Ship3_Latin-square/2019-09-11_12h29m_Subject 47243.txt","47243",2019-09-11,"12:29",80,60,10,10,20,79,12,10,101,46,40,13,99,663,122,129,914
"./Ship3_Latin-square/2019-09-11_12h29m_Subject 47249.txt","47249",2019-09-11,"12:29",52,37,11,4,15,58,26,5,89,53,55,8,116,183,14,24,221
"./Ship3_Latin-square/2019-09-11_12h29m_Subject 47639.txt","47639",2019-09-11,"12:29",83,60,12,11,23,12,4,2,18,10,3,13,26,878,169,172,1219
"./Ship3_Latin-square/2019-09-11_12h29m_Subject 47649.txt","47649",2019-09-11,"12:29",77,60,10,7,17,32,2,6,40,17,13,7,37,454,68,73,595
"./Ship3_Latin-square/2019-09-11_12h29m_Subject 47758.txt","47758",2019-09-11,"12:29",83,60,13,10,23,46,2,14,62,20,4,13,37,372,2,107,481
"./Ship3_Latin-square/2019-09-11_12h29m_Subject 47759.txt","47759",2019-09-11,"12:29",83,60,14,9,23,38,6,9,53,62,11,13,86,297,5,93,395
"./Ship3_Latin-square/2019-09-11_12h29m_Subject 47776.txt","47776",2019-09-11,"12:29",82,60,9,13,22,20,3,3,26,78,24,15,117,992,168,231,1391
"./Ship3_Latin-square/2019-09-11_12h29m_Subject 47799.txt","47799",2019-09-11,"12:29",82,60,11,11,22,51,12,12,75,70,34,15,119,281,0,116,397
"./Ship3_Latin-square/2019-09-11_12h35m_Subject 46881.txt","46881",2019-09-11,"12:35",82,60,10,12,22,61,4,6,71,21,4,25,50,493,66,113,672
"./Ship3_Latin-square/2019-09-11_12h35m_Subject 47087.txt","47087",2019-09-11,"12:35",81,58,10,13,23,45,23,6,74,57,15,14,86,318,57,73,448
"./Ship3_Latin-square/2019-09-11_12h35m_Subject 47626.txt","47626",2019-09-11,"12:35",63,48,9,6,15,43,7,5,55,45,11,9,65,221,24,25,270
"./Ship3_Latin-square/2019-09-11_12h35m_Subject 47632.txt","47632",2019-09-11,"12:35",86,60,14,12,26,28,4,14,46,14,27,26,67,780,138,199,1117
"./Ship3_Latin-square/2019-09-11_12h35m_Subject 47634.txt","47634",2019-09-11,"12:35",72,54,12,6,18,90,18,7,115,92,44,31,167,261,46,28,335
"./Ship3_Latin-square/2019-09-11_12h35m_Subject 47640.txt","47640",2019-09-11,"12:35",71,52,11,8,19,88,14,34,136,29,6,8,43,172,36,35,243
"./Ship3_Latin-square/2019-09-11_12h35m_Subject 47754.txt","47754",2019-09-11,"12:35",55,40,8,7,15,113,11,14,138,68,11,44,123,160,27,21,208
"./Ship3_Latin-square/2019-09-11_12h35m_Subject 47800.txt","47800",2019-09-11,"12:35",77,60,10,7,17,49,12,9,70,63,12,5,80,256,41,36,333
"./Ship3_Latin-square/2019-09-11_13h50m_Subject 46876.txt","46876",2019-09-11,"13:50",46,35,10,1,11,36,6,0,42,13,13,0,26,144,17,6,167
"./Ship3_Latin-square/2019-09-11_13h50m_Subject 46877.txt","46877",2019-09-11,"13:50",78,60,7,11,18,21,1,2,24,275,120,13,408,1071,110,228,1409
"./Ship3_Latin-square/2019-09-11_13h50m_Subject 46893.txt","46893",2019-09-11,"13:50",78,60,9,9,18,15,1,2,18,63,7,7,77,1077,156,197,1430
"./Ship3_Latin-square/2019-09-11_13h50m_Subject 46895.txt","46895",2019-09-11,"13:50",77,58,8,11,19,49,7,5,61,17,3,7,27,245,27,77,349
"./Ship3_Latin-square/2019-09-11_13h50m_Subject 47638.txt","47638",2019-09-11,"13:50",77,55,12,10,22,71,19,13,103,67,30,35,132,264,39,59,362
"./Ship3_Latin-square/2019-09-11_13h50m_Subject 47757.txt","47757",2019-09-11,"13:50",66,47,14,5,19,123,28,15,166,34,16,7,57,172,21,28,221
"./Ship3_Latin-square/2019-09-11_13h50m_Subject 47769.txt","47769",2019-09-11,"13:50",79,58,13,8,21,64,32,11,107,31,10,19,60,449,117,63,629
"./Ship3_Latin-square/2019-09-11_13h50m_Subject 47771.txt","47771",2019-09-11,"13:50",80,60,11,9,20,27,4,4,35,23,15,22,60,467,33,102,602
"./Ship3_Latin-square/2019-09-11_13h50m_Subject 47775.txt","47775",2019-09-11,"13:50",80,60,11,9,20,99,16,14,129,39,15,3,57,285,32,65,382
"./Ship3_Latin-square/2019-09-11_13h50m_Subject 47781.txt","47781",2019-09-11,"13:50",81,60,13,8,21,23,4,3,30,30,25,3,58,702,84,135,921
"./Ship3_Latin-square/2019-09-11_13h50m_Subject 47782.txt","47782",2019-09-11,"13:50",77,60,11,6,17,73,11,8,92,34,17,6,57,354,8,62,424
"./Ship3_Latin-square/2019-09-11_13h50m_Subject 47783.txt","47783",2019-09-11,"13:50",72,52,13,7,20,100,18,14,132,54,28,10,92,354,53,30,437
"./Ship3_Latin-square/2019-09-11_13h50m_Subject 47785.txt","47785",2019-09-11,"13:50",79,60,10,9,19,19,4,2,25,32,5,13,50,529,122,51,702
"./Ship3_Latin-square/2019-09-11_13h50m_Subject 47786.txt","47786",2019-09-11,"13:50",56,41,12,3,15,104,17,9,130,29,11,2,42,158,2,20,180
"./Ship3_Latin-square/2019-09-11_13h50m_Subject 47788.txt","47788",2019-09-11,"13:50",82,60,14,8,22,79,7,6,92,81,40,11,132,287,7,60,354
"./Ship3_Latin-square/2019-09-11_13h53m_Subject 46888.txt","46888",2019-09-11,"13:53",84,60,11,13,24,18,5,5,28,43,9,31,83,477,63,143,683
"./Ship3_Latin-square/2019-09-11_13h53m_Subject 46889.txt","46889",2019-09-11,"13:53",74,60,9,5,14,44,8,8,60,28,1,4,33,530,12,79,621
"./Ship3_Latin-square/2019-09-11_13h53m_Subject 46892.txt","46892",2019-09-11,"13:53",80,60,13,7,20,51,5,4,60,43,3,3,49,459,26,82,567
"./Ship3_Latin-square/2019-09-11_13h53m_Subject 46898.txt","46898",2019-09-11,"13:53",77,60,5,12,17,27,0,4,31,25,6,7,38,668,83,78,829
"./Ship3_Latin-square/2019-09-11_13h53m_Subject 47097.txt","47097",2019-09-11,"13:53",78,60,10,8,18,16,2,3,21,77,15,19,111,695,92,119,906
"./Ship3_Latin-square/2019-09-11_13h53m_Subject 47099.txt","47099",2019-09-11,"13:53",84,60,13,11,24,48,8,19,75,36,18,12,66,439,3,133,575
"./Ship3_Latin-square/2019-09-11_13h53m_Subject 47798.txt","47798",2019-09-11,"13:53",82,60,4,18,22,18,0,7,25,8,3,0,11,205,8,93,306
"./Ship3_Latin-square/2019-09-11_15h03m_Subject 47080.txt","47080",2019-09-11,"15:03",79,60,7,12,19,19,3,1,23,19,4,10,33,662,89,155,906
"./Ship3_Latin-square/2019-09-11_15h03m_Subject 47089.txt","47089",2019-09-11,"15:03",73,54,14,5,19,84,7,14,105,60,28,6,94,191,20,15,226
"./Ship3_Latin-square/2019-09-11_15h03m_Subject 47762.txt","47762",2019-09-11,"15:03",80,60,9,11,20,25,1,9,35,18,1,12,31,207,33,44,284
"./Ship3_Latin-square/2019-09-11_15h03m_Subject 47791.txt","47791",2019-09-11,"15:03",81,60,10,11,21,15,2,18,35,19,12,31,62,485,43,108,636
"./Ship3_Latin-square/2019-09-12_10h09m_Subject 46878.txt","46878",2019-09-12,"10:09",79,60,10,9,19,24,1,5,30,30,11,27,68,648,139,96,883
"./Ship3_Latin-square/2019-09-12_10h09m_Subject 46885.txt","46885",2019-09-12,"10:09",73,53,13,7,20,95,12,25,132,8,6,18,32,203,42,25,270
"./Ship3_Latin-square/2019-09-12_10h09m_Subject 46899.txt","46899",2019-09-12,"10:09",68,49,17,2,19,105,19,8,132,43,22,0,65,342,8,24,374
"./Ship3_Latin-square/2019-09-12_10h09m_Subject 47081.txt","47081",2019-09-12,"10:09",80,60,9,11,20,27,8,4,39,26,0,8,34,613,115,123,851
"./Ship3_Latin-square/2019-09-12_10h09m_Subject 47091.txt","47091",2019-09-12,"10:09",77,59,14,4,18,69,16,4,89,70,38,7,115,202,8,11,221
"./Ship3_Latin-square/2019-09-12_10h09m_Subject 47231.txt","47231",2019-09-12,"10:09",60,44,13,3,16,72,11,6,89,50,55,3,108,108,8,2,118
"./Ship3_Latin-square/2019-09-12_10h09m_Subject 47238.txt","47238",2019-09-12,"10:09",81,60,13,8,21,25,3,3,31,27,18,9,54,459,64,78,601
"./Ship3_Latin-square/2019-09-12_10h09m_Subject 47242.txt","47242",2019-09-12,"10:09",83,60,15,8,23,45,13,9,67,77,72,6,155,455,53,117,625
"./Ship3_Latin-square/2019-09-12_10h09m_Subject 47244.txt","47244",2019-09-12,"10:09",83,60,14,9,23,56,8,11,75,80,43,13,136,347,50,48,445
"./Ship3_Latin-square/2019-09-12_10h09m_Subject 47633.txt","47633",2019-09-12,"10:09",80,60,7,13,20,40,2,6,48,56,9,9,74,354,40,67,461
"./Ship3_Latin-square/2019-09-12_10h09m_Subject 47636.txt","47636",2019-09-12,"10:09",81,60,3,18,21,86,3,21,110,73,1,58,132,432,38,95,565
"./Ship3_Latin-square/2019-09-12_10h09m_Subject 47752.txt","47752",2019-09-12,"10:09",80,60,14,6,20,91,19,12,122,80,39,6,125,312,24,49,385
"./Ship3_Latin-square/2019-09-12_10h09m_Subject 47767.txt","47767",2019-09-12,"10:09",68,50,11,7,18,91,10,21,122,178,7,4,189,147,20,26,193
"./Ship3_Latin-square/2019-09-12_10h09m_Subject 47768.txt","47768",2019-09-12,"10:09",82,60,7,15,22,75,3,5,83,32,6,11,49,703,82,147,932
"./Ship3_Latin-square/2019-09-12_10h09m_Subject 47780.txt","47780",2019-09-12,"10:09",78,60,8,10,18,103,10,11,124,42,8,54,104,346,40,80,466
"./Ship3_Latin-square/2019-09-12_10h12m_Subject 46884.txt","46884",2019-09-12,"10:12",77,60,8,9,17,46,3,7,56,26,4,19,49,188,58,30,276
"./Ship3_Latin-square/2019-09-12_10h12m_Subject 47083.txt","47083",2019-09-12,"10:12",73,52,11,10,21,81,7,7,95,42,12,30,84,220,24,65,309
"./Ship3_Latin-square/2019-09-12_10h12m_Subject 47086.txt","47086",2019-09-12,"10:12",74,60,6,8,14,46,5,3,54,21,12,5,38,477,49,72,598
"./Ship3_Latin-square/2019-09-12_10h12m_Subject 47246.txt","47246",2019-09-12,"10:12",80,60,10,10,20,52,7,13,72,35,9,3,47,369,50,83,502
"./Ship3_Latin-square/2019-09-12_10h12m_Subject 47635.txt","47635",2019-09-12,"10:12",82,60,11,11,22,37,3,8,48,46,15,10,71,551,73,111,735
"./Ship3_Latin-square/2019-09-12_10h12m_Subject 47779.txt","47779",2019-09-12,"10:12",59,45,8,6,14,30,6,3,39,24,5,3,32,70,17,8,95
"./Ship3_Latin-square/2019-09-12_10h12m_Subject 47797.txt","47797",2019-09-12,"10:12",79,58,7,14,21,34,5,8,47,30,1,8,39,187,34,49,270
"./Ship3_Latin-square/2019-09-12_11h32m_Subject 46900.txt","46900",2019-09-12,"11:32",79,60,13,6,19,23,4,0,27,71,75,24,170,684,118,85,887
"./Ship3_Latin-square/2019-09-12_11h32m_Subject 46986.txt","46986",2019-09-12,"11:32",59,41,12,6,18,75,17,14,106,11,4,4,19,126,8,25,159
"./Ship3_Latin-square/2019-09-12_11h32m_Subject 47076.txt","47076",2019-09-12,"11:32",81,60,11,10,21,17,0,4,21,47,7,24,78,520,63,127,710
"./Ship3_Latin-square/2019-09-12_11h32m_Subject 47079.txt","47079",2019-09-12,"11:32",80,60,10,10,20,44,4,1,49,57,8,9,74,309,52,62,423
"./Ship3_Latin-square/2019-09-12_11h32m_Subject 47082.txt","47082",2019-09-12,"11:32",80,60,9,11,20,52,1,7,60,119,81,64,264,333,36,94,463
"./Ship3_Latin-square/2019-09-12_11h32m_Subject 47092.txt","47092",2019-09-12,"11:32",79,60,12,7,19,27,4,3,34,27,13,8,48,571,48,101,720
"./Ship3_Latin-square/2019-09-12_11h32m_Subject 47226.txt","47226",2019-09-12,"11:32",79,60,8,11,19,22,0,0,22,82,5,15,102,699,73,233,1005
"./Ship3_Latin-square/2019-09-12_11h32m_Subject 47227.txt","47227",2019-09-12,"11:32",79,60,10,9,19,75,15,12,102,37,22,6,65,234,33,51,318
"./Ship3_Latin-square/2019-09-12_11h32m_Subject 47250.txt","47250",2019-09-12,"11:32",80,60,10,10,20,11,2,3,16,20,7,11,38,898,122,176,1196
"./Ship3_Latin-square/2019-09-12_11h32m_Subject 47645.txt","47645",2019-09-12,"11:32",43,31,9,3,12,84,32,6,122,28,20,4,52,89,6,14,109
"./Ship3_Latin-square/2019-09-12_11h32m_Subject 47646.txt","47646",2019-09-12,"11:32",82,60,11,11,22,22,9,1,32,79,22,21,122,805,51,314,1170
"./Ship3_Latin-square/2019-09-12_11h32m_Subject 47755.txt","47755",2019-09-12,"11:32",84,60,16,8,24,138,12,33,183,44,7,5,56,400,18,113,531
"./Ship3_Latin-square/2019-09-12_11h32m_Subject 47760.txt","47760",2019-09-12,"11:32",82,60,11,11,22,71,8,4,83,72,21,7,100,458,44,124,626
"./Ship3_Latin-square/2019-09-12_11h32m_Subject 47770.txt","47770",2019-09-12,"11:32",48,36,6,6,12,43,6,6,55,48,10,8,66,109,14,11,134
"./Ship3_Latin-square/2019-09-12_11h32m_Subject 47795.txt","47795",2019-09-12,"11:32",79,60,10,9,19,90,14,16,120,44,15,6,65,274,19,32,325
"./Ship3_Latin-square/2019-09-12_11h37m_Subject 47229.txt","47229",2019-09-12,"11:37",78,60,9,9,18,27,3,4,34,24,7,7,38,907,160,119,1186
"./Ship3_Latin-square/2019-09-12_11h37m_Subject 47233.txt","47233",2019-09-12,"11:37",80,60,8,12,20,14,2,0,16,15,5,29,49,411,44,116,571
"./Ship3_Latin-square/2019-09-12_11h37m_Subject 47234.txt","47234",2019-09-12,"11:37",80,60,8,12,20,83,43,28,154,81,9,28,118,532,82,119,733
"./Ship3_Latin-square/2019-09-12_11h37m_Subject 47237.txt","47237",2019-09-12,"11:37",78,60,10,8,18,28,5,2,35,19,19,20,58,452,62,121,635
"./Ship3_Latin-square/2019-09-12_11h37m_Subject 47241.txt","47241",2019-09-12,"11:37",83,60,1,22,23,19,0,9,28,8,0,3,11,997,19,356,1372
"./Ship3_Latin-square/2019-09-12_11h37m_Subject 47247.txt","47247",2019-09-12,"11:37",71,60,5,6,11,22,0,1,23,38,4,0,42,336,17,54,407
"./Ship3_Latin-square/2019-09-12_11h37m_Subject 47777.txt","47777",2019-09-12,"11:37",84,60,12,12,24,48,4,15,67,20,1,1,22,378,63,87,528
"./Ship3_Latin-square/2019-09-12_11h37m_Subject 47784.txt","47784",2019-09-12,"11:37",81,60,12,9,21,111,19,12,142,99,88,13,200,522,50,81,653
"./Ship3_Latin-square/2019-09-12_12h45m_Subject 46880.txt","46880",2019-09-12,"12:45",79,60,6,13,19,9,0,0,9,19,2,9,30,616,32,223,871
"./Ship3_Latin-square/2019-09-12_12h45m_Subject 46882.txt","46882",2019-09-12,"12:45",85,60,14,11,25,60,15,5,80,129,11,11,151,432,43,207,682
"./Ship3_Latin-square/2019-09-12_12h45m_Subject 46883.txt","46883",2019-09-12,"12:45",79,60,11,8,19,32,2,6,40,95,31,4,130,322,56,47,425
"./Ship3_Latin-square/2019-09-12_12h45m_Subject 46894.txt","46894",2019-09-12,"12:45",82,56,15,11,26,67,21,15,103,31,14,14,59,211,8,94,313
"./Ship3_Latin-square/2019-09-12_12h45m_Subject 46896.txt","46896",2019-09-12,"12:45",82,60,9,13,22,26,1,7,34,64,33,17,114,701,112,145,958
"./Ship3_Latin-square/2019-09-12_12h45m_Subject 47088.txt","47088",2019-09-12,"12:45",80,60,9,11,20,44,13,6,63,100,36,38,174,676,112,113,901
"./Ship3_Latin-square/2019-09-12_12h45m_Subject 47228.txt","47228",2019-09-12,"12:45",83,60,10,13,23,45,7,8,60,20,18,14,52,269,18,142,429
"./Ship3_Latin-square/2019-09-12_12h45m_Subject 47243.txt","47243",2019-09-12,"12:45",82,60,12,10,22,114,8,26,148,37,12,17,66,396,10,99,505
"./Ship3_Latin-square/2019-09-12_12h45m_Subject 47249.txt","47249",2019-09-12,"12:45",80,60,7,13,20,61,2,7,70,83,19,29,131,412,56,79,547
"./Ship3_Latin-square/2019-09-12_12h45m_Subject 47639.txt","47639",2019-09-12,"12:45",83,60,13,10,23,37,3,8,48,42,15,9,66,444,17,104,565
"./Ship3_Latin-square/2019-09-12_12h45m_Subject 47649.txt","47649",2019-09-12,"12:45",85,60,13,12,25,52,15,15,82,15,4,3,22,205,10,52,267
"./Ship3_Latin-square/2019-09-12_12h45m_Subject 47758.txt","47758",2019-09-12,"12:45",80,60,7,13,20,30,10,1,41,31,1,7,39,859,84,186,1129
"./Ship3_Latin-square/2019-09-12_12h45m_Subject 47759.txt","47759",2019-09-12,"12:45",83,60,12,11,23,33,19,9,61,72,32,16,120,616,106,131,853
"./Ship3_Latin-square/2019-09-12_12h45m_Subject 47776.txt","47776",2019-09-12,"12:45",69,60,8,1,9,60,1,2,63,39,11,5,55,716,14,19,749
"./Ship3_Latin-square/2019-09-12_12h45m_Subject 47799.txt","47799",2019-09-12,"12:45",78,60,7,11,18,25,4,3,32,75,12,19,106,942,139,177,1258
"./Ship3_Latin-square/2019-09-12_12h49m_Subject 46881.txt","46881",2019-09-12,"12:49",79,60,9,10,19,39,6,5,50,26,6,6,38,372,37,108,517
"./Ship3_Latin-square/2019-09-12_12h49m_Subject 47087.txt","47087",2019-09-12,"12:49",67,50,10,7,17,47,5,7,59,39,11,3,53,226,31,28,285
"./Ship3_Latin-square/2019-09-12_12h49m_Subject 47626.txt","47626",2019-09-12,"12:49",78,58,10,10,20,85,28,19,132,44,18,52,114,288,39,45,372
"./Ship3_Latin-square/2019-09-12_12h49m_Subject 47632.txt","47632",2019-09-12,"12:49",83,60,9,14,23,46,7,8,61,54,22,87,163,620,102,119,841
"./Ship3_Latin-square/2019-09-12_12h49m_Subject 47634.txt","47634",2019-09-12,"12:49",85,60,14,11,25,58,9,12,79,29,32,14,75,259,44,91,394
"./Ship3_Latin-square/2019-09-12_12h49m_Subject 47640.txt","47640",2019-09-12,"12:49",61,46,12,3,15,63,14,6,83,24,6,0,30,240,29,10,279
"./Ship3_Latin-square/2019-09-12_12h49m_Subject 47754.txt","47754",2019-09-12,"12:49",56,44,8,4,12,81,5,10,96,45,8,39,92,100,2,20,122
"./Ship3_Latin-square/2019-09-12_12h49m_Subject 47800.txt","47800",2019-09-12,"12:49",76,60,8,8,16,81,9,12,102,68,15,16,99,371,60,42,473
"./Ship3_Latin-square/2019-09-12_13h51m_Subject 46876.txt","46876",2019-09-12,"13:51",64,45,9,10,19,42,7,11,60,26,6,17,49,248,24,53,325
"./Ship3_Latin-square/2019-09-12_13h51m_Subject 46877.txt","46877",2019-09-12,"13:51",80,60,10,10,20,17,0,7,24,88,13,11,112,793,167,93,1053
"./Ship3_Latin-square/2019-09-12_13h51m_Subject 46893.txt","46893",2019-09-12,"13:51",79,60,11,8,19,32,0,10,42,79,15,18,112,580,17,109,706
"./Ship3_Latin-square/2019-09-12_13h51m_Subject 46895.txt","46895",2019-09-12,"13:51",69,49,13,7,20,74,9,8,91,65,24,11,100,102,3,39,144
"./Ship3_Latin-square/2019-09-12_13h51m_Subject 47638.txt","47638",2019-09-12,"13:51",78,59,12,7,19,70,11,14,95,52,9,9,70,149,4,29,182
"./Ship3_Latin-square/2019-09-12_13h51m_Subject 47757.txt","47757",2019-09-12,"13:51",75,53,8,14,22,92,16,22,130,44,8,16,68,351,56,97,504
"./Ship3_Latin-square/2019-09-12_13h51m_Subject 47769.txt","47769",2019-09-12,"13:51",74,56,13,5,18,140,35,23,198,46,22,10,78,211,8,21,240
"./Ship3_Latin-square/2019-09-12_13h51m_Subject 47771.txt","47771",2019-09-12,"13:51",82,60,11,11,22,16,1,5,22,39,22,14,75,717,119,150,986
"./Ship3_Latin-square/2019-09-12_13h51m_Subject 47775.txt","47775",2019-09-12,"13:51",79,60,10,9,19,70,17,6,93,56,6,5,67,434,58,64,556
"./Ship3_Latin-square/2019-09-12_13h51m_Subject 47781.txt","47781",2019-09-12,"13:51",81,60,10,11,21,19,3,8,30,43,13,1,57,594,35,190,819
"./Ship3_Latin-square/2019-09-12_13h51m_Subject 47782.txt","47782",2019-09-12,"13:51",81,60,9,12,21,33,6,4,43,19,2,1,22,826,157,143,1126
"./Ship3_Latin-square/2019-09-12_13h51m_Subject 47783.txt","47783",2019-09-12,"13:51",71,53,13,5,18,87,11,10,108,140,29,6,175,241,33,27,301
"./Ship3_Latin-square/2019-09-12_13h51m_Subject 47785.txt","47785",2019-09-12,"13:51",86,60,14,12,26,34,3,7,44,31,14,13,58,427,61,105,593
"./Ship3_Latin-square/2019-09-12_13h51m_Subject 47786.txt","47786",2019-09-12,"13:51",77,57,9,11,20,130,7,15,152,79,14,24,117,358,59,114,531
"./Ship3_Latin-square/2019-09-12_13h51m_Subject 47788.txt","47788",2019-09-12,"13:51",76,60,7,9,16,20,3,4,27,64,13,13,90,772,111,130,1013
"./Ship3_Latin-square/2019-09-12_13h59m_Subject 46888.txt","46888",2019-09-12,"13:59",79,60,7,12,19,19,1,1,21,66,7,8,81,960,120,207,1287
"./Ship3_Latin-square/2019-09-12_13h59m_Subject 46889.txt","46889",2019-09-12,"13:59",79,60,8,11,19,33,56,2,91,18,5,11,34,795,65,260,1120
"./Ship3_Latin-square/2019-09-12_13h59m_Subject 46892.txt","46892",2019-09-12,"13:59",79,60,8,11,19,24,4,2,30,49,4,1,54,852,156,163,1171
"./Ship3_Latin-square/2019-09-12_13h59m_Subject 46898.txt","46898",2019-09-12,"13:59",80,60,7,13,20,30,5,3,38,12,2,5,19,508,44,99,651
"./Ship3_Latin-square/2019-09-12_13h59m_Subject 47097.txt","47097",2019-09-12,"13:59",76,60,7,9,16,19,3,7,29,63,11,13,87,558,57,68,683
"./Ship3_Latin-square/2019-09-12_13h59m_Subject 47099.txt","47099",2019-09-12,"13:59",83,60,12,11,23,18,5,0,23,58,30,5,93,1564,330,336,2230
"./Ship3_Latin-square/2019-09-12_13h59m_Subject 47798.txt","47798",2019-09-12,"13:59",84,60,11,13,24,34,2,4,40,20,8,0,28,165,29,56,250
"./Ship3_Latin-square/2019-09-12_15h12m_Subject 47080.txt","47080",2019-09-12,"15:12",83,60,12,11,23,42,5,10,57,30,8,12,50,347,12,180,539
"./Ship3_Latin-square/2019-09-12_15h12m_Subject 47089.txt","47089",2019-09-12,"15:12",67,49,10,8,18,78,7,8,93,97,40,45,182,214,34,45,293
"./Ship3_Latin-square/2019-09-12_15h12m_Subject 47762.txt","47762",2019-09-12,"15:12",49,36,9,4,13,88,5,14,107,21,5,2,28,85,4,12,101
"./Ship3_Latin-square/2019-09-12_15h12m_Subject 47791.txt","47791",2019-09-12,"15:12",83,60,12,11,23,12,1,1,14,17,5,5,27,598,112,103,813
"./Ship3_Latin-square/2019-09-13_09h58m_Subject 46878.txt","46878",2019-09-13,"09:58",84,60,11,13,24,102,3,45,150,57,8,17,82,319,9,119,447
"./Ship3_Latin-square/2019-09-13_09h58m_Subject 46885.txt","46885",2019-09-13,"09:58",81,60,9,12,21,98,11,18,127,20,1,22,43,313,35,57,405
"./Ship3_Latin-square/2019-09-13_09h58m_Subject 46899.txt","46899",2019-09-13,"09:58",83,60,13,10,23,95,14,31,140,57,12,13,82,400,44,94,538
"./Ship3_Latin-square/2019-09-13_09h58m_Subject 47081.txt","47081",2019-09-13,"09:58",78,60,8,10,18,36,5,2,43,27,9,6,42,477,45,103,625
"./Ship3_Latin-square/2019-09-13_09h58m_Subject 47091.txt","47091",2019-09-13,"09:58",79,60,6,13,19,48,4,9,61,66,14,15,95,277,21,82,380
"./Ship3_Latin-square/2019-09-13_09h58m_Subject 47231.txt","47231",2019-09-13,"09:58",75,56,11,8,19,63,13,12,88,47,34,3,84,172,16,37,225
"./Ship3_Latin-square/2019-09-13_09h58m_Subject 47238.txt","47238",2019-09-13,"09:58",81,60,12,9,21,16,4,2,22,45,18,15,78,501,128,81,710
"./Ship3_Latin-square/2019-09-13_09h58m_Subject 47242.txt","47242",2019-09-13,"09:58",83,60,8,15,23,54,1,6,61,125,36,26,187,695,88,217,1000
"./Ship3_Latin-square/2019-09-13_09h58m_Subject 47244.txt","47244",2019-09-13,"09:58",82,60,10,12,22,52,6,4,62,67,26,126,219,426,80,97,603
"./Ship3_Latin-square/2019-09-13_09h58m_Subject 47633.txt","47633",2019-09-13,"09:58",83,60,12,11,23,92,8,29,129,78,21,28,127,238,5,72,315
"./Ship3_Latin-square/2019-09-13_09h58m_Subject 47636.txt","47636",2019-09-13,"09:58",74,60,7,7,14,64,9,5,78,101,13,14,128,263,22,41,326
"./Ship3_Latin-square/2019-09-13_09h58m_Subject 47752.txt","47752",2019-09-13,"09:58",84,60,15,9,24,82,6,9,97,48,32,28,108,445,61,47,553
"./Ship3_Latin-square/2019-09-13_09h58m_Subject 47767.txt","47767",2019-09-13,"09:58",73,52,13,8,21,88,43,4,135,121,54,81,256,232,57,48,337
"./Ship3_Latin-square/2019-09-13_09h58m_Subject 47768.txt","47768",2019-09-13,"09:58",78,60,10,8,18,42,4,6,52,18,6,9,33,384,69,81,534
"./Ship3_Latin-square/2019-09-13_09h58m_Subject 47780.txt","47780",2019-09-13,"09:58",79,60,6,13,19,53,5,17,75,53,10,9,72,415,51,101,567
"./Ship3_Latin-square/2019-09-13_10h03m_Subject 46884.txt","46884",2019-09-13,"10:03",64,45,9,10,19,52,3,20,75,31,11,3,45,146,20,25,191
"./Ship3_Latin-square/2019-09-13_10h03m_Subject 47083.txt","47083",2019-09-13,"10:03",69,50,8,11,19,71,9,12,92,62,7,35,104,251,32,77,360
"./Ship3_Latin-square/2019-09-13_10h03m_Subject 47086.txt","47086",2019-09-13,"10:03",74,60,7,7,14,42,0,3,45,26,2,0,28,414,57,54,525
"./Ship3_Latin-square/2019-09-13_10h03m_Subject 47246.txt","47246",2019-09-13,"10:03",19,13,6,0,6,14,7,0,21,4,20,0,24,30,12,0,42
"./Ship3_Latin-square/2019-09-13_10h03m_Subject 47635.txt","47635",2019-09-13,"10:03",81,60,10,11,21,107,20,26,153,79,21,15,115,200,1,73,274
"./Ship3_Latin-square/2019-09-13_10h03m_Subject 47779.txt","47779",2019-09-13,"10:03",30,23,0,7,7,26,0,7,33,10,0,7,17,23,0,16,39
"./Ship3_Latin-square/2019-09-13_10h03m_Subject 47797.txt","47797",2019-09-13,"10:03",75,55,7,13,20,55,3,3,61,22,15,2,39,307,58,52,417
"./Ship3_Latin-square/2019-09-13_11h40m_Subject 46900.txt","46900",2019-09-13,"11:40",80,60,10,10,20,28,1,8,37,85,32,29,146,493,33,115,641
"./Ship3_Latin-square/2019-09-13_11h40m_Subject 46986.txt","46986",2019-09-13,"11:40",43,34,7,2,9,48,12,4,64,3,10,5,18,132,57,13,202
"./Ship3_Latin-square/2019-09-13_11h40m_Subject 47076.txt","47076",2019-09-13,"11:40",74,60,8,6,14,7,0,2,9,18,3,14,35,622,112,62,796
"./Ship3_Latin-square/2019-09-13_11h40m_Subject 47079.txt","47079",2019-09-13,"11:40",84,60,10,14,24,29,1,2,32,58,10,18,86,284,58,74,416
"./Ship3_Latin-square/2019-09-13_11h40m_Subject 47082.txt","47082",2019-09-13,"11:40",57,42,7,8,15,82,16,6,104,131,34,34,199,309,59,68,436
"./Ship3_Latin-square/2019-09-13_11h40m_Subject 47092.txt","47092",2019-09-13,"11:40",77,60,8,9,17,15,3,3,21,39,11,8,58,676,76,121,873
"./Ship3_Latin-square/2019-09-13_11h40m_Subject 47098.txt","47098",2019-09-13,"11:40",83,60,9,14,23,69,9,6,84,30,35,57,122,378,34,96,508
"./Ship3_Latin-square/2019-09-13_11h40m_Subject 47226.txt","47226",2019-09-13,"11:40",77,60,6,11,17,16,1,6,23,57,8,6,71,1081,131,135,1347
"./Ship3_Latin-square/2019-09-13_11h40m_Subject 47227.txt","47227",2019-09-13,"11:40",77,60,8,9,17,69,6,7,82,91,20,5,116,448,49,76,573
"./Ship3_Latin-square/2019-09-13_11h40m_Subject 47250.txt","47250",2019-09-13,"11:40",72,53,12,7,19,75,0,11,86,30,15,23,68,349,7,59,415
"./Ship3_Latin-square/2019-09-13_11h40m_Subject 47645.txt","47645",2019-09-13,"11:40",67,48,8,11,19,108,16,16,140,45,29,32,106,259,45,57,361
"./Ship3_Latin-square/2019-09-13_11h40m_Subject 47646.txt","47646",2019-09-13,"11:40",83,60,11,12,23,50,6,1,57,103,24,85,212,966,179,193,1338
"./Ship3_Latin-square/2019-09-13_11h40m_Subject 47755.txt","47755",2019-09-13,"11:40",78,60,11,7,18,65,13,12,90,21,14,2,37,480,65,89,634
"./Ship3_Latin-square/2019-09-13_11h40m_Subject 47760.txt","47760",2019-09-13,"11:40",77,60,9,8,17,52,8,6,66,37,21,4,62,762,98,104,964
"./Ship3_Latin-square/2019-09-13_11h40m_Subject 47770.txt","47770",2019-09-13,"11:40",46,34,9,3,12,83,7,4,94,41,12,8,61,130,4,7,141
"./Ship3_Latin-square/2019-09-13_11h40m_Subject 47795.txt","47795",2019-09-13,"11:40",77,60,8,9,17,69,6,6,81,56,17,5,78,451,81,76,608
"./Ship3_Latin-square/2019-09-13_11h45m_Subject 47229.txt","47229",2019-09-13,"11:45",79,60,11,8,19,92,3,21,116,39,13,6,58,375,2,81,458
"./Ship3_Latin-square/2019-09-13_11h45m_Subject 47233.txt","47233",2019-09-13,"11:45",56,39,17,0,17,70,25,0,95,29,16,0,45,187,48,0,235
"./Ship3_Latin-square/2019-09-13_11h45m_Subject 47234.txt","47234",2019-09-13,"11:45",85,60,11,14,25,31,22,10,63,46,18,8,72,585,130,135,850
"./Ship3_Latin-square/2019-09-13_11h45m_Subject 47237.txt","47237",2019-09-13,"11:45",79,60,8,11,19,48,3,8,59,31,11,40,82,623,94,150,867
"./Ship3_Latin-square/2019-09-13_11h45m_Subject 47241.txt","47241",2019-09-13,"11:45",87,60,0,27,27,23,0,1,24,7,0,5,12,1210,0,418,1628
"./Ship3_Latin-square/2019-09-13_11h45m_Subject 47247.txt","47247",2019-09-13,"11:45",73,60,5,8,13,13,0,5,18,33,1,5,39,409,38,53,500
"./Ship3_Latin-square/2019-09-13_11h45m_Subject 47777.txt","47777",2019-09-13,"11:45",81,60,8,13,21,46,15,9,70,10,4,12,26,522,62,93,677
"./Ship3_Latin-square/2019-09-13_11h45m_Subject 47784.txt","47784",2019-09-13,"11:45",79,60,9,10,19,65,22,2,89,68,12,18,98,749,73,151,973
"./Ship3_Latin-square/2019-09-13_13h07m_Subject 46880.txt","46880",2019-09-13,"13:07",86,60,13,13,26,27,2,11,40,22,33,12,67,507,51,113,671
"./Ship3_Latin-square/2019-09-13_13h07m_Subject 46882.txt","46882",2019-09-13,"13:07",82,60,9,13,22,24,2,23,49,32,7,34,73,627,64,152,843
"./Ship3_Latin-square/2019-09-13_13h07m_Subject 46883.txt","46883",2019-09-13,"13:07",74,57,10,7,17,81,3,17,101,74,18,13,105,172,4,32,208
"./Ship3_Latin-square/2019-09-13_13h07m_Subject 46894.txt","46894",2019-09-13,"13:07",77,60,8,9,17,32,3,5,40,61,11,19,91,955,120,166,1241
"./Ship3_Latin-square/2019-09-13_13h07m_Subject 46896.txt","46896",2019-09-13,"13:07",79,60,10,9,19,22,0,2,24,32,2,6,40,739,111,173,1023
"./Ship3_Latin-square/2019-09-13_13h07m_Subject 47088.txt","47088",2019-09-13,"13:07",83,60,6,17,23,24,2,2,28,83,4,23,110,1174,141,284,1599
"./Ship3_Latin-square/2019-09-13_13h07m_Subject 47228.txt","47228",2019-09-13,"13:07",79,60,4,15,19,29,3,5,37,34,4,26,64,478,40,102,620
"./Ship3_Latin-square/2019-09-13_13h07m_Subject 47243.txt","47243",2019-09-13,"13:07",83,60,11,12,23,43,9,7,59,57,17,8,82,836,140,188,1164
"./Ship3_Latin-square/2019-09-13_13h07m_Subject 47249.txt","47249",2019-09-13,"13:07",79,60,8,11,19,74,3,11,88,81,16,35,132,356,38,64,458
"./Ship3_Latin-square/2019-09-13_13h07m_Subject 47639.txt","47639",2019-09-13,"13:07",83,60,10,13,23,19,1,3,23,5,0,6,11,874,152,177,1203
"./Ship3_Latin-square/2019-09-13_13h07m_Subject 47649.txt","47649",2019-09-13,"13:07",82,60,11,11,22,45,1,8,54,30,2,24,56,300,26,62,388
"./Ship3_Latin-square/2019-09-13_13h07m_Subject 47758.txt","47758",2019-09-13,"13:07",78,60,6,12,18,7,12,1,20,26,3,14,43,933,101,196,1230
"./Ship3_Latin-square/2019-09-13_13h07m_Subject 47759.txt","47759",2019-09-13,"13:07",83,60,11,12,23,10,3,2,15,23,36,2,61,759,154,152,1065
"./Ship3_Latin-square/2019-09-13_13h07m_Subject 47776.txt","47776",2019-09-13,"13:07",78,60,10,8,18,64,22,12,98,21,8,5,34,416,67,104,587
"./Ship3_Latin-square/2019-09-13_13h07m_Subject 47799.txt","47799",2019-09-13,"13:07",82,60,9,13,22,20,3,1,24,89,21,22,132,901,95,183,1179
"./Ship3_Latin-square/2019-09-13_13h12m_Subject 46881.txt","46881",2019-09-13,"13:12",72,60,4,8,12,43,1,5,49,46,2,1,49,486,39,63,588
"./Ship3_Latin-square/2019-09-13_13h12m_Subject 47087.txt","47087",2019-09-13,"13:12",79,60,8,11,19,75,21,5,101,39,32,5,76,368,44,64,476
"./Ship3_Latin-square/2019-09-13_13h12m_Subject 47626.txt","47626",2019-09-13,"13:12",81,60,11,10,21,70,6,4,80,67,10,7,84,283,36,57,376
"./Ship3_Latin-square/2019-09-13_13h12m_Subject 47632.txt","47632",2019-09-13,"13:12",79,60,13,6,19,45,13,21,79,25,27,6,58,446,49,70,565
"./Ship3_Latin-square/2019-09-13_13h12m_Subject 47634.txt","47634",2019-09-13,"13:12",87,60,12,15,27,49,7,12,68,26,19,38,83,386,71,97,554
"./Ship3_Latin-square/2019-09-13_13h12m_Subject 47640.txt","47640",2019-09-13,"13:12",80,57,12,11,23,64,11,8,83,23,23,14,60,525,109,130,764
"./Ship3_Latin-square/2019-09-13_13h12m_Subject 47754.txt","47754",2019-09-13,"13:12",59,44,7,8,15,50,4,4,58,29,8,50,87,344,40,79,463
"./Ship3_Latin-square/2019-09-13_13h12m_Subject 47800.txt","47800",2019-09-13,"13:12",80,60,9,11,20,79,6,21,106,83,12,31,126,164,0,75,239
"./Ship3_Latin-square/2019-09-13_14h22m_Subject 46876.txt","46876",2019-09-13,"14:22",36,27,9,0,9,26,11,0,37,4,31,0,35,156,21,0,177
"./Ship3_Latin-square/2019-09-13_14h22m_Subject 46877.txt","46877",2019-09-13,"14:22",81,60,11,10,21,19,0,2,21,83,10,13,106,966,111,224,1301
"./Ship3_Latin-square/2019-09-13_14h22m_Subject 46893.txt","46893",2019-09-13,"14:22",80,60,8,12,20,20,2,0,22,64,7,6,77,990,144,233,1367
"./Ship3_Latin-square/2019-09-13_14h22m_Subject 46895.txt","46895",2019-09-13,"14:22",65,47,11,7,18,38,14,3,55,65,12,10,87,115,11,32,158
"./Ship3_Latin-square/2019-09-13_14h22m_Subject 47638.txt","47638",2019-09-13,"14:22",79,57,11,11,22,66,11,10,87,28,13,31,72,304,39,65,408
"./Ship3_Latin-square/2019-09-13_14h22m_Subject 47757.txt","47757",2019-09-13,"14:22",67,49,7,11,18,76,10,10,96,57,16,9,82,270,46,67,383
"./Ship3_Latin-square/2019-09-13_14h22m_Subject 47769.txt","47769",2019-09-13,"14:22",83,60,15,8,23,21,8,1,30,51,25,10,86,629,116,111,856
"./Ship3_Latin-square/2019-09-13_14h22m_Subject 47771.txt","47771",2019-09-13,"14:22",84,60,16,8,24,72,13,6,91,21,24,4,49,306,8,50,364
"./Ship3_Latin-square/2019-09-13_14h22m_Subject 47775.txt","47775",2019-09-13,"14:22",81,60,14,7,21,124,30,18,172,40,12,4,56,227,0,51,278
"./Ship3_Latin-square/2019-09-13_14h22m_Subject 47781.txt","47781",2019-09-13,"14:22",81,60,5,16,21,87,9,12,108,29,4,22,55,472,46,186,704
"./Ship3_Latin-square/2019-09-13_14h22m_Subject 47782.txt","47782",2019-09-13,"14:22",78,60,6,12,18,25,2,1,28,20,6,5,31,803,97,184,1084
"./Ship3_Latin-square/2019-09-13_14h22m_Subject 47783.txt","47783",2019-09-13,"14:22",73,53,10,10,20,87,7,15,109,66,22,27,115,387,115,75,577
"./Ship3_Latin-square/2019-09-13_14h22m_Subject 47785.txt","47785",2019-09-13,"14:22",80,60,9,11,20,42,4,5,51,43,1,13,57,642,198,103,943
"./Ship3_Latin-square/2019-09-13_14h22m_Subject 47786.txt","47786",2019-09-13,"14:22",73,51,7,15,22,77,6,20,103,21,8,17,46,437,55,120,612
"./Ship3_Latin-square/2019-09-13_14h22m_Subject 47788.txt","47788",2019-09-13,"14:22",79,60,7,12,19,38,3,8,49,76,19,10,105,771,90,145,1006
"./Ship3_Latin-square/2019-09-13_14h25m_Subject 46888.txt","46888",2019-09-13,"14:25",84,60,15,9,24,26,13,3,42,62,44,14,120,291,21,66,378
"./Ship3_Latin-square/2019-09-13_14h25m_Subject 46889.txt","46889",2019-09-13,"14:25",79,60,9,10,19,26,1,0,27,44,6,4,54,878,167,195,1240
"./Ship3_Latin-square/2019-09-13_14h25m_Subject 46892.txt","46892",2019-09-13,"14:25",77,60,6,11,17,40,0,3,43,34,7,1,42,868,106,144,1118
"./Ship3_Latin-square/2019-09-13_14h25m_Subject 46898.txt","46898",2019-09-13,"14:25",76,60,5,11,16,21,0,5,26,6,0,32,38,530,62,82,674
"./Ship3_Latin-square/2019-09-13_14h25m_Subject 47097.txt","47097",2019-09-13,"14:25",81,60,12,9,21,75,28,3,106,76,52,7,135,562,122,72,756
"./Ship3_Latin-square/2019-09-13_14h25m_Subject 47099.txt","47099",2019-09-13,"14:25",80,60,8,12,20,25,1,0,26,23,8,20,51,793,125,188,1106
"./Ship3_Latin-square/2019-09-13_14h25m_Subject 47798.txt","47798",2019-09-13,"14:25",50,39,11,0,11,49,11,0,60,33,29,0,62,96,8,0,104
"./Ship3_Latin-square/2019-09-13_15h38m_Subject 47080.txt","47080",2019-09-13,"15:38",84,60,8,16,24,17,4,4,25,21,5,4,30,726,78,271,1075
"./Ship3_Latin-square/2019-09-13_15h38m_Subject 47089.txt","47089",2019-09-13,"15:38",58,41,13,4,17,83,11,16,110,68,25,7,100,122,0,3,125
"./Ship3_Latin-square/2019-09-13_15h38m_Subject 47762.txt","47762",2019-09-13,"15:38",57,40,7,10,17,75,11,22,108,10,2,8,20,85,20,25,130
"./Ship3_Latin-square/2019-09-13_15h38m_Subject 47791.txt","47791",2019-09-13,"15:38",83,60,15,8,23,17,6,2,25,24,7,2,33,461,72,109,642
"./Ship3_Latin-square/2019-09-14_13h36m_Subject 46881.txt","46881",2019-09-14,"13:36",81,60,13,8,21,109,14,15,138,48,13,7,68,293,9,70,372
"./Ship3_Latin-square/2019-09-14_13h36m_Subject 47087.txt","47087",2019-09-14,"13:36",74,51,10,13,23,107,6,35,148,47,20,28,95,154,2,69,225
"./Ship3_Latin-square/2019-09-14_13h36m_Subject 47626.txt","47626",2019-09-14,"13:36",80,60,10,10,20,61,16,14,91,39,6,3,48,297,54,50,401
"./Ship3_Latin-square/2019-09-14_13h36m_Subject 47632.txt","47632",2019-09-14,"13:36",80,60,8,12,20,40,3,5,48,40,55,19,114,693,75,189,957
"./Ship3_Latin-square/2019-09-14_13h36m_Subject 47634.txt","47634",2019-09-14,"13:36",81,60,13,8,21,101,10,14,125,36,11,8,55,184,6,30,220
"./Ship3_Latin-square/2019-09-14_13h36m_Subject 47640.txt","47640",2019-09-14,"13:36",62,44,12,6,18,93,15,13,121,37,20,3,60,133,4,33,170
"./Ship3_Latin-square/2019-09-14_13h36m_Subject 47754.txt","47754",2019-09-14,"13:36",57,40,4,13,17,49,26,7,82,48,2,56,106,295,28,83,406
"./Ship3_Latin-square/2019-09-14_13h36m_Subject 47800.txt","47800",2019-09-14,"13:36",81,60,9,12,21,94,11,23,128,117,17,23,157,505,80,112,697
"./Ship3_Latin-square/2019-09-14_13h38m_Subject 46880.txt","46880",2019-09-14,"13:38",79,60,8,11,19,23,3,3,29,54,25,11,90,709,88,172,969
"./Ship3_Latin-square/2019-09-14_13h38m_Subject 46882.txt","46882",2019-09-14,"13:38",84,60,14,10,24,72,13,9,94,26,81,6,113,323,6,185,514
"./Ship3_Latin-square/2019-09-14_13h38m_Subject 46883.txt","46883",2019-09-14,"13:38",80,57,14,9,23,89,15,18,122,64,27,35,126,239,33,39,311
"./Ship3_Latin-square/2019-09-14_13h38m_Subject 46894.txt","46894",2019-09-14,"13:38",79,60,5,14,19,59,3,11,73,27,1,6,34,522,40,99,661
"./Ship3_Latin-square/2019-09-14_13h38m_Subject 46896.txt","46896",2019-09-14,"13:38",78,60,7,11,18,34,3,2,39,46,13,7,66,764,100,175,1039
"./Ship3_Latin-square/2019-09-14_13h38m_Subject 47088.txt","47088",2019-09-14,"13:38",81,60,11,10,21,86,14,24,124,80,22,23,125,269,0,76,345
"./Ship3_Latin-square/2019-09-14_13h38m_Subject 47228.txt","47228",2019-09-14,"13:38",80,60,9,11,20,34,3,6,43,30,6,7,43,568,66,97,731
"./Ship3_Latin-square/2019-09-14_13h38m_Subject 47243.txt","47243",2019-09-14,"13:38",82,60,10,12,22,60,5,4,69,19,24,6,49,820,149,150,1119
"./Ship3_Latin-square/2019-09-14_13h38m_Subject 47249.txt","47249",2019-09-14,"13:38",41,30,9,2,11,37,12,10,59,45,100,5,150,123,11,14,148
"./Ship3_Latin-square/2019-09-14_13h38m_Subject 47639.txt","47639",2019-09-14,"13:38",83,60,8,15,23,18,2,0,20,9,0,14,23,900,118,216,1234
"./Ship3_Latin-square/2019-09-14_13h38m_Subject 47649.txt","47649",2019-09-14,"13:38",75,57,8,10,18,84,18,9,111,25,6,19,50,250,36,56,342
"./Ship3_Latin-square/2019-09-14_13h38m_Subject 47758.txt","47758",2019-09-14,"13:38",80,60,12,8,20,129,2,23,154,65,19,5,89,298,1,73,372
"./Ship3_Latin-square/2019-09-14_13h38m_Subject 47759.txt","47759",2019-09-14,"13:38",77,60,8,9,17,50,6,10,66,33,10,9,52,235,1,84,320
"./Ship3_Latin-square/2019-09-14_13h38m_Subject 47776.txt","47776",2019-09-14,"13:38",78,60,6,12,18,18,2,3,23,64,11,17,92,1162,133,184,1479
"./Ship3_Latin-square/2019-09-14_13h38m_Subject 47799.txt","47799",2019-09-14,"13:38",83,60,14,9,23,83,13,16,112,49,34,8,91,237,0,71,308
"./Ship3_Latin-square/2019-09-14_14h53m_Subject 46888.txt","46888",2019-09-14,"14:53",74,60,4,10,14,17,0,4,21,115,6,13,134,638,29,136,803
"./Ship3_Latin-square/2019-09-14_14h53m_Subject 46889.txt","46889",2019-09-14,"14:53",76,60,11,5,16,28,13,5,46,15,3,0,18,696,81,103,880
"./Ship3_Latin-square/2019-09-14_14h53m_Subject 46890.txt","46890",2019-09-14,"14:53",82,60,9,13,22,45,8,7,60,6,2,15,23,252,36,63,351
"./Ship3_Latin-square/2019-09-14_14h53m_Subject 46892.txt","46892",2019-09-14,"14:53",86,60,16,10,26,27,6,7,40,52,16,5,73,386,15,99,500
"./Ship3_Latin-square/2019-09-14_14h53m_Subject 46898.txt","46898",2019-09-14,"14:53",79,60,10,9,19,21,5,6,32,14,4,2,20,503,55,81,639
"./Ship3_Latin-square/2019-09-14_14h53m_Subject 47097.txt","47097",2019-09-14,"14:53",84,60,13,11,24,98,26,46,170,105,32,22,159,279,0,131,410
"./Ship3_Latin-square/2019-09-14_14h53m_Subject 47099.txt","47099",2019-09-14,"14:53",82,60,12,10,22,16,1,9,26,26,8,6,40,505,3,114,622
"./Ship3_Latin-square/2019-09-14_14h53m_Subject 47798.txt","47798",2019-09-14,"14:53",49,35,8,6,14,77,10,10,97,53,12,10,75,83,15,27,125
"./Ship3_Latin-square/2019-09-14_14h56m_Subject 46876.txt","46876",2019-09-14,"14:56",62,45,9,8,17,112,30,6,148,8,8,1,17,405,59,116,580
"./Ship3_Latin-square/2019-09-14_14h56m_Subject 46877.txt","46877",2019-09-14,"14:56",85,60,14,11,25,44,2,20,66,69,179,96,344,618,13,175,806
"./Ship3_Latin-square/2019-09-14_14h56m_Subject 46893.txt","46893",2019-09-14,"14:56",74,60,6,8,14,3,0,1,4,30,7,3,40,1187,126,155,1468
"./Ship3_Latin-square/2019-09-14_14h56m_Subject 46895.txt","46895",2019-09-14,"14:56",78,55,10,13,23,57,6,8,71,63,6,36,105,263,37,83,383
"./Ship3_Latin-square/2019-09-14_14h56m_Subject 47638.txt","47638",2019-09-14,"14:56",80,58,12,10,22,63,10,13,86,39,23,63,125,253,73,42,368
"./Ship3_Latin-square/2019-09-14_14h56m_Subject 47757.txt","47757",2019-09-14,"14:56",63,45,16,2,18,108,41,2,151,43,73,3,119,189,23,7,219
"./Ship3_Latin-square/2019-09-14_14h56m_Subject 47769.txt","47769",2019-09-14,"14:56",82,60,11,11,22,47,9,6,62,32,7,17,56,455,73,115,643
"./Ship3_Latin-square/2019-09-14_14h56m_Subject 47771.txt","47771",2019-09-14,"14:56",82,60,8,14,22,19,7,2,28,33,35,6,74,729,58,161,948
"./Ship3_Latin-square/2019-09-14_14h56m_Subject 47775.txt","47775",2019-09-14,"14:56",76,60,6,10,16,52,0,19,71,15,19,3,37,551,51,98,700
"./Ship3_Latin-square/2019-09-14_14h56m_Subject 47781.txt","47781",2019-09-14,"14:56",80,60,10,10,20,26,2,5,33,80,11,20,111,382,3,118,503
"./Ship3_Latin-square/2019-09-14_14h56m_Subject 47782.txt","47782",2019-09-14,"14:56",82,60,9,13,22,66,4,23,93,15,11,14,40,240,2,94,336
"./Ship3_Latin-square/2019-09-14_14h56m_Subject 47783.txt","47783",2019-09-14,"14:56",76,59,12,5,17,102,14,16,132,66,1,3,70,328,10,80,418
"./Ship3_Latin-square/2019-09-14_14h56m_Subject 47785.txt","47785",2019-09-14,"14:56",84,60,13,11,24,72,6,20,98,61,16,19,96,299,3,142,444
"./Ship3_Latin-square/2019-09-14_14h56m_Subject 47786.txt","47786",2019-09-14,"14:56",79,57,6,16,22,76,6,21,103,21,12,12,45,391,53,76,520
"./Ship3_Latin-square/2019-09-14_14h56m_Subject 47788.txt","47788",2019-09-14,"14:56",80,59,15,6,21,101,14,17,132,75,28,9,112,283,0,29,312
"./Ship3_Latin-square/2019-09-16_09h40m_Subject 46878.txt","46878",2019-09-16,"09:40",82,60,12,10,22,42,1,33,76,22,5,58,85,522,49,171,742
"./Ship3_Latin-square/2019-09-16_09h40m_Subject 46885.txt","46885",2019-09-16,"09:40",74,53,14,7,21,89,21,6,116,19,8,2,29,230,33,33,296
"./Ship3_Latin-square/2019-09-16_09h40m_Subject 46899.txt","46899",2019-09-16,"09:40",80,60,12,8,20,35,8,9,52,35,9,12,56,658,88,119,865
"./Ship3_Latin-square/2019-09-16_09h40m_Subject 47081.txt","47081",2019-09-16,"09:40",75,60,4,11,15,31,0,2,33,35,7,22,64,490,28,72,590
"./Ship3_Latin-square/2019-09-16_09h40m_Subject 47091.txt","47091",2019-09-16,"09:40",81,60,11,10,21,42,13,2,57,70,17,33,120,271,47,60,378
"./Ship3_Latin-square/2019-09-16_09h40m_Subject 47231.txt","47231",2019-09-16,"09:40",80,57,10,13,23,115,11,12,138,88,20,17,125,226,29,75,330
"./Ship3_Latin-square/2019-09-16_09h40m_Subject 47238.txt","47238",2019-09-16,"09:40",80,60,12,8,20,45,1,6,52,44,24,15,83,345,11,65,421
"./Ship3_Latin-square/2019-09-16_09h40m_Subject 47242.txt","47242",2019-09-16,"09:40",79,60,9,10,19,91,5,11,107,64,14,48,126,349,10,115,474
"./Ship3_Latin-square/2019-09-16_09h40m_Subject 47244.txt","47244",2019-09-16,"09:40",83,60,14,9,23,22,5,1,28,79,25,20,124,447,59,76,582
"./Ship3_Latin-square/2019-09-16_09h40m_Subject 47633.txt","47633",2019-09-16,"09:40",80,60,10,10,20,57,8,18,83,67,20,16,103,239,33,70,342
"./Ship3_Latin-square/2019-09-16_09h40m_Subject 47636.txt","47636",2019-09-16,"09:40",48,35,12,1,13,90,22,0,112,126,31,3,160,151,12,1,164
"./Ship3_Latin-square/2019-09-16_09h40m_Subject 47752.txt","47752",2019-09-16,"09:40",77,60,7,10,17,69,7,7,83,30,11,8,49,493,29,105,627
"./Ship3_Latin-square/2019-09-16_09h40m_Subject 47767.txt","47767",2019-09-16,"09:40",74,58,13,3,16,105,12,6,123,31,17,4,52,148,7,6,161
"./Ship3_Latin-square/2019-09-16_09h40m_Subject 47768.txt","47768",2019-09-16,"09:40",72,52,13,7,20,75,8,16,99,33,5,8,46,258,5,19,282
"./Ship3_Latin-square/2019-09-16_09h40m_Subject 47780.txt","47780",2019-09-16,"09:40",84,60,10,14,24,59,10,10,79,68,10,16,94,343,41,96,480
"./Ship3_Latin-square/2019-09-16_09h43m_Subject 46884.txt","46884",2019-09-16,"09:43",76,56,11,9,20,105,5,8,118,49,1,84,134,191,47,41,279
"./Ship3_Latin-square/2019-09-16_09h43m_Subject 47083.txt","47083",2019-09-16,"09:43",80,58,11,11,22,87,7,10,104,48,8,19,75,288,27,92,407
"./Ship3_Latin-square/2019-09-16_09h43m_Subject 47086.txt","47086",2019-09-16,"09:43",79,60,8,11,19,17,4,4,25,41,13,3,57,406,64,71,541
"./Ship3_Latin-square/2019-09-16_09h43m_Subject 47246.txt","47246",2019-09-16,"09:43",86,60,9,17,26,57,9,2,68,25,7,23,55,404,59,120,583
"./Ship3_Latin-square/2019-09-16_09h43m_Subject 47635.txt","47635",2019-09-16,"09:43",83,60,11,12,23,49,5,8,62,50,12,15,77,387,51,128,566
"./Ship3_Latin-square/2019-09-16_09h43m_Subject 47779.txt","47779",2019-09-16,"09:43",49,35,9,5,14,30,6,9,45,61,22,15,98,82,12,13,107
"./Ship3_Latin-square/2019-09-16_09h43m_Subject 47797.txt","47797",2019-09-16,"09:43",51,38,8,5,13,44,2,6,52,27,14,5,46,154,41,28,223
"./Ship3_Latin-square/2019-09-16_10h57m_Subject 46900.txt","46900",2019-09-16,"10:57",80,60,9,11,20,20,7,4,31,106,57,12,175,763,129,181,1073
"./Ship3_Latin-square/2019-09-16_10h57m_Subject 46986.txt","46986",2019-09-16,"10:57",80,60,12,8,20,51,10,9,70,15,14,5,34,351,64,52,467
"./Ship3_Latin-square/2019-09-16_10h57m_Subject 47076.txt","47076",2019-09-16,"10:57",83,60,16,7,23,28,2,5,35,59,35,11,105,365,17,76,458
"./Ship3_Latin-square/2019-09-16_10h57m_Subject 47079.txt","47079",2019-09-16,"10:57",80,60,9,11,20,41,5,7,53,53,12,15,80,200,33,50,283
"./Ship3_Latin-square/2019-09-16_10h57m_Subject 47082.txt","47082",2019-09-16,"10:57",78,60,12,6,18,62,17,20,99,57,6,3,66,285,9,31,325
"./Ship3_Latin-square/2019-09-16_10h57m_Subject 47092.txt","47092",2019-09-16,"10:57",80,60,10,10,20,16,4,4,24,28,7,1,36,538,53,110,701
"./Ship3_Latin-square/2019-09-16_10h57m_Subject 47098.txt","47098",2019-09-16,"10:57",78,60,10,8,18,19,1,0,20,26,3,5,34,301,41,38,380
"./Ship3_Latin-square/2019-09-16_10h57m_Subject 47226.txt","47226",2019-09-16,"10:57",81,60,11,10,21,41,3,10,54,38,14,12,64,512,7,88,607
"./Ship3_Latin-square/2019-09-16_10h57m_Subject 47227.txt","47227",2019-09-16,"10:57",79,60,14,5,19,79,30,11,120,19,27,17,63,292,13,30,335
"./Ship3_Latin-square/2019-09-16_10h57m_Subject 47250.txt","47250",2019-09-16,"10:57",79,60,6,13,19,21,2,4,27,16,2,13,31,852,106,197,1155
"./Ship3_Latin-square/2019-09-16_10h57m_Subject 47645.txt","47645",2019-09-16,"10:57",72,53,9,10,19,59,16,9,84,25,6,8,39,336,67,57,460
"./Ship3_Latin-square/2019-09-16_10h57m_Subject 47646.txt","47646",2019-09-16,"10:57",77,60,6,11,17,51,0,22,73,66,16,6,88,485,3,238,726
"./Ship3_Latin-square/2019-09-16_10h57m_Subject 47755.txt","47755",2019-09-16,"10:57",80,60,10,10,20,29,6,6,41,18,5,7,30,638,97,139,874
"./Ship3_Latin-square/2019-09-16_10h57m_Subject 47760.txt","47760",2019-09-16,"10:57",78,60,10,8,18,52,8,8,68,65,15,8,88,557,33,106,696
"./Ship3_Latin-square/2019-09-16_10h57m_Subject 47770.txt","47770",2019-09-16,"10:57",53,39,10,4,14,76,9,5,90,43,19,7,69,125,19,12,156
"./Ship3_Latin-square/2019-09-16_10h57m_Subject 47795.txt","47795",2019-09-16,"10:57",69,51,16,2,18,112,35,3,150,49,33,1,83,237,3,9,249
"./Ship3_Latin-square/2019-09-16_11h00m_Subject 47229.txt","47229",2019-09-16,"11:00",85,60,9,16,25,13,2,4,19,51,20,30,101,760,139,191,1090
"./Ship3_Latin-square/2019-09-16_11h00m_Subject 47233.txt","47233",2019-09-16,"11:00",81,60,6,15,21,31,2,4,37,20,11,4,35,397,38,115,550
"./Ship3_Latin-square/2019-09-16_11h00m_Subject 47234.txt","47234",2019-09-16,"11:00",83,60,9,14,23,49,7,20,76,60,21,17,98,680,92,202,974
"./Ship3_Latin-square/2019-09-16_11h00m_Subject 47237.txt","47237",2019-09-16,"11:00",78,60,9,9,18,26,1,2,29,37,14,10,61,422,28,79,529
"./Ship3_Latin-square/2019-09-16_11h00m_Subject 47241.txt","47241",2019-09-16,"11:00",80,60,7,13,20,16,0,10,26,2,3,1,6,753,68,185,1006
"./Ship3_Latin-square/2019-09-16_11h00m_Subject 47247.txt","47247",2019-09-16,"11:00",72,60,9,3,12,29,10,0,39,41,9,4,54,255,25,28,308
"./Ship3_Latin-square/2019-09-16_11h00m_Subject 47777.txt","47777",2019-09-16,"11:00",73,60,9,4,13,145,15,10,170,22,3,1,26,178,4,14,196
"./Ship3_Latin-square/2019-09-16_11h00m_Subject 47784.txt","47784",2019-09-16,"11:00",78,60,10,8,18,97,13,15,125,85,17,15,117,581,62,80,723
"./Ship3_Latin-square/2019-09-16_12h05m_Subject 46880.txt","46880",2019-09-16,"12:05",85,60,14,11,25,73,5,22,100,13,2,11,26,296,9,75,380
"./Ship3_Latin-square/2019-09-16_12h05m_Subject 46882.txt","46882",2019-09-16,"12:05",77,60,7,10,17,33,0,2,35,58,2,26,86,659,107,92,858
"./Ship3_Latin-square/2019-09-16_12h05m_Subject 46883.txt","46883",2019-09-16,"12:05",72,53,10,9,19,111,8,12,131,90,35,10,135,207,29,33,269
"./Ship3_Latin-square/2019-09-16_12h05m_Subject 46894.txt","46894",2019-09-16,"12:05",74,54,12,8,20,91,16,14,121,26,16,2,44,215,9,66,290
"./Ship3_Latin-square/2019-09-16_12h05m_Subject 46896.txt","46896",2019-09-16,"12:05",77,60,10,7,17,48,3,4,55,40,7,8,55,491,26,76,593
"./Ship3_Latin-square/2019-09-16_12h05m_Subject 47088.txt","47088",2019-09-16,"12:05",82,60,7,15,22,37,1,1,39,51,4,11,66,1171,153,285,1609
"./Ship3_Latin-square/2019-09-16_12h05m_Subject 47228.txt","47228",2019-09-16,"12:05",82,60,10,12,22,49,2,9,60,10,11,10,31,234,19,83,336
"./Ship3_Latin-square/2019-09-16_12h05m_Subject 47243.txt","47243",2019-09-16,"12:05",79,60,11,8,19,130,15,20,165,27,28,2,57,384,14,78,476
"./Ship3_Latin-square/2019-09-16_12h05m_Subject 47249.txt","47249",2019-09-16,"12:05",80,60,7,13,20,26,17,12,55,84,16,26,126,429,52,91,572
"./Ship3_Latin-square/2019-09-16_12h05m_Subject 47639.txt","47639",2019-09-16,"12:05",81,60,14,7,21,57,5,11,73,89,34,12,135,310,5,39,354
"./Ship3_Latin-square/2019-09-16_12h05m_Subject 47649.txt","47649",2019-09-16,"12:05",68,51,12,5,17,48,7,7,62,17,5,0,22,141,23,19,183
"./Ship3_Latin-square/2019-09-16_12h05m_Subject 47758.txt","47758",2019-09-16,"12:05",78,60,7,11,18,8,1,1,10,16,3,1,20,930,120,200,1250
"./Ship3_Latin-square/2019-09-16_12h05m_Subject 47759.txt","47759",2019-09-16,"12:05",80,60,8,12,20,8,5,3,16,19,3,5,27,661,85,157,903
"./Ship3_Latin-square/2019-09-16_12h05m_Subject 47776.txt","47776",2019-09-16,"12:05",78,60,14,4,18,78,14,4,96,37,24,2,63,426,11,62,499
"./Ship3_Latin-square/2019-09-16_12h05m_Subject 47799.txt","47799",2019-09-16,"12:05",76,60,6,10,16,39,4,4,47,57,8,9,74,591,59,125,775
"./Ship3_Latin-square/2019-09-16_12h12m_Subject 46881.txt","46881",2019-09-16,"12:12",77,60,8,9,17,76,8,6,90,56,5,1,62,449,63,70,582
"./Ship3_Latin-square/2019-09-16_12h12m_Subject 47087.txt","47087",2019-09-16,"12:12",79,60,7,12,19,59,3,6,68,56,8,13,77,354,46,65,465
"./Ship3_Latin-square/2019-09-16_12h12m_Subject 47626.txt","47626",2019-09-16,"12:12",62,49,9,4,13,53,7,9,69,38,8,4,50,165,4,18,187
"./Ship3_Latin-square/2019-09-16_12h12m_Subject 47632.txt","47632",2019-09-16,"12:12",70,51,15,4,19,99,16,13,128,76,31,6,113,364,14,37,415
"./Ship3_Latin-square/2019-09-16_12h12m_Subject 47634.txt","47634",2019-09-16,"12:12",83,60,10,13,23,54,6,10,70,44,40,7,91,331,53,74,458
"./Ship3_Latin-square/2019-09-16_12h12m_Subject 47640.txt","47640",2019-09-16,"12:12",77,60,7,10,17,47,3,3,53,44,7,15,66,557,61,120,738
"./Ship3_Latin-square/2019-09-16_12h12m_Subject 47754.txt","47754",2019-09-16,"12:12",64,49,9,6,15,54,8,14,76,35,6,12,53,165,4,32,201
"./Ship3_Latin-square/2019-09-16_12h12m_Subject 47800.txt","47800",2019-09-16,"12:12",81,60,9,12,21,63,9,17,89,69,13,21,103,351,52,82,485
"./Ship3_Latin-square/2019-09-16_13h11m_Subject 46876.txt","46876",2019-09-16,"13:11",39,29,7,3,10,85,6,7,98,14,7,4,25,130,0,12,142
"./Ship3_Latin-square/2019-09-16_13h11m_Subject 46877.txt","46877",2019-09-16,"13:11",83,60,15,8,23,34,22,8,64,30,61,66,157,738,95,177,1010
"./Ship3_Latin-square/2019-09-16_13h11m_Subject 46893.txt","46893",2019-09-16,"13:11",78,60,10,8,18,39,5,10,54,35,7,7,49,543,24,104,671
"./Ship3_Latin-square/2019-09-16_13h11m_Subject 46895.txt","46895",2019-09-16,"13:11",71,50,12,9,21,67,15,11,93,30,7,9,46,169,24,41,234
"./Ship3_Latin-square/2019-09-16_13h11m_Subject 47638.txt","47638",2019-09-16,"13:11",79,60,13,6,19,106,9,7,122,41,20,7,68,214,9,33,256
"./Ship3_Latin-square/2019-09-16_13h11m_Subject 47757.txt","47757",2019-09-16,"13:11",73,53,8,12,20,81,19,18,118,36,16,8,60,358,53,71,482
"./Ship3_Latin-square/2019-09-16_13h11m_Subject 47769.txt","47769",2019-09-16,"13:11",68,51,12,5,17,116,8,22,146,63,19,12,94,227,14,21,262
"./Ship3_Latin-square/2019-09-16_13h11m_Subject 47771.txt","47771",2019-09-16,"13:11",79,60,9,10,19,21,1,1,23,7,11,4,22,751,123,145,1019
"./Ship3_Latin-square/2019-09-16_13h11m_Subject 47775.txt","47775",2019-09-16,"13:11",78,60,5,13,18,41,5,10,56,9,0,4,13,493,54,110,657
"./Ship3_Latin-square/2019-09-16_13h11m_Subject 47781.txt","47781",2019-09-16,"13:11",79,60,8,11,19,22,2,5,29,58,11,14,83,834,108,159,1101
"./Ship3_Latin-square/2019-09-16_13h11m_Subject 47782.txt","47782",2019-09-16,"13:11",78,60,6,12,18,10,0,3,13,15,5,5,25,787,126,129,1042
"./Ship3_Latin-square/2019-09-16_13h11m_Subject 47783.txt","47783",2019-09-16,"13:11",80,60,10,10,20,72,6,9,87,41,8,41,90,559,126,121,806
"./Ship3_Latin-square/2019-09-16_13h11m_Subject 47785.txt","47785",2019-09-16,"13:11",81,60,11,10,21,13,3,0,16,44,9,13,66,1025,263,163,1451
"./Ship3_Latin-square/2019-09-16_13h11m_Subject 47786.txt","47786",2019-09-16,"13:11",79,60,11,8,19,46,7,9,62,32,12,5,49,399,43,76,518
"./Ship3_Latin-square/2019-09-16_13h11m_Subject 47788.txt","47788",2019-09-16,"13:11",79,60,6,13,19,40,3,6,49,85,12,15,112,680,73,141,894
"./Ship3_Latin-square/2019-09-16_13h19m_Subject 46888.txt","46888",2019-09-16,"13:19",80,60,10,10,20,11,0,0,11,48,8,24,80,1042,162,203,1407
"./Ship3_Latin-square/2019-09-16_13h19m_Subject 46889.txt","46889",2019-09-16,"13:19",80,60,10,10,20,16,3,1,20,25,5,38,68,895,178,191,1264
"./Ship3_Latin-square/2019-09-16_13h19m_Subject 46890.txt","46890",2019-09-16,"13:19",84,59,13,12,25,22,1,5,28,6,14,4,24,212,51,57,320
"./Ship3_Latin-square/2019-09-16_13h19m_Subject 46892.txt","46892",2019-09-16,"13:19",80,60,7,13,20,18,4,4,26,16,4,3,23,1004,137,210,1351
"./Ship3_Latin-square/2019-09-16_13h19m_Subject 46898.txt","46898",2019-09-16,"13:19",75,60,11,4,15,101,6,6,113,25,2,2,29,295,17,26,338
"./Ship3_Latin-square/2019-09-16_13h19m_Subject 47097.txt","47097",2019-09-16,"13:19",76,60,5,11,16,34,3,3,40,76,12,17,105,795,92,117,1004
"./Ship3_Latin-square/2019-09-16_13h19m_Subject 47099.txt","47099",2019-09-16,"13:19",81,60,7,14,21,11,2,2,15,26,11,6,43,1379,136,267,1782
"./Ship3_Latin-square/2019-09-16_13h19m_Subject 47798.txt","47798",2019-09-16,"13:19",71,52,5,14,19,54,0,13,67,33,7,28,68,133,6,48,187
"./Ship3_Latin-square/2019-09-16_14h30m_Subject 47080.txt","47080",2019-09-16,"14:30",79,60,5,14,19,12,1,1,14,16,2,3,21,875,70,162,1107
"./Ship3_Latin-square/2019-09-16_14h30m_Subject 47089.txt","47089",2019-09-16,"14:30",83,59,10,14,24,72,9,13,94,134,36,37,207,362,53,95,510
"./Ship3_Latin-square/2019-09-16_14h30m_Subject 47762.txt","47762",2019-09-16,"14:30",67,50,11,6,17,74,6,13,93,41,4,5,50,214,39,21,274
"./Ship3_Latin-square/2019-09-16_14h30m_Subject 47791.txt","47791",2019-09-16,"14:30",81,60,12,9,21,25,3,3,31,22,10,11,43,538,124,88,750
"./Ship3_Latin-square/2019-09-17_09h58m_Subject 46878.txt","46878",2019-09-17,"09:58",77,60,9,8,17,20,5,4,29,25,24,1,50,771,99,105,975
"./Ship3_Latin-square/2019-09-17_09h58m_Subject 46885.txt","46885",2019-09-17,"09:58",78,60,8,10,18,32,10,8,50,7,4,11,22,392,48,73,513
"./Ship3_Latin-square/2019-09-17_09h58m_Subject 46899.txt","46899",2019-09-17,"09:58",80,60,13,7,20,75,5,12,92,40,12,3,55,516,50,86,652
"./Ship3_Latin-square/2019-09-17_09h58m_Subject 47081.txt","47081",2019-09-17,"09:58",81,60,11,10,21,38,4,7,49,12,0,6,18,551,59,117,727
"./Ship3_Latin-square/2019-09-17_09h58m_Subject 47091.txt","47091",2019-09-17,"09:58",79,60,7,12,19,35,5,7,47,59,11,12,82,181,24,56,261
"./Ship3_Latin-square/2019-09-17_09h58m_Subject 47231.txt","47231",2019-09-17,"09:58",79,60,11,8,19,43,8,7,58,11,19,6,36,507,40,116,663
"./Ship3_Latin-square/2019-09-17_09h58m_Subject 47238.txt","47238",2019-09-17,"09:58",81,60,8,13,21,13,3,4,20,56,14,19,89,598,62,129,789
"./Ship3_Latin-square/2019-09-17_09h58m_Subject 47242.txt","47242",2019-09-17,"09:58",79,60,8,11,19,35,2,7,44,68,35,16,119,665,108,135,908
"./Ship3_Latin-square/2019-09-17_09h58m_Subject 47244.txt","47244",2019-09-17,"09:58",78,60,9,9,18,40,15,1,56,70,6,55,131,648,122,91,861
"./Ship3_Latin-square/2019-09-17_09h58m_Subject 47633.txt","47633",2019-09-17,"09:58",80,60,10,10,20,43,6,6,55,63,18,16,97,418,51,114,583
"./Ship3_Latin-square/2019-09-17_09h58m_Subject 47636.txt","47636",2019-09-17,"09:58",69,50,10,9,19,98,12,15,125,237,88,35,360,276,38,42,356
"./Ship3_Latin-square/2019-09-17_09h58m_Subject 47752.txt","47752",2019-09-17,"09:58",82,60,11,11,22,74,10,11,95,37,18,14,69,446,42,172,660
"./Ship3_Latin-square/2019-09-17_09h58m_Subject 47767.txt","47767",2019-09-17,"09:58",81,60,11,10,21,28,8,1,37,89,35,7,131,504,70,81,655
"./Ship3_Latin-square/2019-09-17_09h58m_Subject 47768.txt","47768",2019-09-17,"09:58",66,46,12,8,20,89,14,9,112,37,14,60,111,246,23,50,319
"./Ship3_Latin-square/2019-09-17_09h58m_Subject 47780.txt","47780",2019-09-17,"09:58",82,60,14,8,22,46,8,2,56,14,7,6,27,209,0,34,243
"./Ship3_Latin-square/2019-09-17_10h03m_Subject 46884.txt","46884",2019-09-17,"10:03",79,58,13,8,21,90,3,14,107,37,9,7,53,170,5,42,217
"./Ship3_Latin-square/2019-09-17_10h03m_Subject 47083.txt","47083",2019-09-17,"10:03",77,59,8,10,18,54,11,15,80,62,15,36,113,360,60,48,468
"./Ship3_Latin-square/2019-09-17_10h03m_Subject 47086.txt","47086",2019-09-17,"10:03",80,60,12,8,20,14,2,2,18,30,9,4,43,391,59,68,518
"./Ship3_Latin-square/2019-09-17_10h03m_Subject 47246.txt","47246",2019-09-17,"10:03",81,60,12,9,21,87,4,14,105,18,7,10,35,220,1,58,279
"./Ship3_Latin-square/2019-09-17_10h03m_Subject 47635.txt","47635",2019-09-17,"10:03",82,60,11,11,22,27,7,6,40,52,16,9,77,504,93,89,686
"./Ship3_Latin-square/2019-09-17_10h03m_Subject 47779.txt","47779",2019-09-17,"10:03",80,60,12,8,20,52,12,9,73,53,12,3,68,141,27,20,188
"./Ship3_Latin-square/2019-09-17_10h03m_Subject 47797.txt","47797",2019-09-17,"10:03",53,37,10,6,16,49,8,22,79,49,13,14,76,87,5,17,109
"./Ship3_Latin-square/2019-09-17_11h19m_Subject 46900.txt","46900",2019-09-17,"11:19",77,60,9,8,17,40,2,9,51,43,45,10,98,487,4,82,573
"./Ship3_Latin-square/2019-09-17_11h19m_Subject 46986.txt","46986",2019-09-17,"11:19",83,60,10,13,23,48,9,8,65,15,8,21,44,380,64,83,527
"./Ship3_Latin-square/2019-09-17_11h19m_Subject 47076.txt","47076",2019-09-17,"11:19",76,60,9,7,16,6,1,0,7,10,23,6,39,516,64,83,663
"./Ship3_Latin-square/2019-09-17_11h19m_Subject 47079.txt","47079",2019-09-17,"11:19",80,60,9,11,20,23,1,0,24,56,16,10,82,375,69,86,530
"./Ship3_Latin-square/2019-09-17_11h19m_Subject 47082.txt","47082",2019-09-17,"11:19",77,60,9,8,17,31,0,3,34,116,10,4,130,472,65,59,596
"./Ship3_Latin-square/2019-09-17_11h19m_Subject 47092.txt","47092",2019-09-17,"11:19",82,60,12,10,22,21,2,5,28,42,12,0,54,720,159,122,1001
"./Ship3_Latin-square/2019-09-17_11h19m_Subject 47098.txt","47098",2019-09-17,"11:19",83,60,8,15,23,12,1,2,15,25,2,27,54,294,30,66,390
"./Ship3_Latin-square/2019-09-17_11h19m_Subject 47226.txt","47226",2019-09-17,"11:19",79,60,5,14,19,26,1,5,32,27,4,20,51,969,125,188,1282
"./Ship3_Latin-square/2019-09-17_11h19m_Subject 47227.txt","47227",2019-09-17,"11:19",83,60,10,13,23,32,1,1,34,20,19,5,44,761,113,200,1074
"./Ship3_Latin-square/2019-09-17_11h19m_Subject 47250.txt","47250",2019-09-17,"11:19",82,60,8,14,22,26,2,11,39,12,4,15,31,963,134,217,1314
"./Ship3_Latin-square/2019-09-17_11h19m_Subject 47645.txt","47645",2019-09-17,"11:19",79,57,10,12,22,75,17,14,106,31,9,31,71,497,88,86,671
"./Ship3_Latin-square/2019-09-17_11h19m_Subject 47646.txt","47646",2019-09-17,"11:19",78,60,6,12,18,14,0,0,14,93,18,44,155,1547,146,298,1991
"./Ship3_Latin-square/2019-09-17_11h19m_Subject 47755.txt","47755",2019-09-17,"11:19",75,60,7,8,15,58,7,11,76,33,7,3,43,546,53,115,714
"./Ship3_Latin-square/2019-09-17_11h19m_Subject 47760.txt","47760",2019-09-17,"11:19",80,60,8,12,20,38,5,6,49,45,6,12,63,885,81,191,1157
"./Ship3_Latin-square/2019-09-17_11h19m_Subject 47770.txt","47770",2019-09-17,"11:19",44,33,5,6,11,44,5,3,52,53,16,9,78,105,37,21,163
"./Ship3_Latin-square/2019-09-17_11h19m_Subject 47795.txt","47795",2019-09-17,"11:19",84,60,5,19,24,37,1,12,50,39,11,25,75,645,43,179,867
"./Ship3_Latin-square/2019-09-17_11h23m_Subject 47229.txt","47229",2019-09-17,"11:23",81,60,10,11,21,15,5,0,20,44,17,10,71,753,119,129,1001
"./Ship3_Latin-square/2019-09-17_11h23m_Subject 47233.txt","47233",2019-09-17,"11:23",81,60,11,10,21,48,7,16,71,55,17,19,91,258,5,86,349
"./Ship3_Latin-square/2019-09-17_11h23m_Subject 47234.txt","47234",2019-09-17,"11:23",83,60,12,11,23,61,12,10,83,164,17,15,196,589,101,133,823
"./Ship3_Latin-square/2019-09-17_11h23m_Subject 47237.txt","47237",2019-09-17,"11:23",79,60,9,10,19,29,4,2,35,10,5,29,44,784,97,187,1068
"./Ship3_Latin-square/2019-09-17_11h23m_Subject 47241.txt","47241",2019-09-17,"11:23",79,60,11,8,19,26,3,10,39,13,9,5,27,576,9,146,731
"./Ship3_Latin-square/2019-09-17_11h23m_Subject 47247.txt","47247",2019-09-17,"11:23",73,60,5,8,13,21,0,3,24,39,5,5,49,414,53,70,537
"./Ship3_Latin-square/2019-09-17_11h23m_Subject 47777.txt","47777",2019-09-17,"11:23",81,60,7,14,21,33,11,4,48,14,3,17,34,518,73,121,712
"./Ship3_Latin-square/2019-09-17_11h23m_Subject 47784.txt","47784",2019-09-17,"11:23",78,60,8,10,18,39,8,3,50,48,19,24,91,1057,171,172,1400
"./Ship3_Latin-square/2019-09-17_12h31m_Subject 46880.txt","46880",2019-09-17,"12:31",74,60,7,7,14,10,0,1,11,54,10,3,67,714,71,110,895
"./Ship3_Latin-square/2019-09-17_12h31m_Subject 46882.txt","46882",2019-09-17,"12:31",82,60,7,15,22,13,0,6,19,49,5,16,70,791,85,124,1000
"./Ship3_Latin-square/2019-09-17_12h31m_Subject 46883.txt","46883",2019-09-17,"12:31",80,60,12,8,20,75,7,12,94,37,16,20,73,233,29,28,290
"./Ship3_Latin-square/2019-09-17_12h31m_Subject 46894.txt","46894",2019-09-17,"12:31",80,60,2,18,20,36,0,7,43,19,1,15,35,798,50,202,1050
"./Ship3_Latin-square/2019-09-17_12h31m_Subject 46896.txt","46896",2019-09-17,"12:31",80,60,6,14,20,16,0,0,16,27,8,9,44,848,112,176,1136
"./Ship3_Latin-square/2019-09-17_12h31m_Subject 47088.txt","47088",2019-09-17,"12:31",83,60,12,11,23,34,3,7,44,38,10,16,64,605,44,124,773
"./Ship3_Latin-square/2019-09-17_12h31m_Subject 47228.txt","47228",2019-09-17,"12:31",81,60,9,12,21,20,4,3,27,24,6,17,47,594,74,124,792
"./Ship3_Latin-square/2019-09-17_12h31m_Subject 47243.txt","47243",2019-09-17,"12:31",83,60,9,14,23,23,10,5,38,8,5,1,14,917,154,220,1291
"./Ship3_Latin-square/2019-09-17_12h31m_Subject 47249.txt","47249",2019-09-17,"12:31",79,57,14,8,22,57,18,12,87,76,64,8,148,266,58,40,364
"./Ship3_Latin-square/2019-09-17_12h31m_Subject 47639.txt","47639",2019-09-17,"12:31",83,60,4,19,23,16,0,3,19,12,1,5,18,891,48,248,1187
"./Ship3_Latin-square/2019-09-17_12h31m_Subject 47649.txt","47649",2019-09-17,"12:31",80,60,7,13,20,53,3,2,58,53,8,82,143,273,39,76,388
"./Ship3_Latin-square/2019-09-17_12h31m_Subject 47758.txt","47758",2019-09-17,"12:31",79,60,10,9,19,9,0,2,11,2,0,0,2,286,18,90,394
"./Ship3_Latin-square/2019-09-17_12h31m_Subject 47759.txt","47759",2019-09-17,"12:31",82,60,13,9,22,21,4,3,28,29,7,11,47,349,34,68,451
"./Ship3_Latin-square/2019-09-17_12h31m_Subject 47776.txt","47776",2019-09-17,"12:31",82,60,9,13,22,14,4,4,22,54,21,7,82,1065,162,180,1407
"./Ship3_Latin-square/2019-09-17_12h31m_Subject 47799.txt","47799",2019-09-17,"12:31",81,60,12,9,21,41,6,4,51,54,24,11,89,191,27,28,246
"./Ship3_Latin-square/2019-09-17_12h36m_Subject 46881.txt","46881",2019-09-17,"12:36",79,60,7,12,19,24,1,4,29,13,4,5,22,417,49,102,568
"./Ship3_Latin-square/2019-09-17_12h36m_Subject 47087.txt","47087",2019-09-17,"12:36",79,60,9,10,19,25,3,0,28,37,8,11,56,365,43,73,481
"./Ship3_Latin-square/2019-09-17_12h36m_Subject 47626.txt","47626",2019-09-17,"12:36",79,60,9,10,19,32,7,4,43,86,8,10,104,311,50,57,418
"./Ship3_Latin-square/2019-09-17_12h36m_Subject 47632.txt","47632",2019-09-17,"12:36",79,60,8,11,19,63,5,3,71,12,4,8,24,891,111,202,1204
"./Ship3_Latin-square/2019-09-17_12h36m_Subject 47634.txt","47634",2019-09-17,"12:36",80,60,9,11,20,34,12,11,57,22,6,8,36,487,96,115,698
"./Ship3_Latin-square/2019-09-17_12h36m_Subject 47640.txt","47640",2019-09-17,"12:36",82,60,9,13,22,57,12,5,74,28,1,26,55,708,127,209,1044
"./Ship3_Latin-square/2019-09-17_12h36m_Subject 47754.txt","47754",2019-09-17,"12:36",81,60,7,14,21,23,7,12,42,50,3,20,73,658,79,149,886
"./Ship3_Latin-square/2019-09-17_12h36m_Subject 47800.txt","47800",2019-09-17,"12:36",76,60,10,6,16,63,2,8,73,63,18,16,97,308,4,53,365
"./Ship3_Latin-square/2019-09-17_13h45m_Subject 46876.txt","46876",2019-09-17,"13:45",78,60,8,10,18,44,18,5,67,52,10,33,95,397,49,88,534
"./Ship3_Latin-square/2019-09-17_13h45m_Subject 46877.txt","46877",2019-09-17,"13:45",76,60,9,7,16,17,1,0,18,141,31,49,221,919,138,121,1178
"./Ship3_Latin-square/2019-09-17_13h45m_Subject 46893.txt","46893",2019-09-17,"13:45",78,60,6,12,18,18,3,2,23,46,7,8,61,1204,111,287,1602
"./Ship3_Latin-square/2019-09-17_13h45m_Subject 46895.txt","46895",2019-09-17,"13:45",83,60,11,12,23,81,27,8,116,21,8,6,35,422,84,86,592
"./Ship3_Latin-square/2019-09-17_13h45m_Subject 47638.txt","47638",2019-09-17,"13:45",82,60,11,11,22,125,15,13,153,23,8,29,60,422,102,92,616
"./Ship3_Latin-square/2019-09-17_13h45m_Subject 47757.txt","47757",2019-09-17,"13:45",71,51,14,6,20,106,30,25,161,22,13,4,39,266,61,43,370
"./Ship3_Latin-square/2019-09-17_13h45m_Subject 47769.txt","47769",2019-09-17,"13:45",86,60,14,12,26,30,2,6,38,40,10,16,66,904,169,197,1270
"./Ship3_Latin-square/2019-09-17_13h45m_Subject 47771.txt","47771",2019-09-17,"13:45",84,60,13,11,24,81,7,15,103,15,14,10,39,275,7,59,341
"./Ship3_Latin-square/2019-09-17_13h45m_Subject 47775.txt","47775",2019-09-17,"13:45",79,60,13,6,19,103,11,21,135,23,11,4,38,305,3,59,367
"./Ship3_Latin-square/2019-09-17_13h45m_Subject 47781.txt","47781",2019-09-17,"13:45",81,60,8,13,21,10,0,3,13,55,10,6,71,1122,170,236,1528
"./Ship3_Latin-square/2019-09-17_13h45m_Subject 47782.txt","47782",2019-09-17,"13:45",79,60,9,10,19,31,3,9,43,13,6,8,27,497,39,87,623
"./Ship3_Latin-square/2019-09-17_13h45m_Subject 47783.txt","47783",2019-09-17,"13:45",83,60,9,14,23,39,3,7,49,49,8,19,76,738,72,197,1007
"./Ship3_Latin-square/2019-09-17_13h45m_Subject 47785.txt","47785",2019-09-17,"13:45",77,60,6,11,17,9,0,1,10,50,15,8,73,1278,197,260,1735
"./Ship3_Latin-square/2019-09-17_13h45m_Subject 47786.txt","47786",2019-09-17,"13:45",66,48,12,6,18,68,12,9,89,51,12,15,78,146,2,40,188
"./Ship3_Latin-square/2019-09-17_13h45m_Subject 47788.txt","47788",2019-09-17,"13:45",79,60,11,8,19,48,2,7,57,79,28,10,117,364,28,80,472
"./Ship3_Latin-square/2019-09-17_13h50m_Subject 46888.txt","46888",2019-09-17,"13:50",85,60,15,10,25,22,7,6,35,51,34,13,98,316,27,127,470
"./Ship3_Latin-square/2019-09-17_13h50m_Subject 46889.txt","46889",2019-09-17,"13:50",80,60,10,10,20,47,0,16,63,39,4,13,56,499,14,121,634
"./Ship3_Latin-square/2019-09-17_13h50m_Subject 46890.txt","46890",2019-09-17,"13:50",83,60,10,13,23,16,3,3,22,3,0,25,28,141,34,49,224
"./Ship3_Latin-square/2019-09-17_13h50m_Subject 46892.txt","46892",2019-09-17,"13:50",81,60,12,9,21,24,2,3,29,6,3,1,10,482,77,93,652
"./Ship3_Latin-square/2019-09-17_13h50m_Subject 46898.txt","46898",2019-09-17,"13:50",82,60,14,8,22,48,5,6,59,19,11,9,39,500,75,77,652
"./Ship3_Latin-square/2019-09-17_13h50m_Subject 47097.txt","47097",2019-09-17,"13:50",80,60,7,13,20,14,1,2,17,73,9,18,100,863,72,191,1126
"./Ship3_Latin-square/2019-09-17_13h50m_Subject 47099.txt","47099",2019-09-17,"13:50",79,60,11,8,19,18,5,2,25,27,6,12,45,667,71,96,834
"./Ship3_Latin-square/2019-09-17_13h50m_Subject 47798.txt","47798",2019-09-17,"13:50",75,55,11,9,20,45,8,9,62,27,19,5,51,148,13,32,193
"./Ship3_Latin-square/2019-09-17_14h56m_Subject 47080.txt","47080",2019-09-17,"14:56",87,60,15,12,27,33,1,8,42,21,7,10,38,525,14,170,709
"./Ship3_Latin-square/2019-09-17_14h56m_Subject 47089.txt","47089",2019-09-17,"14:56",82,60,10,12,22,57,13,29,99,77,20,42,139,382,45,100,527
"./Ship3_Latin-square/2019-09-17_14h56m_Subject 47762.txt","47762",2019-09-17,"14:56",81,60,11,10,21,74,10,10,94,51,10,10,71,188,24,43,255
"./Ship3_Latin-square/2019-09-17_14h56m_Subject 47791.txt","47791",2019-09-17,"14:56",87,60,16,11,27,25,3,1,29,42,21,8,71,329,16,112,457
"./Ship3_Latin-square/2019-09-18_09h56m_Subject 46878.txt","46878",2019-09-18,"09:56",85,60,15,10,25,40,8,4,52,37,40,66,143,542,105,123,770
"./Ship3_Latin-square/2019-09-18_09h56m_Subject 46885.txt","46885",2019-09-18,"09:56",78,57,11,10,21,79,14,15,108,48,6,14,68,155,7,51,213
"./Ship3_Latin-square/2019-09-18_09h56m_Subject 46899.txt","46899",2019-09-18,"09:56",82,60,12,10,22,27,3,4,34,24,5,5,34,919,140,139,1198
"./Ship3_Latin-square/2019-09-18_09h56m_Subject 47081.txt","47081",2019-09-18,"09:56",85,60,14,11,25,58,3,14,75,34,9,31,74,278,2,83,363
"./Ship3_Latin-square/2019-09-18_09h56m_Subject 47091.txt","47091",2019-09-18,"09:56",82,60,14,8,22,38,7,2,47,53,20,46,119,319,74,66,459
"./Ship3_Latin-square/2019-09-18_09h56m_Subject 47231.txt","47231",2019-09-18,"09:56",81,59,8,14,22,63,16,20,99,93,11,14,118,253,29,70,352
"./Ship3_Latin-square/2019-09-18_09h56m_Subject 47238.txt","47238",2019-09-18,"09:56",74,60,6,8,14,15,1,2,18,54,13,4,71,559,51,77,687
"./Ship3_Latin-square/2019-09-18_09h56m_Subject 47242.txt","47242",2019-09-18,"09:56",78,60,6,12,18,27,1,6,34,56,4,9,69,697,90,153,940
"./Ship3_Latin-square/2019-09-18_09h56m_Subject 47244.txt","47244",2019-09-18,"09:56",82,60,11,11,22,41,1,3,45,73,13,15,101,323,13,72,408
"./Ship3_Latin-square/2019-09-18_09h56m_Subject 47633.txt","47633",2019-09-18,"09:56",80,60,11,9,20,44,17,6,67,57,21,12,90,371,48,88,507
"./Ship3_Latin-square/2019-09-18_09h56m_Subject 47636.txt","47636",2019-09-18,"09:56",79,60,9,10,19,83,11,5,99,154,8,11,173,320,45,37,402
"./Ship3_Latin-square/2019-09-18_09h56m_Subject 47752.txt","47752",2019-09-18,"09:56",84,60,9,15,24,50,5,2,57,28,13,20,61,757,58,209,1024
"./Ship3_Latin-square/2019-09-18_09h56m_Subject 47767.txt","47767",2019-09-18,"09:56",82,60,11,11,22,39,6,6,51,55,25,23,103,340,70,57,467
"./Ship3_Latin-square/2019-09-18_09h56m_Subject 47768.txt","47768",2019-09-18,"09:56",74,53,12,9,21,55,7,11,73,30,10,33,73,374,62,99,535
"./Ship3_Latin-square/2019-09-18_09h56m_Subject 47780.txt","47780",2019-09-18,"09:56",82,60,13,9,22,63,10,14,87,60,13,9,82,333,33,75,441
"./Ship3_Latin-square/2019-09-18_10h00m_Subject 46884.txt","46884",2019-09-18,"10:00",80,60,9,11,20,34,8,10,52,44,1,5,50,292,50,26,368
"./Ship3_Latin-square/2019-09-18_10h00m_Subject 47083.txt","47083",2019-09-18,"10:00",70,48,12,10,22,65,11,20,96,39,20,18,77,114,12,55,181
"./Ship3_Latin-square/2019-09-18_10h00m_Subject 47086.txt","47086",2019-09-18,"10:00",56,42,11,3,14,53,6,7,66,29,54,9,92,137,5,6,148
"./Ship3_Latin-square/2019-09-18_10h00m_Subject 47246.txt","47246",2019-09-18,"10:00",80,60,7,13,20,34,5,1,40,23,4,18,45,485,68,93,646
"./Ship3_Latin-square/2019-09-18_10h00m_Subject 47635.txt","47635",2019-09-18,"10:00",76,60,10,6,16,21,6,1,28,41,8,4,53,513,56,74,643
"./Ship3_Latin-square/2019-09-18_10h00m_Subject 47779.txt","47779",2019-09-18,"10:00",59,42,12,5,17,25,5,2,32,21,10,4,35,73,13,10,96
"./Ship3_Latin-square/2019-09-18_10h00m_Subject 47797.txt","47797",2019-09-18,"10:00",38,28,6,4,10,53,9,5,67,27,8,4,39,43,10,6,59
"./Ship3_Latin-square/2019-09-18_11h19m_Subject 46900.txt","46900",2019-09-18,"11:19",79,60,9,10,19,15,0,0,15,79,31,21,131,1022,147,160,1329
"./Ship3_Latin-square/2019-09-18_11h19m_Subject 46986.txt","46986",2019-09-18,"11:19",78,59,11,8,19,53,10,5,68,11,0,1,12,215,38,42,295
"./Ship3_Latin-square/2019-09-18_11h19m_Subject 47076.txt","47076",2019-09-18,"11:19",76,60,7,9,16,19,3,0,22,22,3,10,35,926,85,166,1177
"./Ship3_Latin-square/2019-09-18_11h19m_Subject 47079.txt","47079",2019-09-18,"11:19",78,60,11,7,18,56,11,12,79,68,13,7,88,209,7,29,245
"./Ship3_Latin-square/2019-09-18_11h19m_Subject 47082.txt","47082",2019-09-18,"11:19",84,60,10,14,24,14,1,6,21,67,22,8,97,425,90,102,617
"./Ship3_Latin-square/2019-09-18_11h19m_Subject 47092.txt","47092",2019-09-18,"11:19",71,60,8,3,11,44,4,7,55,46,7,2,55,444,6,39,489
"./Ship3_Latin-square/2019-09-18_11h19m_Subject 47098.txt","47098",2019-09-18,"11:19",78,60,9,9,18,18,0,1,19,17,0,9,26,157,14,31,202
"./Ship3_Latin-square/2019-09-18_11h19m_Subject 47226.txt","47226",2019-09-18,"11:19",78,60,4,14,18,17,1,2,20,58,5,21,84,1618,92,261,1971
"./Ship3_Latin-square/2019-09-18_11h19m_Subject 47227.txt","47227",2019-09-18,"11:19",80,60,7,13,20,15,1,1,17,17,8,7,32,854,114,201,1169
"./Ship3_Latin-square/2019-09-18_11h19m_Subject 47250.txt","47250",2019-09-18,"11:19",77,60,9,8,17,49,5,10,64,16,7,8,31,333,4,80,417
"./Ship3_Latin-square/2019-09-18_11h19m_Subject 47645.txt","47645",2019-09-18,"11:19",79,58,14,7,21,94,21,11,126,22,7,1,30,290,53,59,402
"./Ship3_Latin-square/2019-09-18_11h19m_Subject 47646.txt","47646",2019-09-18,"11:19",82,60,8,14,22,9,3,2,14,101,10,44,155,1586,185,428,2199
"./Ship3_Latin-square/2019-09-18_11h19m_Subject 47755.txt","47755",2019-09-18,"11:19",78,60,8,10,18,40,3,4,47,22,14,3,39,675,100,118,893
"./Ship3_Latin-square/2019-09-18_11h19m_Subject 47760.txt","47760",2019-09-18,"11:19",84,60,14,10,24,55,8,12,75,52,11,9,72,465,6,139,610
"./Ship3_Latin-square/2019-09-18_11h19m_Subject 47770.txt","47770",2019-09-18,"11:19",44,33,6,5,11,53,8,3,64,29,17,5,51,96,20,17,133
"./Ship3_Latin-square/2019-09-18_11h19m_Subject 47795.txt","47795",2019-09-18,"11:19",81,60,3,18,21,24,3,3,30,28,2,17,47,624,35,152,811
"./Ship3_Latin-square/2019-09-18_11h22m_Subject 47229.txt","47229",2019-09-18,"11:22",81,60,14,7,21,59,0,14,73,47,21,6,74,359,7,65,431
"./Ship3_Latin-square/2019-09-18_11h22m_Subject 47233.txt","47233",2019-09-18,"11:22",76,60,4,12,16,19,0,3,22,55,5,3,63,374,23,116,513
"./Ship3_Latin-square/2019-09-18_11h22m_Subject 47234.txt","47234",2019-09-18,"11:22",82,60,14,8,22,51,3,8,62,44,7,11,62,334,22,88,444
"./Ship3_Latin-square/2019-09-18_11h22m_Subject 47237.txt","47237",2019-09-18,"11:22",86,60,17,9,26,44,1,6,51,28,12,4,44,367,12,76,455
"./Ship3_Latin-square/2019-09-18_11h22m_Subject 47241.txt","47241",2019-09-18,"11:22",79,60,9,10,19,18,0,3,21,7,1,2,10,811,60,201,1072
"./Ship3_Latin-square/2019-09-18_11h22m_Subject 47247.txt","47247",2019-09-18,"11:22",75,60,7,8,15,51,4,7,62,46,8,5,59,163,3,44,210
"./Ship3_Latin-square/2019-09-18_11h22m_Subject 47777.txt","47777",2019-09-18,"11:22",82,60,4,18,22,37,3,10,50,14,2,15,31,472,44,130,646
"./Ship3_Latin-square/2019-09-18_11h22m_Subject 47784.txt","47784",2019-09-18,"11:22",74,60,8,6,14,155,10,38,203,61,9,11,81,472,7,41,520
"./Ship3_Latin-square/2019-09-18_12h27m_Subject 46881.txt","46881",2019-09-18,"12:27",75,60,9,6,15,72,5,16,93,49,2,5,56,242,7,28,277
"./Ship3_Latin-square/2019-09-18_12h27m_Subject 47087.txt","47087",2019-09-18,"12:27",63,46,12,5,17,74,5,8,87,29,12,8,49,163,8,23,194
"./Ship3_Latin-square/2019-09-18_12h27m_Subject 47626.txt","47626",2019-09-18,"12:27",79,60,7,12,19,64,4,1,69,34,5,11,50,256,42,50,348
"./Ship3_Latin-square/2019-09-18_12h27m_Subject 47632.txt","47632",2019-09-18,"12:27",79,60,10,9,19,16,4,0,20,31,23,10,64,1063,155,169,1387
"./Ship3_Latin-square/2019-09-18_12h27m_Subject 47634.txt","47634",2019-09-18,"12:27",81,60,14,7,21,53,6,8,67,33,6,6,45,217,11,43,271
"./Ship3_Latin-square/2019-09-18_12h27m_Subject 47640.txt","47640",2019-09-18,"12:27",79,60,11,8,19,49,16,12,77,52,13,11,76,252,3,77,332
"./Ship3_Latin-square/2019-09-18_12h27m_Subject 47754.txt","47754",2019-09-18,"12:27",64,48,12,4,16,45,9,3,57,30,10,4,44,108,27,15,150
"./Ship3_Latin-square/2019-09-18_12h27m_Subject 47800.txt","47800",2019-09-18,"12:27",82,60,9,13,22,37,5,7,49,70,11,23,104,652,82,150,884
"./Ship3_Latin-square/2019-09-18_12h29m_Subject 46880.txt","46880",2019-09-18,"12:29",81,60,9,12,21,10,5,2,17,40,19,4,63,926,102,233,1261
"./Ship3_Latin-square/2019-09-18_12h29m_Subject 46882.txt","46882",2019-09-18,"12:29",83,60,14,9,23,62,3,12,77,35,47,19,101,332,11,68,411
"./Ship3_Latin-square/2019-09-18_12h29m_Subject 46883.txt","46883",2019-09-18,"12:29",79,60,8,11,19,23,2,7,32,166,45,5,216,359,42,93,494
"./Ship3_Latin-square/2019-09-18_12h29m_Subject 46894.txt","46894",2019-09-18,"12:29",82,60,10,12,22,41,6,8,55,44,6,2,52,370,44,90,504
"./Ship3_Latin-square/2019-09-18_12h29m_Subject 46896.txt","46896",2019-09-18,"12:29",83,60,14,9,23,39,6,8,53,35,5,6,46,349,24,77,450
"./Ship3_Latin-square/2019-09-18_12h29m_Subject 47088.txt","47088",2019-09-18,"12:29",81,60,7,14,21,20,2,2,24,48,2,13,63,1161,154,297,1612
"./Ship3_Latin-square/2019-09-18_12h29m_Subject 47228.txt","47228",2019-09-18,"12:29",79,60,11,8,19,12,6,0,18,23,4,5,32,470,59,107,636
"./Ship3_Latin-square/2019-09-18_12h29m_Subject 47243.txt","47243",2019-09-18,"12:29",81,60,13,8,21,80,5,10,95,18,3,1,22,470,70,57,597
"./Ship3_Latin-square/2019-09-18_12h29m_Subject 47249.txt","47249",2019-09-18,"12:29",76,60,8,8,16,26,4,8,38,75,12,23,110,412,49,62,523
"./Ship3_Latin-square/2019-09-18_12h29m_Subject 47639.txt","47639",2019-09-18,"12:29",80,60,12,8,20,43,1,5,49,27,9,3,39,380,49,59,488
"./Ship3_Latin-square/2019-09-18_12h29m_Subject 47649.txt","47649",2019-09-18,"12:29",65,48,12,5,17,59,6,6,71,11,1,1,13,150,11,13,174
"./Ship3_Latin-square/2019-09-18_12h29m_Subject 47758.txt","47758",2019-09-18,"12:29",79,60,8,11,19,14,1,6,21,23,6,21,50,810,104,148,1062
"./Ship3_Latin-square/2019-09-18_12h29m_Subject 47759.txt","47759",2019-09-18,"12:29",82,60,8,14,22,21,2,0,23,17,6,10,33,576,72,155,803
"./Ship3_Latin-square/2019-09-18_12h29m_Subject 47776.txt","47776",2019-09-18,"12:29",81,60,12,9,21,12,0,3,15,56,24,14,94,735,88,132,955
"./Ship3_Latin-square/2019-09-18_12h29m_Subject 47799.txt","47799",2019-09-18,"12:29",82,60,11,11,22,25,3,1,29,58,26,17,101,619,107,176,902
"./Ship3_Latin-square/2019-09-18_13h38m_Subject 46888.txt","46888",2019-09-18,"13:38",81,60,6,15,21,2,0,2,4,55,13,10,78,995,111,231,1337
"./Ship3_Latin-square/2019-09-18_13h38m_Subject 46889.txt","46889",2019-09-18,"13:38",79,60,7,12,19,8,1,0,9,22,7,10,39,1208,160,224,1592
"./Ship3_Latin-square/2019-09-18_13h38m_Subject 46890.txt","46890",2019-09-18,"13:38",82,60,13,9,22,16,7,1,24,12,9,1,22,185,34,40,259
"./Ship3_Latin-square/2019-09-18_13h38m_Subject 46892.txt","46892",2019-09-18,"13:38",84,60,10,14,24,8,3,1,12,22,1,11,34,1027,177,237,1441
"./Ship3_Latin-square/2019-09-18_13h38m_Subject 46898.txt","46898",2019-09-18,"13:38",71,60,5,6,11,22,1,2,25,18,0,2,20,537,54,51,642
"./Ship3_Latin-square/2019-09-18_13h38m_Subject 47097.txt","47097",2019-09-18,"13:38",79,60,12,7,19,71,3,11,85,82,20,6,108,365,2,55,422
"./Ship3_Latin-square/2019-09-18_13h38m_Subject 47099.txt","47099",2019-09-18,"13:38",78,60,7,11,18,4,0,0,4,48,8,12,68,1536,178,291,2005
"./Ship3_Latin-square/2019-09-18_13h38m_Subject 47798.txt","47798",2019-09-18,"13:38",82,60,7,15,22,30,2,5,37,29,0,4,33,259,30,68,357
"./Ship3_Latin-square/2019-09-18_13h40m_Subject 46876.txt","46876",2019-09-18,"13:40",79,60,8,11,19,29,6,5,40,4,0,1,5,599,88,171,858
"./Ship3_Latin-square/2019-09-18_13h40m_Subject 46877.txt","46877",2019-09-18,"13:40",84,60,14,10,24,25,2,8,35,43,49,123,215,785,104,205,1094
"./Ship3_Latin-square/2019-09-18_13h40m_Subject 46893.txt","46893",2019-09-18,"13:40",79,60,12,7,19,18,1,2,21,44,6,3,53,899,144,134,1177
"./Ship3_Latin-square/2019-09-18_13h40m_Subject 46895.txt","46895",2019-09-18,"13:40",76,53,14,9,23,52,15,17,84,47,10,11,68,141,4,54,199
"./Ship3_Latin-square/2019-09-18_13h40m_Subject 47638.txt","47638",2019-09-18,"13:40",78,60,12,6,18,63,11,10,84,33,4,9,46,249,32,21,302
"./Ship3_Latin-square/2019-09-18_13h40m_Subject 47757.txt","47757",2019-09-18,"13:40",80,58,8,14,22,78,8,16,102,32,5,16,53,308,40,75,423
"./Ship3_Latin-square/2019-09-18_13h40m_Subject 47769.txt","47769",2019-09-18,"13:40",84,60,14,10,24,43,6,20,69,36,13,11,60,445,57,94,596
"./Ship3_Latin-square/2019-09-18_13h40m_Subject 47771.txt","47771",2019-09-18,"13:40",80,60,7,13,20,20,1,3,24,11,12,1,24,776,87,143,1006
"./Ship3_Latin-square/2019-09-18_13h40m_Subject 47775.txt","47775",2019-09-18,"13:40",83,60,9,14,23,36,1,11,48,9,4,1,14,504,96,121,721
"./Ship3_Latin-square/2019-09-18_13h40m_Subject 47781.txt","47781",2019-09-18,"13:40",82,60,13,9,22,27,0,3,30,46,19,12,77,525,17,122,664
"./Ship3_Latin-square/2019-09-18_13h40m_Subject 47782.txt","47782",2019-09-18,"13:40",84,60,11,13,24,14,1,1,16,12,1,7,20,883,165,202,1250
"./Ship3_Latin-square/2019-09-18_13h40m_Subject 47783.txt","47783",2019-09-18,"13:40",71,54,10,7,17,97,10,17,124,34,7,3,44,244,6,57,307
"./Ship3_Latin-square/2019-09-18_13h40m_Subject 47785.txt","47785",2019-09-18,"13:40",85,60,15,10,25,38,2,15,55,34,27,11,72,488,9,168,665
"./Ship3_Latin-square/2019-09-18_13h40m_Subject 47786.txt","47786",2019-09-18,"13:40",61,45,8,8,16,58,5,7,70,32,3,12,47,175,14,54,243
"./Ship3_Latin-square/2019-09-18_13h40m_Subject 47788.txt","47788",2019-09-18,"13:40",84,60,9,15,24,38,6,9,53,93,23,78,194,739,112,195,1046
"./Ship3_Latin-square/2019-09-18_14h42m_Subject 47080.txt","47080",2019-09-18,"14:42",75,60,4,11,15,6,0,3,9,68,2,17,87,1396,62,194,1652
"./Ship3_Latin-square/2019-09-18_14h42m_Subject 47089.txt","47089",2019-09-18,"14:42",72,52,17,3,20,81,12,6,99,63,25,3,91,214,2,16,232
"./Ship3_Latin-square/2019-09-18_14h42m_Subject 47762.txt","47762",2019-09-18,"14:42",80,60,10,10,20,62,10,6,78,24,10,12,46,259,40,72,371
"./Ship3_Latin-square/2019-09-18_14h42m_Subject 47791.txt","47791",2019-09-18,"14:42",77,60,7,10,17,13,1,1,15,20,10,5,35,711,86,125,922
"./Ship3_Latin-square/2019-09-19_10h01m_Subject 46884.txt","46884",2019-09-19,"10:01",78,60,11,7,18,29,4,2,35,20,4,9,33,262,60,25,347
"./Ship3_Latin-square/2019-09-19_10h01m_Subject 47083.txt","47083",2019-09-19,"10:01",71,50,5,16,21,64,8,6,78,57,5,30,92,275,21,88,384
"./Ship3_Latin-square/2019-09-19_10h01m_Subject 47086.txt","47086",2019-09-19,"10:01",77,60,9,8,17,34,1,3,38,29,5,4,38,328,37,45,410
"./Ship3_Latin-square/2019-09-19_10h01m_Subject 47246.txt","47246",2019-09-19,"10:01",82,60,8,14,22,33,8,2,43,9,6,5,20,342,59,87,488
"./Ship3_Latin-square/2019-09-19_10h01m_Subject 47635.txt","47635",2019-09-19,"10:01",79,60,7,12,19,24,4,5,33,52,7,4,63,590,83,109,782
"./Ship3_Latin-square/2019-09-19_10h01m_Subject 47779.txt","47779",2019-09-19,"10:01",82,60,10,12,22,58,15,4,77,71,50,31,152,178,28,39,245
"./Ship3_Latin-square/2019-09-19_10h01m_Subject 47790.txt","47790",2019-09-19,"10:01",83,60,12,11,23,58,33,33,124,43,23,19,85,267,73,70,410
"./Ship3_Latin-square/2019-09-19_10h01m_Subject 47797.txt","47797",2019-09-19,"10:01",50,39,6,5,11,43,5,4,52,84,23,4,111,103,27,14,144
"./Ship3_Latin-square/2019-09-19_10h07m_Subject 46878.txt","46878",2019-09-19,"10:07",79,60,8,11,19,22,0,2,24,27,3,1,31,997,136,131,1264
"./Ship3_Latin-square/2019-09-19_10h07m_Subject 46885.txt","46885",2019-09-19,"10:07",81,60,12,9,21,43,15,9,67,11,5,4,20,353,77,35,465
"./Ship3_Latin-square/2019-09-19_10h07m_Subject 46899.txt","46899",2019-09-19,"10:07",79,60,14,5,19,117,4,21,142,29,5,12,46,436,10,46,492
"./Ship3_Latin-square/2019-09-19_10h07m_Subject 47081.txt","47081",2019-09-19,"10:07",84,60,12,12,24,72,7,1,80,9,5,8,22,349,42,101,492
"./Ship3_Latin-square/2019-09-19_10h07m_Subject 47091.txt","47091",2019-09-19,"10:07",78,60,8,10,18,53,7,5,65,70,12,32,114,214,6,62,282
"./Ship3_Latin-square/2019-09-19_10h07m_Subject 47231.txt","47231",2019-09-19,"10:07",81,59,15,7,22,64,27,7,98,22,25,3,50,186,23,26,235
"./Ship3_Latin-square/2019-09-19_10h07m_Subject 47238.txt","47238",2019-09-19,"10:07",79,60,13,6,19,41,1,5,47,35,36,8,79,333,18,54,405
"./Ship3_Latin-square/2019-09-19_10h07m_Subject 47242.txt","47242",2019-09-19,"10:07",80,60,11,9,20,149,3,12,164,154,13,29,196,320,0,87,407
"./Ship3_Latin-square/2019-09-19_10h07m_Subject 47244.txt","47244",2019-09-19,"10:07",80,60,9,11,20,21,7,1,29,82,12,21,115,835,143,149,1127
"./Ship3_Latin-square/2019-09-19_10h07m_Subject 47633.txt","47633",2019-09-19,"10:07",81,60,9,12,21,27,2,10,39,72,16,16,104,500,73,94,667
"./Ship3_Latin-square/2019-09-19_10h07m_Subject 47636.txt","47636",2019-09-19,"10:07",83,59,16,8,24,74,9,6,89,65,31,9,105,296,60,37,393
"./Ship3_Latin-square/2019-09-19_10h07m_Subject 47752.txt","47752",2019-09-19,"10:07",85,60,17,8,25,74,20,14,108,41,34,8,83,316,27,65,408
"./Ship3_Latin-square/2019-09-19_10h07m_Subject 47767.txt","47767",2019-09-19,"10:07",67,52,10,5,15,121,9,14,144,40,25,5,70,161,7,13,181
"./Ship3_Latin-square/2019-09-19_10h07m_Subject 47768.txt","47768",2019-09-19,"10:07",49,36,11,2,13,51,19,2,72,31,15,3,49,135,18,11,164
"./Ship3_Latin-square/2019-09-19_10h07m_Subject 47780.txt","47780",2019-09-19,"10:07",81,60,10,11,21,50,7,5,62,55,8,18,81,368,55,79,502
"./Ship3_Latin-square/2019-09-19_11h21m_Subject 47229.txt","47229",2019-09-19,"11:21",78,60,6,12,18,9,5,3,17,44,11,9,64,982,92,223,1297
"./Ship3_Latin-square/2019-09-19_11h21m_Subject 47233.txt","47233",2019-09-19,"11:21",85,60,5,20,25,37,1,12,50,29,15,26,70,439,25,180,644
"./Ship3_Latin-square/2019-09-19_11h21m_Subject 47234.txt","47234",2019-09-19,"11:21",82,60,13,9,22,48,4,8,60,176,15,19,210,352,86,101,539
"./Ship3_Latin-square/2019-09-19_11h21m_Subject 47237.txt","47237",2019-09-19,"11:21",79,60,10,9,19,28,2,2,32,17,17,28,62,781,87,177,1045
"./Ship3_Latin-square/2019-09-19_11h21m_Subject 47241.txt","47241",2019-09-19,"11:21",79,60,6,13,19,16,0,2,18,6,4,2,12,917,77,269,1263
"./Ship3_Latin-square/2019-09-19_11h21m_Subject 47247.txt","47247",2019-09-19,"11:21",75,60,5,10,15,9,1,0,10,25,1,3,29,542,60,60,662
"./Ship3_Latin-square/2019-09-19_11h21m_Subject 47777.txt","47777",2019-09-19,"11:21",72,53,11,8,19,117,14,19,150,34,10,9,53,132,7,19,158
"./Ship3_Latin-square/2019-09-19_11h21m_Subject 47784.txt","47784",2019-09-19,"11:21",81,60,6,15,21,23,2,6,31,60,18,24,102,1089,110,256,1455
"./Ship3_Latin-square/2019-09-19_11h25m_Subject 46900.txt","46900",2019-09-19,"11:25",80,60,8,12,20,19,1,46,66,80,16,5,101,1156,188,255,1599
"./Ship3_Latin-square/2019-09-19_11h25m_Subject 46986.txt","46986",2019-09-19,"11:25",61,45,12,4,16,75,8,8,91,29,28,5,62,155,11,25,191
"./Ship3_Latin-square/2019-09-19_11h25m_Subject 47076.txt","47076",2019-09-19,"11:25",77,60,13,4,17,63,3,7,73,49,16,4,69,460,8,45,513
"./Ship3_Latin-square/2019-09-19_11h25m_Subject 47079.txt","47079",2019-09-19,"11:25",76,60,7,9,16,18,0,4,22,71,7,10,88,372,57,71,500
"./Ship3_Latin-square/2019-09-19_11h25m_Subject 47082.txt","47082",2019-09-19,"11:25",73,54,11,8,19,73,10,5,88,63,17,7,87,217,13,38,268
"./Ship3_Latin-square/2019-09-19_11h25m_Subject 47092.txt","47092",2019-09-19,"11:25",76,60,6,10,16,15,3,3,21,39,13,4,56,894,101,123,1118
"./Ship3_Latin-square/2019-09-19_11h25m_Subject 47098.txt","47098",2019-09-19,"11:25",84,60,10,14,24,17,0,1,18,10,0,21,31,310,37,79,426
"./Ship3_Latin-square/2019-09-19_11h25m_Subject 47226.txt","47226",2019-09-19,"11:25",80,60,9,11,20,56,3,22,81,64,27,12,103,558,45,220,823
"./Ship3_Latin-square/2019-09-19_11h25m_Subject 47227.txt","47227",2019-09-19,"11:25",84,60,14,10,24,77,26,8,111,28,16,29,73,318,8,103,429
"./Ship3_Latin-square/2019-09-19_11h25m_Subject 47250.txt","47250",2019-09-19,"11:25",84,60,7,17,24,21,0,3,24,21,4,24,49,1004,110,257,1371
"./Ship3_Latin-square/2019-09-19_11h25m_Subject 47645.txt","47645",2019-09-19,"11:25",47,32,13,2,15,108,26,6,140,19,12,3,34,153,11,17,181
"./Ship3_Latin-square/2019-09-19_11h25m_Subject 47646.txt","47646",2019-09-19,"11:25",82,60,12,10,22,39,3,16,58,69,29,11,109,735,10,232,977
"./Ship3_Latin-square/2019-09-19_11h25m_Subject 47755.txt","47755",2019-09-19,"11:25",84,60,13,11,24,119,11,28,158,34,3,9,46,362,20,120,502
"./Ship3_Latin-square/2019-09-19_11h25m_Subject 47760.txt","47760",2019-09-19,"11:25",80,60,10,10,20,45,7,9,61,38,11,12,61,902,173,143,1218
"./Ship3_Latin-square/2019-09-19_11h25m_Subject 47770.txt","47770",2019-09-19,"11:25",46,33,4,9,13,46,6,5,57,101,18,103,222,104,27,17,148
"./Ship3_Latin-square/2019-09-19_11h25m_Subject 47795.txt","47795",2019-09-19,"11:25",75,54,14,7,21,124,21,12,157,53,33,26,112,157,6,31,194
"./Ship3_Latin-square/2019-09-19_12h45m_Subject 46880.txt","46880",2019-09-19,"12:45",83,60,13,10,23,46,0,13,59,9,15,4,28,415,1,70,486
"./Ship3_Latin-square/2019-09-19_12h45m_Subject 46882.txt","46882",2019-09-19,"12:45",81,60,9,12,21,12,3,4,19,62,11,18,91,832,160,199,1191
"./Ship3_Latin-square/2019-09-19_12h45m_Subject 46883.txt","46883",2019-09-19,"12:45",79,60,11,8,19,72,6,15,93,52,16,8,76,191,0,32,223
"./Ship3_Latin-square/2019-09-19_12h45m_Subject 46894.txt","46894",2019-09-19,"12:45",75,60,4,11,15,52,2,5,59,39,5,3,47,493,43,78,614
"./Ship3_Latin-square/2019-09-19_12h45m_Subject 46896.txt","46896",2019-09-19,"12:45",85,60,9,16,25,19,5,4,28,45,13,15,73,803,134,227,1164
"./Ship3_Latin-square/2019-09-19_12h45m_Subject 47088.txt","47088",2019-09-19,"12:45",81,60,9,12,21,41,2,4,47,68,9,20,97,899,83,219,1201
"./Ship3_Latin-square/2019-09-19_12h45m_Subject 47228.txt","47228",2019-09-19,"12:45",77,60,5,12,17,12,2,0,14,16,5,10,31,684,58,146,888
"./Ship3_Latin-square/2019-09-19_12h45m_Subject 47243.txt","47243",2019-09-19,"12:45",81,60,14,7,21,39,11,7,57,35,14,3,52,668,115,90,873
"./Ship3_Latin-square/2019-09-19_12h45m_Subject 47249.txt","47249",2019-09-19,"12:45",80,60,11,9,20,48,11,1,60,78,21,15,114,232,44,53,329
"./Ship3_Latin-square/2019-09-19_12h45m_Subject 47639.txt","47639",2019-09-19,"12:45",78,60,7,11,18,15,0,1,16,1,6,3,10,908,109,157,1174
"./Ship3_Latin-square/2019-09-19_12h45m_Subject 47649.txt","47649",2019-09-19,"12:45",83,60,10,13,23,31,6,3,40,20,9,1,30,369,51,101,521
"./Ship3_Latin-square/2019-09-19_12h45m_Subject 47753.txt","47753",2019-09-19,"12:45",83,60,9,14,23,120,31,11,162,58,89,7,154,556,90,134,780
"./Ship3_Latin-square/2019-09-19_12h45m_Subject 47758.txt","47758",2019-09-19,"12:45",80,60,9,11,20,12,1,3,16,36,1,2,39,770,108,154,1032
"./Ship3_Latin-square/2019-09-19_12h45m_Subject 47759.txt","47759",2019-09-19,"12:45",82,60,11,11,22,23,3,3,29,17,1,34,52,527,70,133,730
"./Ship3_Latin-square/2019-09-19_12h45m_Subject 47776.txt","47776",2019-09-19,"12:45",80,60,9,11,20,13,2,2,17,55,24,15,94,974,152,164,1290
"./Ship3_Latin-square/2019-09-19_12h45m_Subject 47799.txt","47799",2019-09-19,"12:45",82,60,12,10,22,12,2,3,17,96,80,11,187,548,102,106,756
"./Ship3_Latin-square/2019-09-19_12h48m_Subject 46881.txt","46881",2019-09-19,"12:48",84,60,11,13,24,39,2,2,43,22,6,0,28,529,61,150,740
"./Ship3_Latin-square/2019-09-19_12h48m_Subject 47087.txt","47087",2019-09-19,"12:48",79,60,7,12,19,18,2,4,24,56,6,23,85,327,42,50,419
"./Ship3_Latin-square/2019-09-19_12h48m_Subject 47626.txt","47626",2019-09-19,"12:48",57,42,11,4,15,80,8,11,99,25,7,2,34,158,1,24,183
"./Ship3_Latin-square/2019-09-19_12h48m_Subject 47632.txt","47632",2019-09-19,"12:48",78,60,9,9,18,5,3,2,10,26,9,23,58,1228,157,198,1583
"./Ship3_Latin-square/2019-09-19_12h48m_Subject 47634.txt","47634",2019-09-19,"12:48",80,60,8,12,20,30,3,6,39,8,3,8,19,440,77,97,614
"./Ship3_Latin-square/2019-09-19_12h48m_Subject 47640.txt","47640",2019-09-19,"12:48",78,60,10,8,18,31,9,5,45,25,3,5,33,750,163,122,1035
"./Ship3_Latin-square/2019-09-19_12h48m_Subject 47754.txt","47754",2019-09-19,"12:48",67,49,8,10,18,49,7,6,62,62,17,49,128,303,48,80,431
"./Ship3_Latin-square/2019-09-19_12h48m_Subject 47800.txt","47800",2019-09-19,"12:48",81,60,9,12,21,21,8,8,37,44,10,6,60,441,53,104,598
"./Ship3_Latin-square/2019-09-19_13h57m_Subject 46888.txt","46888",2019-09-19,"13:57",82,60,12,10,22,11,3,3,17,34,22,8,64,693,99,139,931
"./Ship3_Latin-square/2019-09-19_13h57m_Subject 46889.txt","46889",2019-09-19,"13:57",81,60,5,16,21,6,0,0,6,9,1,7,17,1169,108,254,1531
"./Ship3_Latin-square/2019-09-19_13h57m_Subject 46890.txt","46890",2019-09-19,"13:57",79,60,7,12,19,30,1,4,35,6,6,10,22,423,66,74,563
"./Ship3_Latin-square/2019-09-19_13h57m_Subject 46892.txt","46892",2019-09-19,"13:57",77,60,7,10,17,8,1,2,11,16,3,4,23,755,101,115,971
"./Ship3_Latin-square/2019-09-19_13h57m_Subject 46898.txt","46898",2019-09-19,"13:57",82,60,13,9,22,22,1,6,29,18,15,9,42,468,77,104,649
"./Ship3_Latin-square/2019-09-19_13h57m_Subject 47097.txt","47097",2019-09-19,"13:57",81,60,9,12,21,8,2,2,12,75,19,8,102,938,148,231,1317
"./Ship3_Latin-square/2019-09-19_13h57m_Subject 47099.txt","47099",2019-09-19,"13:57",79,60,9,10,19,16,3,3,22,34,16,8,58,912,141,206,1259
"./Ship3_Latin-square/2019-09-19_13h57m_Subject 47798.txt","47798",2019-09-19,"13:57",70,53,10,7,17,65,2,15,82,33,6,13,52,115,0,29,144
"./Ship3_Latin-square/2019-09-19_14h00m_Subject 46876.txt","46876",2019-09-19,"14:00",46,36,10,0,10,32,3,0,35,7,1,0,8,219,1,0,220
"./Ship3_Latin-square/2019-09-19_14h00m_Subject 46877.txt","46877",2019-09-19,"14:00",80,60,10,10,20,24,2,16,42,101,114,81,296,1206,181,234,1621
"./Ship3_Latin-square/2019-09-19_14h00m_Subject 46893.txt","46893",2019-09-19,"14:00",74,60,4,10,14,4,0,0,4,34,1,7,42,1369,90,213,1672
"./Ship3_Latin-square/2019-09-19_14h00m_Subject 46895.txt","46895",2019-09-19,"14:00",85,60,10,15,25,57,11,14,82,29,20,5,54,355,49,134,538
"./Ship3_Latin-square/2019-09-19_14h00m_Subject 47638.txt","47638",2019-09-19,"14:00",81,60,11,10,21,87,10,11,108,19,3,75,97,512,104,72,688
"./Ship3_Latin-square/2019-09-19_14h00m_Subject 47757.txt","47757",2019-09-19,"14:00",76,54,12,10,22,81,19,11,111,39,9,13,61,290,60,69,419
"./Ship3_Latin-square/2019-09-19_14h00m_Subject 47769.txt","47769",2019-09-19,"14:00",84,60,13,11,24,31,1,14,46,38,27,16,81,536,148,127,811
"./Ship3_Latin-square/2019-09-19_14h00m_Subject 47771.txt","47771",2019-09-19,"14:00",86,60,15,11,26,56,9,14,79,17,14,9,40,334,47,91,472
"./Ship3_Latin-square/2019-09-19_14h00m_Subject 47775.txt","47775",2019-09-19,"14:00",85,60,12,13,25,96,19,33,148,45,8,37,90,238,31,77,346
"./Ship3_Latin-square/2019-09-19_14h00m_Subject 47781.txt","47781",2019-09-19,"14:00",80,60,6,14,20,11,0,2,13,42,14,12,68,1228,178,257,1663
"./Ship3_Latin-square/2019-09-19_14h00m_Subject 47782.txt","47782",2019-09-19,"14:00",75,60,7,8,15,26,1,1,28,4,3,2,9,763,79,122,964
"./Ship3_Latin-square/2019-09-19_14h00m_Subject 47783.txt","47783",2019-09-19,"14:00",79,60,8,11,19,36,2,3,41,48,8,14,70,873,135,154,1162
"./Ship3_Latin-square/2019-09-19_14h00m_Subject 47785.txt","47785",2019-09-19,"14:00",81,60,9,12,21,8,1,1,10,68,18,22,108,1628,201,337,2166
"./Ship3_Latin-square/2019-09-19_14h00m_Subject 47786.txt","47786",2019-09-19,"14:00",78,60,11,7,18,44,6,9,59,40,6,42,88,344,47,35,426
"./Ship3_Latin-square/2019-09-19_14h00m_Subject 47788.txt","47788",2019-09-19,"14:00",77,60,7,10,17,44,3,7,54,83,29,13,125,550,52,127,729
"./Ship3_Latin-square/2019-09-19_15h01m_Subject 47080.txt","47080",2019-09-19,"15:01",79,60,8,11,19,10,1,2,13,24,9,8,41,866,77,273,1216
"./Ship3_Latin-square/2019-09-19_15h01m_Subject 47089.txt","47089",2019-09-19,"15:01",79,60,10,9,19,23,8,5,36,94,11,34,139,448,65,61,574
"./Ship3_Latin-square/2019-09-19_15h01m_Subject 47762.txt","47762",2019-09-19,"15:01",84,59,14,11,25,47,13,9,69,26,10,10,46,140,9,62,211
"./Ship3_Latin-square/2019-09-19_15h01m_Subject 47791.txt","47791",2019-09-19,"15:01",75,60,3,12,15,15,0,2,17,22,1,3,26,691,50,120,861
"./Ship3_Latin-square/2019-09-20_09h34m_Subject 46884.txt","46884",2019-09-20,"09:34",61,46,12,3,15,43,1,5,49,15,3,2,20,138,10,11,159
"./Ship3_Latin-square/2019-09-20_09h34m_Subject 47083.txt","47083",2019-09-20,"09:34",73,52,9,12,21,56,8,12,76,46,24,19,89,338,46,84,468
"./Ship3_Latin-square/2019-09-20_09h34m_Subject 47086.txt","47086",2019-09-20,"09:34",78,60,9,9,18,31,8,2,41,18,8,1,27,468,48,98,614
"./Ship3_Latin-square/2019-09-20_09h34m_Subject 47246.txt","47246",2019-09-20,"09:34",83,60,8,15,23,58,4,23,85,16,2,11,29,156,0,67,223
"./Ship3_Latin-square/2019-09-20_09h34m_Subject 47635.txt","47635",2019-09-20,"09:34",82,60,13,9,22,79,7,14,100,58,18,7,83,353,1,92,446
"./Ship3_Latin-square/2019-09-20_09h34m_Subject 47779.txt","47779",2019-09-20,"09:34",53,37,8,8,16,47,4,11,62,30,7,10,47,61,6,15,82
"./Ship3_Latin-square/2019-09-20_09h34m_Subject 47790.txt","47790",2019-09-20,"09:34",84,60,9,15,24,19,0,5,24,19,1,13,33,499,55,151,705
"./Ship3_Latin-square/2019-09-20_09h34m_Subject 47797.txt","47797",2019-09-20,"09:34",37,28,6,3,9,64,4,3,71,19,3,2,24,62,11,3,76
"./Ship3_Latin-square/2019-09-20_09h37m_Subject 46878.txt","46878",2019-09-20,"09:37",80,60,12,8,20,119,6,25,150,72,18,9,99,356,11,83,450
"./Ship3_Latin-square/2019-09-20_09h37m_Subject 46885.txt","46885",2019-09-20,"09:37",80,60,9,11,20,44,8,9,61,10,1,2,13,394,48,62,504
"./Ship3_Latin-square/2019-09-20_09h37m_Subject 46899.txt","46899",2019-09-20,"09:37",80,60,11,9,20,26,1,2,29,28,7,4,39,810,147,140,1097
"./Ship3_Latin-square/2019-09-20_09h37m_Subject 47081.txt","47081",2019-09-20,"09:37",79,60,10,9,19,24,5,3,32,7,16,18,41,677,88,127,892
"./Ship3_Latin-square/2019-09-20_09h37m_Subject 47091.txt","47091",2019-09-20,"09:37",79,60,5,14,19,17,2,4,23,57,4,12,73,286,25,70,381
"./Ship3_Latin-square/2019-09-20_09h37m_Subject 47095.txt","47095",2019-09-20,"09:37",81,60,12,9,21,46,23,5,74,10,17,17,44,446,99,57,602
"./Ship3_Latin-square/2019-09-20_09h37m_Subject 47231.txt","47231",2019-09-20,"09:37",80,60,6,14,20,66,8,13,87,60,15,10,85,284,16,48,348
"./Ship3_Latin-square/2019-09-20_09h37m_Subject 47238.txt","47238",2019-09-20,"09:37",78,60,10,8,18,23,1,3,27,43,25,15,83,454,89,60,603
"./Ship3_Latin-square/2019-09-20_09h37m_Subject 47242.txt","47242",2019-09-20,"09:37",85,60,9,16,25,71,2,20,93,21,6,50,77,885,129,223,1237
"./Ship3_Latin-square/2019-09-20_09h37m_Subject 47244.txt","47244",2019-09-20,"09:37",79,60,6,13,19,28,0,1,29,55,13,87,155,928,82,187,1197
"./Ship3_Latin-square/2019-09-20_09h37m_Subject 47633.txt","47633",2019-09-20,"09:37",78,60,12,6,18,67,9,12,88,64,25,5,94,296,11,40,347
"./Ship3_Latin-square/2019-09-20_09h37m_Subject 47636.txt","47636",2019-09-20,"09:37",78,60,12,6,18,194,81,9,284,149,116,4,269,418,106,55,579
"./Ship3_Latin-square/2019-09-20_09h37m_Subject 47752.txt","47752",2019-09-20,"09:37",76,60,8,8,16,35,5,4,44,23,14,9,46,684,100,58,842
"./Ship3_Latin-square/2019-09-20_09h37m_Subject 47767.txt","47767",2019-09-20,"09:37",82,60,11,11,22,37,6,2,45,24,13,1,38,424,74,72,570
"./Ship3_Latin-square/2019-09-20_09h37m_Subject 47768.txt","47768",2019-09-20,"09:37",80,60,6,14,20,34,5,2,41,24,3,21,48,505,61,164,730
"./Ship3_Latin-square/2019-09-20_09h37m_Subject 47780.txt","47780",2019-09-20,"09:37",78,60,9,9,18,72,7,8,87,37,11,4,52,296,32,60,388
"./Ship3_Latin-square/2019-09-20_10h48m_Subject 47229.txt","47229",2019-09-20,"10:48",80,60,10,10,20,15,0,1,16,37,11,6,54,560,70,119,749
"./Ship3_Latin-square/2019-09-20_10h48m_Subject 47233.txt","47233",2019-09-20,"10:48",83,60,11,12,23,60,5,12,77,55,8,17,80,273,4,118,395
"./Ship3_Latin-square/2019-09-20_10h48m_Subject 47234.txt","47234",2019-09-20,"10:48",81,60,11,10,21,79,1,9,89,154,11,26,191,479,115,118,712
"./Ship3_Latin-square/2019-09-20_10h48m_Subject 47237.txt","47237",2019-09-20,"10:48",78,60,10,8,18,16,5,0,21,8,2,17,27,494,74,70,638
"./Ship3_Latin-square/2019-09-20_10h48m_Subject 47241.txt","47241",2019-09-20,"10:48",71,60,4,7,11,13,0,1,14,6,2,1,9,805,36,128,969
"./Ship3_Latin-square/2019-09-20_10h48m_Subject 47247.txt","47247",2019-09-20,"10:48",76,60,5,11,16,15,0,0,15,17,0,3,20,450,34,63,547
"./Ship3_Latin-square/2019-09-20_10h48m_Subject 47777.txt","47777",2019-09-20,"10:48",72,55,4,13,17,32,8,0,40,24,2,7,33,480,41,114,635
"./Ship3_Latin-square/2019-09-20_10h48m_Subject 47784.txt","47784",2019-09-20,"10:48",80,60,3,17,20,23,1,6,30,42,0,20,62,1370,96,296,1762
"./Ship3_Latin-square/2019-09-20_10h51m_Subject 46900.txt","46900",2019-09-20,"10:51",82,60,11,11,22,28,0,11,39,51,26,13,90,564,8,123,695
"./Ship3_Latin-square/2019-09-20_10h51m_Subject 46986.txt","46986",2019-09-20,"10:51",58,41,13,4,17,48,16,5,69,15,13,2,30,143,40,14,197
"./Ship3_Latin-square/2019-09-20_10h51m_Subject 47076.txt","47076",2019-09-20,"10:51",78,60,6,12,18,16,1,2,19,11,4,5,20,935,106,207,1248
"./Ship3_Latin-square/2019-09-20_10h51m_Subject 47079.txt","47079",2019-09-20,"10:51",79,60,5,14,19,26,3,2,31,57,9,16,82,324,22,75,421
"./Ship3_Latin-square/2019-09-20_10h51m_Subject 47082.txt","47082",2019-09-20,"10:51",76,60,4,12,16,22,0,3,25,33,5,2,40,511,41,83,635
"./Ship3_Latin-square/2019-09-20_10h51m_Subject 47092.txt","47092",2019-09-20,"10:51",84,60,12,12,24,5,2,1,8,53,18,4,75,833,211,169,1213
"./Ship3_Latin-square/2019-09-20_10h51m_Subject 47098.txt","47098",2019-09-20,"10:51",81,60,11,10,21,51,2,14,67,15,5,22,42,127,1,28,156
"./Ship3_Latin-square/2019-09-20_10h51m_Subject 47226.txt","47226",2019-09-20,"10:51",76,60,4,12,16,13,3,1,17,91,6,15,112,2377,149,421,2947
"./Ship3_Latin-square/2019-09-20_10h51m_Subject 47227.txt","47227",2019-09-20,"10:51",77,60,7,10,17,19,2,1,22,24,8,2,34,690,99,138,927
"./Ship3_Latin-square/2019-09-20_10h51m_Subject 47250.txt","47250",2019-09-20,"10:51",79,60,11,8,19,25,2,4,31,16,5,6,27,602,48,102,752
"./Ship3_Latin-square/2019-09-20_10h51m_Subject 47645.txt","47645",2019-09-20,"10:51",47,34,11,2,13,90,17,6,113,20,6,0,26,180,28,2,210
"./Ship3_Latin-square/2019-09-20_10h51m_Subject 47646.txt","47646",2019-09-20,"10:51",85,60,4,21,25,9,1,5,15,82,6,38,126,1757,120,652,2529
"./Ship3_Latin-square/2019-09-20_10h51m_Subject 47755.txt","47755",2019-09-20,"10:51",77,60,7,10,17,30,3,4,37,38,11,4,53,767,102,107,976
"./Ship3_Latin-square/2019-09-20_10h51m_Subject 47760.txt","47760",2019-09-20,"10:51",79,60,9,10,19,35,5,4,44,33,6,7,46,1107,167,151,1425
"./Ship3_Latin-square/2019-09-20_10h51m_Subject 47770.txt","47770",2019-09-20,"10:51",43,31,10,2,12,70,17,4,91,32,45,4,81,91,8,9,108
"./Ship3_Latin-square/2019-09-20_10h51m_Subject 47795.txt","47795",2019-09-20,"10:51",83,60,2,21,23,40,0,7,47,24,0,5,29,490,9,111,610
"./Ship3_Latin-square/2019-09-20_12h01m_Subject 46880.txt","46880",2019-09-20,"12:01",81,60,7,14,21,6,0,1,7,15,0,6,21,1023,92,268,1383
"./Ship3_Latin-square/2019-09-20_12h01m_Subject 46882.txt","46882",2019-09-20,"12:01",85,60,14,11,25,35,6,64,105,55,63,23,141,393,50,57,500
"./Ship3_Latin-square/2019-09-20_12h01m_Subject 46883.txt","46883",2019-09-20,"12:01",83,60,10,13,23,19,4,3,26,197,51,6,254,560,93,118,771
"./Ship3_Latin-square/2019-09-20_12h01m_Subject 46894.txt","46894",2019-09-20,"12:01",82,60,10,12,22,42,4,15,61,20,4,11,35,427,58,117,602
"./Ship3_Latin-square/2019-09-20_12h01m_Subject 46896.txt","46896",2019-09-20,"12:01",76,60,6,10,16,21,0,2,23,41,5,4,50,882,87,169,1138
"./Ship3_Latin-square/2019-09-20_12h01m_Subject 47088.txt","47088",2019-09-20,"12:01",77,60,5,12,17,11,2,1,14,77,3,9,89,1040,81,230,1351
"./Ship3_Latin-square/2019-09-20_12h01m_Subject 47228.txt","47228",2019-09-20,"12:01",78,60,9,9,18,18,3,3,24,20,5,9,34,600,74,73,747
"./Ship3_Latin-square/2019-09-20_12h01m_Subject 47243.txt","47243",2019-09-20,"12:01",77,60,9,8,17,43,9,3,55,10,11,16,37,756,89,138,983
"./Ship3_Latin-square/2019-09-20_12h01m_Subject 47249.txt","47249",2019-09-20,"12:01",80,60,10,10,20,17,7,0,24,73,14,7,94,388,65,75,528
"./Ship3_Latin-square/2019-09-20_12h01m_Subject 47639.txt","47639",2019-09-20,"12:01",85,60,13,12,25,19,1,6,26,10,6,8,24,802,134,161,1097
"./Ship3_Latin-square/2019-09-20_12h01m_Subject 47649.txt","47649",2019-09-20,"12:01",84,60,10,14,24,26,10,4,40,12,4,13,29,615,88,157,860
"./Ship3_Latin-square/2019-09-20_12h01m_Subject 47753.txt","47753",2019-09-20,"12:01",85,60,12,13,25,51,13,11,75,38,46,28,112,530,71,173,774
"./Ship3_Latin-square/2019-09-20_12h01m_Subject 47758.txt","47758",2019-09-20,"12:01",81,60,9,12,21,6,0,0,6,60,0,8,68,808,115,181,1104
"./Ship3_Latin-square/2019-09-20_12h01m_Subject 47759.txt","47759",2019-09-20,"12:01",81,60,11,10,21,11,1,2,14,44,3,6,53,766,103,146,1015
"./Ship3_Latin-square/2019-09-20_12h01m_Subject 47776.txt","47776",2019-09-20,"12:01",81,60,8,13,21,8,0,2,10,52,17,9,78,1030,131,244,1405
"./Ship3_Latin-square/2019-09-20_12h01m_Subject 47799.txt","47799",2019-09-20,"12:01",80,60,11,9,20,16,3,2,21,56,18,21,95,585,75,138,798
"./Ship3_Latin-square/2019-09-20_12h04m_Subject 46881.txt","46881",2019-09-20,"12:04",75,60,6,9,15,30,2,4,36,18,2,5,25,423,26,144,593
"./Ship3_Latin-square/2019-09-20_12h04m_Subject 47087.txt","47087",2019-09-20,"12:04",83,60,12,11,23,38,2,9,49,76,83,8,167,205,42,62,309
"./Ship3_Latin-square/2019-09-20_12h04m_Subject 47626.txt","47626",2019-09-20,"12:04",81,60,7,14,21,17,2,5,24,15,2,7,24,344,43,76,463
"./Ship3_Latin-square/2019-09-20_12h04m_Subject 47632.txt","47632",2019-09-20,"12:04",82,60,12,10,22,24,3,2,29,36,13,5,54,1068,114,253,1435
"./Ship3_Latin-square/2019-09-20_12h04m_Subject 47634.txt","47634",2019-09-20,"12:04",86,60,11,15,26,66,8,14,88,22,5,17,44,253,40,107,400
"./Ship3_Latin-square/2019-09-20_12h04m_Subject 47640.txt","47640",2019-09-20,"12:04",81,60,12,9,21,56,10,1,67,26,8,6,40,311,23,109,443
"./Ship3_Latin-square/2019-09-20_12h04m_Subject 47754.txt","47754",2019-09-20,"12:04",65,46,7,12,19,36,4,11,51,27,5,19,51,199,47,81,327
"./Ship3_Latin-square/2019-09-20_12h04m_Subject 47800.txt","47800",2019-09-20,"12:04",81,60,9,12,21,55,5,11,71,74,21,12,107,505,76,71,652
"./Ship3_Latin-square/2019-09-20_13h28m_Subject 46888.txt","46888",2019-09-20,"13:28",82,60,8,14,22,14,0,2,16,60,19,9,88,982,123,212,1317
"./Ship3_Latin-square/2019-09-20_13h28m_Subject 46889.txt","46889",2019-09-20,"13:28",76,60,9,7,16,14,5,6,25,25,5,4,34,617,14,134,765
"./Ship3_Latin-square/2019-09-20_13h28m_Subject 46890.txt","46890",2019-09-20,"13:28",64,47,11,6,17,32,7,5,44,9,6,5,20,109,2,23,134
"./Ship3_Latin-square/2019-09-20_13h28m_Subject 46892.txt","46892",2019-09-20,"13:28",77,60,6,11,17,15,24,1,40,12,3,6,21,891,79,142,1112
"./Ship3_Latin-square/2019-09-20_13h28m_Subject 46898.txt","46898",2019-09-20,"13:28",76,60,7,9,16,27,2,5,34,29,2,16,47,717,98,103,918
"./Ship3_Latin-square/2019-09-20_13h28m_Subject 47097.txt","47097",2019-09-20,"13:28",81,60,13,8,21,31,5,6,42,59,20,22,101,624,90,124,838
"./Ship3_Latin-square/2019-09-20_13h28m_Subject 47099.txt","47099",2019-09-20,"13:28",80,60,9,11,20,5,2,3,10,27,1,30,58,1115,159,195,1469
"./Ship3_Latin-square/2019-09-20_13h28m_Subject 47798.txt","47798",2019-09-20,"13:28",81,60,6,15,21,30,0,9,39,7,6,2,15,205,19,51,275
"./Ship3_Latin-square/2019-09-20_13h30m_Subject 46876.txt","46876",2019-09-20,"13:30",81,60,10,11,21,21,2,3,26,5,0,3,8,745,69,169,983
"./Ship3_Latin-square/2019-09-20_13h30m_Subject 46877.txt","46877",2019-09-20,"13:30",84,60,13,11,24,35,5,10,50,115,83,48,246,602,26,181,809
"./Ship3_Latin-square/2019-09-20_13h30m_Subject 46893.txt","46893",2019-09-20,"13:30",76,60,6,10,16,8,1,2,11,31,4,3,38,1242,141,209,1592
"./Ship3_Latin-square/2019-09-20_13h30m_Subject 46895.txt","46895",2019-09-20,"13:30",84,60,9,15,24,19,9,7,35,12,21,19,52,286,45,97,428
"./Ship3_Latin-square/2019-09-20_13h30m_Subject 47638.txt","47638",2019-09-20,"13:30",82,60,11,11,22,45,10,12,67,36,7,11,54,338,66,76,480
"./Ship3_Latin-square/2019-09-20_13h30m_Subject 47757.txt","47757",2019-09-20,"13:30",79,60,10,9,19,68,12,10,90,36,10,9,55,327,41,53,421
"./Ship3_Latin-square/2019-09-20_13h30m_Subject 47769.txt","47769",2019-09-20,"13:30",84,60,13,11,24,37,3,17,57,31,13,21,65,490,73,92,655
"./Ship3_Latin-square/2019-09-20_13h30m_Subject 47771.txt","47771",2019-09-20,"13:30",83,60,11,12,23,19,0,3,22,15,3,2,20,816,139,141,1096
"./Ship3_Latin-square/2019-09-20_13h30m_Subject 47775.txt","47775",2019-09-20,"13:30",75,60,6,9,15,49,6,2,57,17,15,2,34,465,48,67,580
"./Ship3_Latin-square/2019-09-20_13h30m_Subject 47781.txt","47781",2019-09-20,"13:30",81,60,11,10,21,15,3,2,20,20,8,5,33,847,104,177,1128
"./Ship3_Latin-square/2019-09-20_13h30m_Subject 47782.txt","47782",2019-09-20,"13:30",85,60,12,13,25,13,7,2,22,10,3,2,15,716,148,183,1047
"./Ship3_Latin-square/2019-09-20_13h30m_Subject 47783.txt","47783",2019-09-20,"13:30",78,60,10,8,18,55,6,9,70,31,5,2,38,479,32,40,551
"./Ship3_Latin-square/2019-09-20_13h30m_Subject 47785.txt","47785",2019-09-20,"13:30",81,60,12,9,21,18,1,1,20,31,15,1,47,915,60,229,1204
"./Ship3_Latin-square/2019-09-20_13h30m_Subject 47786.txt","47786",2019-09-20,"13:30",60,45,10,5,15,59,14,8,81,25,9,4,38,101,8,11,120
"./Ship3_Latin-square/2019-09-20_13h30m_Subject 47788.txt","47788",2019-09-20,"13:30",79,60,8,11,19,17,3,4,24,61,15,17,93,690,98,127,915
"./Ship3_Latin-square/2019-09-20_14h41m_Subject 47080.txt","47080",2019-09-20,"14:41",78,60,5,13,18,13,0,6,19,36,10,6,52,1251,90,323,1664
"./Ship3_Latin-square/2019-09-20_14h41m_Subject 47089.txt","47089",2019-09-20,"14:41",75,60,10,5,15,51,5,6,62,61,16,5,82,270,18,26,314
"./Ship3_Latin-square/2019-09-20_14h41m_Subject 47762.txt","47762",2019-09-20,"14:41",80,60,9,11,20,56,6,1,63,37,21,17,75,198,35,57,290
"./Ship3_Latin-square/2019-09-20_14h41m_Subject 47791.txt","47791",2019-09-20,"14:41",81,60,11,10,21,31,1,6,38,47,16,24,87,267,16,55,338
"./Ship3_Latin-square/2019-09-21_09h36m_Subject 46884.txt","46884",2019-09-21,"09:36",79,60,8,11,19,22,5,6,33,14,3,4,21,357,64,61,482
"./Ship3_Latin-square/2019-09-21_09h36m_Subject 47083.txt","47083",2019-09-21,"09:36",70,55,8,7,15,93,9,9,111,52,9,12,73,151,2,53,206
"./Ship3_Latin-square/2019-09-21_09h36m_Subject 47086.txt","47086",2019-09-21,"09:36",80,60,10,10,20,29,3,3,35,24,3,11,38,365,38,85,488
"./Ship3_Latin-square/2019-09-21_09h36m_Subject 47246.txt","47246",2019-09-21,"09:36",83,60,4,19,23,24,1,3,28,9,2,15,26,455,38,99,592
"./Ship3_Latin-square/2019-09-21_09h36m_Subject 47635.txt","47635",2019-09-21,"09:36",81,60,9,12,21,24,6,3,33,53,13,11,77,672,108,112,892
"./Ship3_Latin-square/2019-09-21_09h36m_Subject 47779.txt","47779",2019-09-21,"09:36",79,60,7,12,19,7,3,0,10,96,18,16,130,206,16,57,279
"./Ship3_Latin-square/2019-09-21_09h36m_Subject 47790.txt","47790",2019-09-21,"09:36",84,60,12,12,24,7,0,0,7,17,0,7,24,615,92,201,908
"./Ship3_Latin-square/2019-09-21_09h36m_Subject 47797.txt","47797",2019-09-21,"09:36",35,25,6,4,10,31,10,4,45,26,19,4,49,95,21,9,125
"./Ship3_Latin-square/2019-09-21_09h39m_Subject 46878.txt","46878",2019-09-21,"09:39",75,60,5,10,15,23,2,4,29,15,7,10,32,905,79,146,1130
"./Ship3_Latin-square/2019-09-21_09h39m_Subject 46885.txt","46885",2019-09-21,"09:39",47,33,10,4,14,96,12,12,120,11,3,2,16,106,7,15,128
"./Ship3_Latin-square/2019-09-21_09h39m_Subject 46899.txt","46899",2019-09-21,"09:39",76,60,8,8,16,54,4,11,69,24,5,8,37,738,117,107,962
"./Ship3_Latin-square/2019-09-21_09h39m_Subject 47081.txt","47081",2019-09-21,"09:39",74,60,6,8,14,25,4,3,32,7,3,3,13,516,21,91,628
"./Ship3_Latin-square/2019-09-21_09h39m_Subject 47091.txt","47091",2019-09-21,"09:39",81,60,7,14,21,24,4,3,31,59,6,15,80,293,34,77,404
"./Ship3_Latin-square/2019-09-21_09h39m_Subject 47095.txt","47095",2019-09-21,"09:39",80,60,11,9,20,56,7,3,66,25,8,17,50,375,66,80,521
"./Ship3_Latin-square/2019-09-21_09h39m_Subject 47231.txt","47231",2019-09-21,"09:39",85,60,5,20,25,60,2,23,85,26,9,4,39,338,17,68,423
"./Ship3_Latin-square/2019-09-21_09h39m_Subject 47238.txt","47238",2019-09-21,"09:39",81,60,10,11,21,22,0,4,26,53,16,15,84,409,56,108,573
"./Ship3_Latin-square/2019-09-21_09h39m_Subject 47242.txt","47242",2019-09-21,"09:39",78,60,12,6,18,79,6,5,90,92,11,44,147,495,69,86,650
"./Ship3_Latin-square/2019-09-21_09h39m_Subject 47244.txt","47244",2019-09-21,"09:39",77,58,10,9,19,86,1,22,109,99,43,13,155,314,9,69,392
"./Ship3_Latin-square/2019-09-21_09h39m_Subject 47633.txt","47633",2019-09-21,"09:39",79,60,6,13,19,41,2,0,43,70,21,11,102,630,87,113,830
"./Ship3_Latin-square/2019-09-21_09h39m_Subject 47636.txt","47636",2019-09-21,"09:39",61,44,9,8,17,120,8,28,156,54,10,8,72,165,13,51,229
"./Ship3_Latin-square/2019-09-21_09h39m_Subject 47752.txt","47752",2019-09-21,"09:39",81,60,7,14,21,39,2,6,47,31,9,8,48,757,78,167,1002
"./Ship3_Latin-square/2019-09-21_09h39m_Subject 47767.txt","47767",2019-09-21,"09:39",82,60,11,11,22,75,4,18,97,74,10,13,97,228,24,67,319
"./Ship3_Latin-square/2019-09-21_09h39m_Subject 47768.txt","47768",2019-09-21,"09:39",79,55,14,10,24,66,8,11,85,29,8,17,54,254,15,76,345
"./Ship3_Latin-square/2019-09-21_09h39m_Subject 47780.txt","47780",2019-09-21,"09:39",82,57,9,16,25,73,14,12,99,54,16,42,112,295,47,103,445
"./Ship3_Latin-square/2019-09-21_10h47m_Subject 47229.txt","47229",2019-09-21,"10:47",80,60,7,13,20,14,1,1,16,42,5,5,52,964,145,235,1344
"./Ship3_Latin-square/2019-09-21_10h47m_Subject 47233.txt","47233",2019-09-21,"10:47",77,60,5,12,17,21,0,4,25,22,2,7,31,461,51,113,625
"./Ship3_Latin-square/2019-09-21_10h47m_Subject 47234.txt","47234",2019-09-21,"10:47",84,60,12,12,24,44,9,7,60,49,39,25,113,413,72,114,599
"./Ship3_Latin-square/2019-09-21_10h47m_Subject 47237.txt","47237",2019-09-21,"10:47",75,60,7,8,15,15,2,1,18,13,4,13,30,778,104,128,1010
"./Ship3_Latin-square/2019-09-21_10h47m_Subject 47241.txt","47241",2019-09-21,"10:47",81,60,9,12,21,10,0,3,13,6,5,1,12,1046,167,227,1440
"./Ship3_Latin-square/2019-09-21_10h47m_Subject 47247.txt","47247",2019-09-21,"10:47",70,60,5,5,10,56,3,13,72,32,4,7,43,200,0,28,228
"./Ship3_Latin-square/2019-09-21_10h47m_Subject 47777.txt","47777",2019-09-21,"10:47",79,60,8,11,19,36,8,15,59,46,13,6,65,381,27,88,496
"./Ship3_Latin-square/2019-09-21_10h47m_Subject 47784.txt","47784",2019-09-21,"10:47",78,60,11,7,18,156,11,36,203,71,9,9,89,562,1,74,637
"./Ship3_Latin-square/2019-09-21_10h49m_Subject 46900.txt","46900",2019-09-21,"10:49",78,60,7,11,18,9,3,0,12,61,7,16,84,1016,138,151,1305
"./Ship3_Latin-square/2019-09-21_10h49m_Subject 46986.txt","46986",2019-09-21,"10:49",67,49,12,6,18,51,29,9,89,34,12,15,61,310,57,43,410
"./Ship3_Latin-square/2019-09-21_10h49m_Subject 47076.txt","47076",2019-09-21,"10:49",85,60,14,11,25,18,1,5,24,71,8,33,112,456,47,127,630
"./Ship3_Latin-square/2019-09-21_10h49m_Subject 47079.txt","47079",2019-09-21,"10:49",79,60,14,5,19,53,9,8,70,61,20,6,87,240,5,18,263
"./Ship3_Latin-square/2019-09-21_10h49m_Subject 47082.txt","47082",2019-09-21,"10:49",76,60,8,8,16,58,3,4,65,42,5,11,58,384,39,63,486
"./Ship3_Latin-square/2019-09-21_10h49m_Subject 47092.txt","47092",2019-09-21,"10:49",83,60,12,11,23,113,3,45,161,67,9,12,88,353,0,98,451
"./Ship3_Latin-square/2019-09-21_10h49m_Subject 47098.txt","47098",2019-09-21,"10:49",77,60,7,10,17,20,2,3,25,17,5,8,30,514,48,118,680
"./Ship3_Latin-square/2019-09-21_10h49m_Subject 47226.txt","47226",2019-09-21,"10:49",82,60,11,11,22,27,9,3,39,86,29,23,138,1392,66,507,1965
"./Ship3_Latin-square/2019-09-21_10h49m_Subject 47227.txt","47227",2019-09-21,"10:49",79,60,10,9,19,35,4,4,43,48,5,4,57,347,40,43,430
"./Ship3_Latin-square/2019-09-21_10h49m_Subject 47250.txt","47250",2019-09-21,"10:49",81,60,9,12,21,18,3,3,24,10,6,12,28,855,120,202,1177
"./Ship3_Latin-square/2019-09-21_10h49m_Subject 47645.txt","47645",2019-09-21,"10:49",71,51,10,10,20,112,28,23,163,27,10,8,45,270,37,53,360
"./Ship3_Latin-square/2019-09-21_10h49m_Subject 47646.txt","47646",2019-09-21,"10:49",85,60,15,10,25,74,7,15,96,64,17,54,135,305,24,116,445
"./Ship3_Latin-square/2019-09-21_10h49m_Subject 47755.txt","47755",2019-09-21,"10:49",83,60,10,13,23,34,2,8,44,35,5,10,50,708,140,119,967
"./Ship3_Latin-square/2019-09-21_10h49m_Subject 47760.txt","47760",2019-09-21,"10:49",81,60,12,9,21,65,9,13,87,56,14,10,80,432,11,104,547
"./Ship3_Latin-square/2019-09-21_10h49m_Subject 47770.txt","47770",2019-09-21,"10:49",38,26,10,2,12,103,59,0,162,39,37,4,80,133,47,6,186
"./Ship3_Latin-square/2019-09-21_10h49m_Subject 47795.txt","47795",2019-09-21,"10:49",67,52,12,3,15,106,24,4,134,36,16,6,58,186,17,16,219
"./Ship3_Latin-square/2019-09-21_11h56m_Subject 46881.txt","46881",2019-09-21,"11:56",74,60,4,10,14,30,1,1,32,21,1,3,25,880,52,163,1095
"./Ship3_Latin-square/2019-09-21_11h56m_Subject 47087.txt","47087",2019-09-21,"11:56",80,60,9,11,20,18,1,2,21,68,12,6,86,417,57,78,552
"./Ship3_Latin-square/2019-09-21_11h56m_Subject 47626.txt","47626",2019-09-21,"11:56",64,47,9,8,17,42,4,8,54,45,7,5,57,151,25,28,204
"./Ship3_Latin-square/2019-09-21_11h56m_Subject 47632.txt","47632",2019-09-21,"11:56",83,60,15,8,23,70,11,5,86,87,51,13,151,513,3,151,667
"./Ship3_Latin-square/2019-09-21_11h56m_Subject 47634.txt","47634",2019-09-21,"11:56",81,60,10,11,21,53,3,10,66,26,9,3,38,249,57,60,366
"./Ship3_Latin-square/2019-09-21_11h56m_Subject 47640.txt","47640",2019-09-21,"11:56",74,55,11,8,19,61,5,9,75,28,4,18,50,464,95,100,659
"./Ship3_Latin-square/2019-09-21_11h56m_Subject 47754.txt","47754",2019-09-21,"11:56",52,39,5,8,13,35,2,4,41,19,1,28,48,145,20,40,205
"./Ship3_Latin-square/2019-09-21_11h56m_Subject 47800.txt","47800",2019-09-21,"11:56",82,60,10,12,22,63,8,16,87,53,13,18,84,349,54,68,471
"./Ship3_Latin-square/2019-09-21_11h59m_Subject 46880.txt","46880",2019-09-21,"11:59",81,60,11,10,21,18,0,5,23,20,9,8,37,452,44,94,590
"./Ship3_Latin-square/2019-09-21_11h59m_Subject 46882.txt","46882",2019-09-21,"11:59",79,60,10,9,19,30,2,1,33,50,10,16,76,604,72,121,797
"./Ship3_Latin-square/2019-09-21_11h59m_Subject 46883.txt","46883",2019-09-21,"11:59",80,60,6,14,20,15,0,3,18,38,14,53,105,453,54,126,633
"./Ship3_Latin-square/2019-09-21_11h59m_Subject 46894.txt","46894",2019-09-21,"11:59",78,60,6,12,18,46,2,16,64,23,2,7,32,505,79,78,662
"./Ship3_Latin-square/2019-09-21_11h59m_Subject 46896.txt","46896",2019-09-21,"11:59",82,60,4,18,22,16,0,7,23,27,6,9,42,956,46,319,1321
"./Ship3_Latin-square/2019-09-21_11h59m_Subject 47088.txt","47088",2019-09-21,"11:59",86,60,12,14,26,39,4,9,52,64,23,9,96,606,73,231,910
"./Ship3_Latin-square/2019-09-21_11h59m_Subject 47228.txt","47228",2019-09-21,"11:59",68,46,0,22,22,30,0,15,45,23,0,92,115,217,0,211,428
"./Ship3_Latin-square/2019-09-21_11h59m_Subject 47243.txt","47243",2019-09-21,"11:59",79,60,9,10,19,54,5,3,62,19,11,1,31,864,130,156,1150
"./Ship3_Latin-square/2019-09-21_11h59m_Subject 47249.txt","47249",2019-09-21,"11:59",82,60,10,12,22,67,3,13,83,88,31,30,149,309,35,88,432
"./Ship3_Latin-square/2019-09-21_11h59m_Subject 47639.txt","47639",2019-09-21,"11:59",80,60,8,12,20,28,5,1,34,12,7,7,26,675,113,130,918
"./Ship3_Latin-square/2019-09-21_11h59m_Subject 47649.txt","47649",2019-09-21,"11:59",75,54,11,10,21,70,6,20,96,14,1,10,25,236,6,56,298
"./Ship3_Latin-square/2019-09-21_11h59m_Subject 47753.txt","47753",2019-09-21,"11:59",81,60,8,13,21,27,3,7,37,36,28,35,99,689,92,181,962
"./Ship3_Latin-square/2019-09-21_11h59m_Subject 47758.txt","47758",2019-09-21,"11:59",80,60,12,8,20,15,1,0,16,11,1,3,15,576,50,105,731
"./Ship3_Latin-square/2019-09-21_11h59m_Subject 47759.txt","47759",2019-09-21,"11:59",81,60,9,12,21,40,1,13,54,57,5,32,94,372,28,109,509
"./Ship3_Latin-square/2019-09-21_11h59m_Subject 47776.txt","47776",2019-09-21,"11:59",84,60,11,13,24,11,4,4,19,51,20,11,82,1193,179,301,1673
"./Ship3_Latin-square/2019-09-21_11h59m_Subject 47799.txt","47799",2019-09-21,"11:59",81,60,11,10,21,31,2,4,37,78,26,16,120,229,19,57,305
"./Ship3_Latin-square/2019-09-21_13h05m_Subject 46888.txt","46888",2019-09-21,"13:05",75,60,6,9,15,16,3,4,23,49,6,13,68,864,76,97,1037
"./Ship3_Latin-square/2019-09-21_13h05m_Subject 46889.txt","46889",2019-09-21,"13:05",75,60,5,10,15,6,0,1,7,20,5,5,30,1246,117,197,1560
"./Ship3_Latin-square/2019-09-21_13h05m_Subject 46890.txt","46890",2019-09-21,"13:05",81,60,9,12,21,18,2,2,22,12,3,6,21,275,57,59,391
"./Ship3_Latin-square/2019-09-21_13h05m_Subject 46892.txt","46892",2019-09-21,"13:05",80,60,10,10,20,16,2,2,20,18,2,3,23,691,78,140,909
"./Ship3_Latin-square/2019-09-21_13h05m_Subject 46898.txt","46898",2019-09-21,"13:05",79,60,12,7,19,47,4,4,55,16,3,8,27,376,20,83,479
"./Ship3_Latin-square/2019-09-21_13h05m_Subject 47097.txt","47097",2019-09-21,"13:05",81,60,10,11,21,108,3,1,112,66,15,13,94,940,193,196,1329
"./Ship3_Latin-square/2019-09-21_13h05m_Subject 47099.txt","47099",2019-09-21,"13:05",73,60,9,4,13,9,2,2,13,36,12,0,48,747,53,63,863
"./Ship3_Latin-square/2019-09-21_13h05m_Subject 47798.txt","47798",2019-09-21,"13:05",80,60,5,15,20,26,0,4,30,6,6,2,14,237,18,58,313
"./Ship3_Latin-square/2019-09-21_13h08m_Subject 46876.txt","46876",2019-09-21,"13:08",53,41,9,3,12,48,9,7,64,18,6,5,29,230,20,17,267
"./Ship3_Latin-square/2019-09-21_13h08m_Subject 46877.txt","46877",2019-09-21,"13:08",83,60,11,12,23,69,20,5,94,69,27,252,348,1229,184,278,1691
"./Ship3_Latin-square/2019-09-21_13h08m_Subject 46893.txt","46893",2019-09-21,"13:08",83,60,19,4,23,56,19,4,79,33,25,2,60,598,193,33,824
"./Ship3_Latin-square/2019-09-21_13h08m_Subject 46895.txt","46895",2019-09-21,"13:08",60,44,11,5,16,50,11,10,71,76,11,10,97,95,5,16,116
"./Ship3_Latin-square/2019-09-21_13h08m_Subject 47638.txt","47638",2019-09-21,"13:08",71,54,9,8,17,54,9,8,71,43,22,5,70,241,48,30,319
"./Ship3_Latin-square/2019-09-21_13h08m_Subject 47757.txt","47757",2019-09-21,"13:08",64,47,12,5,17,89,26,19,134,43,11,4,58,198,49,29,276
"./Ship3_Latin-square/2019-09-21_13h08m_Subject 47769.txt","47769",2019-09-21,"13:08",83,60,11,12,23,62,6,8,76,46,15,15,76,520,69,153,742
"./Ship3_Latin-square/2019-09-21_13h08m_Subject 47771.txt","47771",2019-09-21,"13:08",85,60,10,15,25,28,0,6,34,8,3,23,34,673,65,199,937
"./Ship3_Latin-square/2019-09-21_13h08m_Subject 47775.txt","47775",2019-09-21,"13:08",81,60,9,12,21,75,11,13,99,27,5,17,49,371,51,82,504
"./Ship3_Latin-square/2019-09-21_13h08m_Subject 47781.txt","47781",2019-09-21,"13:08",77,60,8,9,17,17,3,1,21,39,14,10,63,1109,168,182,1459
"./Ship3_Latin-square/2019-09-21_13h08m_Subject 47782.txt","47782",2019-09-21,"13:08",76,60,9,7,16,37,4,4,45,19,8,10,37,474,41,96,611
"./Ship3_Latin-square/2019-09-21_13h08m_Subject 47783.txt","47783",2019-09-21,"13:08",78,60,6,12,18,46,7,14,67,54,4,5,63,612,76,170,858
"./Ship3_Latin-square/2019-09-21_13h08m_Subject 47785.txt","47785",2019-09-21,"13:08",83,60,10,13,23,13,0,2,15,46,16,15,77,1432,262,235,1929
"./Ship3_Latin-square/2019-09-21_13h08m_Subject 47786.txt","47786",2019-09-21,"13:08",53,41,6,6,12,56,3,7,66,69,57,39,165,133,15,23,171
"./Ship3_Latin-square/2019-09-21_13h08m_Subject 47788.txt","47788",2019-09-21,"13:08",78,60,8,10,18,61,6,8,75,68,11,9,88,338,34,107,479
"./Ship3_Latin-square/2019-09-21_14h14m_Subject 47080.txt","47080",2019-09-21,"14:14",74,60,4,10,14,11,0,1,12,31,2,6,39,1015,32,172,1219
"./Ship3_Latin-square/2019-09-21_14h14m_Subject 47089.txt","47089",2019-09-21,"14:14",78,60,8,10,18,25,5,1,31,126,8,16,150,380,49,73,502
"./Ship3_Latin-square/2019-09-21_14h14m_Subject 47762.txt","47762",2019-09-21,"14:14",80,60,8,12,20,56,2,7,65,27,5,7,39,230,33,41,304
"./Ship3_Latin-square/2019-09-21_14h14m_Subject 47791.txt","47791",2019-09-21,"14:14",80,60,8,12,20,11,3,1,15,22,7,2,31,753,106,164,1023
"./Ship3_Latin-square/2019-09-22_09h53m_Subject 46878.txt","46878",2019-09-22,"09:53",78,60,6,12,18,27,1,6,34,27,3,17,47,964,97,200,1261
"./Ship3_Latin-square/2019-09-22_09h53m_Subject 46885.txt","46885",2019-09-22,"09:53",83,60,7,16,23,59,5,4,68,8,1,5,14,370,60,112,542
"./Ship3_Latin-square/2019-09-22_09h53m_Subject 46899.txt","46899",2019-09-22,"09:53",77,60,13,4,17,137,19,25,181,36,11,3,50,288,1,26,315
"./Ship3_Latin-square/2019-09-22_09h53m_Subject 47081.txt","47081",2019-09-22,"09:53",84,60,7,17,24,18,19,5,42,33,5,61,99,626,79,170,875
"./Ship3_Latin-square/2019-09-22_09h53m_Subject 47091.txt","47091",2019-09-22,"09:53",85,60,13,12,25,43,10,11,64,76,20,49,145,185,18,51,254
"./Ship3_Latin-square/2019-09-22_09h53m_Subject 47095.txt","47095",2019-09-22,"09:53",76,60,5,11,16,24,1,2,27,43,9,10,62,564,46,66,676
"./Ship3_Latin-square/2019-09-22_09h53m_Subject 47231.txt","47231",2019-09-22,"09:53",65,47,11,7,18,59,14,11,84,53,23,34,110,130,14,19,163
"./Ship3_Latin-square/2019-09-22_09h53m_Subject 47238.txt","47238",2019-09-22,"09:53",80,60,11,9,20,18,1,4,23,61,19,23,103,459,100,85,644
"./Ship3_Latin-square/2019-09-22_09h53m_Subject 47242.txt","47242",2019-09-22,"09:53",82,60,5,17,22,42,3,9,54,69,0,177,246,716,76,245,1037
"./Ship3_Latin-square/2019-09-22_09h53m_Subject 47244.txt","47244",2019-09-22,"09:53",85,60,8,17,25,69,4,9,82,93,60,30,183,717,96,246,1059
"./Ship3_Latin-square/2019-09-22_09h53m_Subject 47633.txt","47633",2019-09-22,"09:53",83,60,9,14,23,61,3,11,75,64,16,24,104,398,80,90,568
"./Ship3_Latin-square/2019-09-22_09h53m_Subject 47636.txt","47636",2019-09-22,"09:53",81,60,10,11,21,114,13,11,138,142,28,54,224,399,88,71,558
"./Ship3_Latin-square/2019-09-22_09h53m_Subject 47752.txt","47752",2019-09-22,"09:53",84,59,13,12,25,111,20,16,147,54,28,42,124,182,13,58,253
"./Ship3_Latin-square/2019-09-22_09h53m_Subject 47767.txt","47767",2019-09-22,"09:53",85,60,12,13,25,28,1,13,42,23,18,13,54,339,69,72,480
"./Ship3_Latin-square/2019-09-22_09h53m_Subject 47768.txt","47768",2019-09-22,"09:53",84,60,9,15,24,48,6,4,58,29,11,2,42,520,70,121,711
"./Ship3_Latin-square/2019-09-22_09h53m_Subject 47780.txt","47780",2019-09-22,"09:53",79,60,11,8,19,75,8,13,96,50,16,10,76,243,3,50,296
"./Ship3_Latin-square/2019-09-22_10h59m_Subject 46900.txt","46900",2019-09-22,"10:59",80,60,11,9,20,22,1,2,25,28,24,7,59,478,43,76,597
"./Ship3_Latin-square/2019-09-22_10h59m_Subject 46986.txt","46986",2019-09-22,"10:59",67,51,9,7,16,56,10,7,73,52,6,3,61,165,19,25,209
"./Ship3_Latin-square/2019-09-22_10h59m_Subject 47076.txt","47076",2019-09-22,"10:59",81,60,10,11,21,15,1,0,16,21,8,21,50,977,171,202,1350
"./Ship3_Latin-square/2019-09-22_10h59m_Subject 47079.txt","47079",2019-09-22,"10:59",78,60,7,11,18,25,1,6,32,60,6,21,87,425,42,79,546
"./Ship3_Latin-square/2019-09-22_10h59m_Subject 47082.txt","47082",2019-09-22,"10:59",79,60,8,11,19,33,5,0,38,13,0,0,13,491,78,93,662
"./Ship3_Latin-square/2019-09-22_10h59m_Subject 47092.txt","47092",2019-09-22,"10:59",82,60,9,13,22,12,1,2,15,24,6,5,35,901,137,252,1290
"./Ship3_Latin-square/2019-09-22_10h59m_Subject 47098.txt","47098",2019-09-22,"10:59",80,60,10,10,20,15,2,0,17,4,6,71,81,332,55,73,460
"./Ship3_Latin-square/2019-09-22_10h59m_Subject 47226.txt","47226",2019-09-22,"10:59",76,60,7,9,16,10,3,2,15,75,64,15,154,2882,369,316,3567
"./Ship3_Latin-square/2019-09-22_10h59m_Subject 47227.txt","47227",2019-09-22,"10:59",81,60,6,15,21,44,1,11,56,32,9,32,73,493,61,114,668
"./Ship3_Latin-square/2019-09-22_10h59m_Subject 47250.txt","47250",2019-09-22,"10:59",75,60,7,8,15,16,0,3,19,7,5,6,18,731,71,102,904
"./Ship3_Latin-square/2019-09-22_10h59m_Subject 47645.txt","47645",2019-09-22,"10:59",66,48,11,7,18,96,22,11,129,26,8,5,39,215,35,36,286
"./Ship3_Latin-square/2019-09-22_10h59m_Subject 47646.txt","47646",2019-09-22,"10:59",82,60,5,17,22,19,2,3,24,103,8,23,134,1866,193,520,2579
"./Ship3_Latin-square/2019-09-22_10h59m_Subject 47755.txt","47755",2019-09-22,"10:59",83,60,12,11,23,100,5,21,126,25,30,10,65,283,12,96,391
"./Ship3_Latin-square/2019-09-22_10h59m_Subject 47760.txt","47760",2019-09-22,"10:59",81,60,11,10,21,40,10,11,61,24,13,5,42,918,175,141,1234
"./Ship3_Latin-square/2019-09-22_10h59m_Subject 47770.txt","47770",2019-09-22,"10:59",44,31,6,7,13,72,34,15,121,58,27,10,95,138,25,16,179
"./Ship3_Latin-square/2019-09-22_10h59m_Subject 47795.txt","47795",2019-09-22,"10:59",82,60,4,18,22,41,5,5,51,27,12,8,47,409,18,109,536
"./Ship3_Latin-square/2019-09-22_12h06m_Subject 46880.txt","46880",2019-09-22,"12:06",82,60,7,15,22,6,0,3,9,11,6,7,24,745,78,206,1029
"./Ship3_Latin-square/2019-09-22_12h06m_Subject 46882.txt","46882",2019-09-22,"12:06",79,60,10,9,19,23,2,4,29,54,5,16,75,624,66,110,800
"./Ship3_Latin-square/2019-09-22_12h06m_Subject 46883.txt","46883",2019-09-22,"12:06",73,56,11,6,17,101,14,16,131,89,23,7,119,164,3,22,189
"./Ship3_Latin-square/2019-09-22_12h06m_Subject 46894.txt","46894",2019-09-22,"12:06",84,60,11,13,24,67,8,24,99,21,8,9,38,258,35,131,424
"./Ship3_Latin-square/2019-09-22_12h06m_Subject 46896.txt","46896",2019-09-22,"12:06",79,60,9,10,19,12,2,4,18,31,9,8,48,740,97,193,1030
"./Ship3_Latin-square/2019-09-22_12h06m_Subject 47088.txt","47088",2019-09-22,"12:06",84,60,11,13,24,67,6,9,82,63,13,16,92,391,4,163,558
"./Ship3_Latin-square/2019-09-22_12h06m_Subject 47228.txt","47228",2019-09-22,"12:06",85,60,11,14,25,45,2,10,57,19,1,11,31,362,86,129,577
"./Ship3_Latin-square/2019-09-22_12h06m_Subject 47243.txt","47243",2019-09-22,"12:06",83,60,11,12,23,52,5,8,65,25,8,4,37,542,66,137,745
"./Ship3_Latin-square/2019-09-22_12h06m_Subject 47249.txt","47249",2019-09-22,"12:06",87,60,16,11,27,84,14,16,114,86,86,15,187,269,19,83,371
"./Ship3_Latin-square/2019-09-22_12h06m_Subject 47639.txt","47639",2019-09-22,"12:06",79,58,15,6,21,62,8,6,76,45,49,3,97,361,52,40,453
"./Ship3_Latin-square/2019-09-22_12h06m_Subject 47649.txt","47649",2019-09-22,"12:06",78,60,3,15,18,49,1,7,57,5,3,3,11,527,23,136,686
"./Ship3_Latin-square/2019-09-22_12h06m_Subject 47753.txt","47753",2019-09-22,"12:06",83,60,15,8,23,27,7,4,38,26,99,6,131,515,53,97,665
"./Ship3_Latin-square/2019-09-22_12h06m_Subject 47758.txt","47758",2019-09-22,"12:06",76,60,10,6,16,69,1,10,80,19,2,6,27,384,0,84,468
"./Ship3_Latin-square/2019-09-22_12h06m_Subject 47759.txt","47759",2019-09-22,"12:06",81,60,12,9,21,89,4,21,114,68,13,8,89,228,6,73,307
"./Ship3_Latin-square/2019-09-22_12h06m_Subject 47776.txt","47776",2019-09-22,"12:06",82,60,8,14,22,13,1,5,19,61,13,10,84,860,77,321,1258
"./Ship3_Latin-square/2019-09-22_12h06m_Subject 47799.txt","47799",2019-09-22,"12:06",80,57,12,11,23,71,3,24,98,73,20,8,101,162,4,45,211
"./Ship3_Latin-square/2019-09-22_13h12m_Subject 46876.txt","46876",2019-09-22,"13:12",85,60,12,13,25,22,6,4,32,28,10,8,46,611,134,125,870
"./Ship3_Latin-square/2019-09-22_13h12m_Subject 46877.txt","46877",2019-09-22,"13:12",80,60,11,9,20,7,1,1,9,35,64,12,111,1350,312,197,1859
"./Ship3_Latin-square/2019-09-22_13h12m_Subject 46893.txt","46893",2019-09-22,"13:12",79,60,8,11,19,22,0,5,27,63,25,7,95,932,72,249,1253
"./Ship3_Latin-square/2019-09-22_13h12m_Subject 46895.txt","46895",2019-09-22,"13:12",78,55,9,14,23,29,5,3,37,21,5,12,38,175,38,63,276
"./Ship3_Latin-square/2019-09-22_13h12m_Subject 47638.txt","47638",2019-09-22,"13:12",81,60,13,8,21,73,14,14,101,48,8,7,63,314,38,50,402
"./Ship3_Latin-square/2019-09-22_13h12m_Subject 47757.txt","47757",2019-09-22,"13:12",71,50,17,4,21,147,37,21,205,39,31,3,73,193,20,23,236
"./Ship3_Latin-square/2019-09-22_13h12m_Subject 47769.txt","47769",2019-09-22,"13:12",81,60,13,8,21,79,10,15,104,54,19,4,77,397,49,53,499
"./Ship3_Latin-square/2019-09-22_13h12m_Subject 47771.txt","47771",2019-09-22,"13:12",78,60,8,10,18,26,0,4,30,10,2,18,30,816,97,126,1039
"./Ship3_Latin-square/2019-09-22_13h12m_Subject 47775.txt","47775",2019-09-22,"13:12",78,60,9,9,18,63,8,8,79,8,4,3,15,368,56,62,486
"./Ship3_Latin-square/2019-09-22_13h12m_Subject 47781.txt","47781",2019-09-22,"13:12",79,60,9,10,19,13,2,2,17,21,4,17,42,942,128,205,1275
"./Ship3_Latin-square/2019-09-22_13h12m_Subject 47782.txt","47782",2019-09-22,"13:12",85,60,14,11,25,62,6,15,83,35,13,25,73,311,4,100,415
"./Ship3_Latin-square/2019-09-22_13h12m_Subject 47783.txt","47783",2019-09-22,"13:12",79,60,11,8,19,23,7,7,37,38,5,8,51,698,71,113,882
"./Ship3_Latin-square/2019-09-22_13h12m_Subject 47785.txt","47785",2019-09-22,"13:12",81,60,10,11,21,16,2,3,21,45,18,5,68,1119,221,190,1530
"./Ship3_Latin-square/2019-09-22_13h12m_Subject 47786.txt","47786",2019-09-22,"13:12",46,33,9,4,13,48,12,9,69,28,6,18,52,87,3,6,96
"./Ship3_Latin-square/2019-09-22_13h12m_Subject 47788.txt","47788",2019-09-22,"13:12",78,60,10,8,18,59,10,13,82,86,40,8,134,325,7,82,414
"./Ship3_Latin-square/2019-09-23_09h55m_Subject 46878.txt","46878",2019-09-23,"09:55",85,60,13,12,25,68,2,19,89,28,13,6,47,406,8,128,542
"./Ship3_Latin-square/2019-09-23_09h55m_Subject 46885.txt","46885",2019-09-23,"09:55",69,50,12,7,19,77,13,13,103,4,1,0,5,183,26,24,233
"./Ship3_Latin-square/2019-09-23_09h55m_Subject 46899.txt","46899",2019-09-23,"09:55",80,60,8,12,20,34,3,5,42,6,5,11,22,876,80,210,1166
"./Ship3_Latin-square/2019-09-23_09h55m_Subject 47081.txt","47081",2019-09-23,"09:55",84,60,11,13,24,21,4,5,30,30,7,22,59,381,9,153,543
"./Ship3_Latin-square/2019-09-23_09h55m_Subject 47091.txt","47091",2019-09-23,"09:55",82,60,8,14,22,18,1,3,22,69,8,14,91,303,39,83,425
"./Ship3_Latin-square/2019-09-23_09h55m_Subject 47095.txt","47095",2019-09-23,"09:55",80,60,8,12,20,43,10,15,68,25,16,40,81,327,32,75,434
"./Ship3_Latin-square/2019-09-23_09h55m_Subject 47231.txt","47231",2019-09-23,"09:55",77,53,1,23,24,56,3,23,82,27,0,17,44,150,5,63,218
"./Ship3_Latin-square/2019-09-23_09h55m_Subject 47238.txt","47238",2019-09-23,"09:55",81,60,12,9,21,17,4,3,24,43,16,13,72,484,83,73,640
"./Ship3_Latin-square/2019-09-23_09h55m_Subject 47242.txt","47242",2019-09-23,"09:55",82,60,13,9,22,25,1,0,26,130,74,6,210,619,125,102,846
"./Ship3_Latin-square/2019-09-23_09h55m_Subject 47244.txt","47244",2019-09-23,"09:55",77,60,9,8,17,20,2,4,26,92,12,10,114,568,71,116,755
"./Ship3_Latin-square/2019-09-23_09h55m_Subject 47633.txt","47633",2019-09-23,"09:55",80,60,13,7,20,67,19,9,95,75,19,15,109,289,13,35,337
"./Ship3_Latin-square/2019-09-23_09h55m_Subject 47636.txt","47636",2019-09-23,"09:55",81,60,8,13,21,54,7,5,66,92,9,13,114,469,70,116,655
"./Ship3_Latin-square/2019-09-23_09h55m_Subject 47752.txt","47752",2019-09-23,"09:55",80,60,10,10,20,65,7,4,76,23,18,8,49,639,97,92,828
"./Ship3_Latin-square/2019-09-23_09h55m_Subject 47767.txt","47767",2019-09-23,"09:55",79,60,8,11,19,20,1,2,23,22,11,6,39,350,46,75,471
"./Ship3_Latin-square/2019-09-23_09h55m_Subject 47768.txt","47768",2019-09-23,"09:55",82,60,7,15,22,44,2,5,51,34,3,16,53,514,57,191,762
"./Ship3_Latin-square/2019-09-23_09h55m_Subject 47780.txt","47780",2019-09-23,"09:55",80,60,6,14,20,41,6,10,57,59,12,4,75,442,52,99,593
"./Ship3_Latin-square/2019-09-23_10h00m_Subject 46884.txt","46884",2019-09-23,"10:00",44,33,10,1,11,27,7,0,34,13,5,1,19,91,20,1,112
"./Ship3_Latin-square/2019-09-23_10h00m_Subject 47083.txt","47083",2019-09-23,"10:00",78,58,5,15,20,57,10,13,80,57,7,18,82,434,62,115,611
"./Ship3_Latin-square/2019-09-23_10h00m_Subject 47086.txt","47086",2019-09-23,"10:00",81,60,9,12,21,31,2,0,33,32,7,8,47,440,72,79,591
"./Ship3_Latin-square/2019-09-23_10h00m_Subject 47246.txt","47246",2019-09-23,"10:00",83,60,11,12,23,20,2,8,30,15,1,5,21,388,50,84,522
"./Ship3_Latin-square/2019-09-23_10h00m_Subject 47635.txt","47635",2019-09-23,"10:00",80,60,1,19,20,38,3,4,45,52,1,20,73,496,4,131,631
"./Ship3_Latin-square/2019-09-23_10h00m_Subject 47779.txt","47779",2019-09-23,"10:00",81,60,6,15,21,47,1,3,51,71,9,15,95,235,11,29,275
"./Ship3_Latin-square/2019-09-23_10h00m_Subject 47790.txt","47790",2019-09-23,"10:00",79,60,12,7,19,57,7,4,68,31,16,4,51,305,42,39,386
"./Ship3_Latin-square/2019-09-23_10h00m_Subject 47797.txt","47797",2019-09-23,"10:00",45,32,10,3,13,57,9,7,73,39,11,7,57,55,7,7,69
"./Ship3_Latin-square/2019-09-23_11h26m_Subject 46900.txt","46900",2019-09-23,"11:26",77,60,6,11,17,19,1,4,24,87,8,20,115,883,90,140,1113
"./Ship3_Latin-square/2019-09-23_11h26m_Subject 46986.txt","46986",2019-09-23,"11:26",70,53,9,8,17,47,10,3,60,19,7,9,35,271,47,42,360
"./Ship3_Latin-square/2019-09-23_11h26m_Subject 47076.txt","47076",2019-09-23,"11:26",79,60,10,9,19,8,0,7,15,40,3,11,54,558,71,69,698
"./Ship3_Latin-square/2019-09-23_11h26m_Subject 47079.txt","47079",2019-09-23,"11:26",78,60,9,9,18,30,6,4,40,69,12,12,93,244,30,49,323
"./Ship3_Latin-square/2019-09-23_11h26m_Subject 47082.txt","47082",2019-09-23,"11:26",79,60,9,10,19,37,7,2,46,16,4,5,25,386,51,63,500
"./Ship3_Latin-square/2019-09-23_11h26m_Subject 47092.txt","47092",2019-09-23,"11:26",79,60,9,10,19,24,3,6,33,36,5,6,47,553,44,118,715
"./Ship3_Latin-square/2019-09-23_11h26m_Subject 47098.txt","47098",2019-09-23,"11:26",84,60,4,20,24,16,1,4,21,4,0,12,16,382,32,99,513
"./Ship3_Latin-square/2019-09-23_11h26m_Subject 47226.txt","47226",2019-09-23,"11:26",78,60,10,8,18,9,0,0,9,82,48,14,144,2443,432,549,3424
"./Ship3_Latin-square/2019-09-23_11h26m_Subject 47227.txt","47227",2019-09-23,"11:26",81,60,8,13,21,71,5,8,84,30,4,13,47,266,48,66,380
"./Ship3_Latin-square/2019-09-23_11h26m_Subject 47250.txt","47250",2019-09-23,"11:26",79,60,12,7,19,14,7,2,23,25,22,5,52,803,154,126,1083
"./Ship3_Latin-square/2019-09-23_11h26m_Subject 47645.txt","47645",2019-09-23,"11:26",70,52,12,6,18,87,19,11,117,21,7,10,38,229,59,37,325
"./Ship3_Latin-square/2019-09-23_11h26m_Subject 47646.txt","47646",2019-09-23,"11:26",76,60,6,10,16,26,2,0,28,84,7,37,128,1502,84,387,1973
"./Ship3_Latin-square/2019-09-23_11h26m_Subject 47755.txt","47755",2019-09-23,"11:26",79,60,7,12,19,26,2,3,31,21,4,3,28,729,85,144,958
"./Ship3_Latin-square/2019-09-23_11h26m_Subject 47760.txt","47760",2019-09-23,"11:26",81,60,11,10,21,60,10,15,85,38,8,4,50,520,55,115,690
"./Ship3_Latin-square/2019-09-23_11h26m_Subject 47770.txt","47770",2019-09-23,"11:26",40,29,7,4,11,53,16,10,79,27,19,10,56,84,7,14,105
"./Ship3_Latin-square/2019-09-23_11h26m_Subject 47795.txt","47795",2019-09-23,"11:26",70,55,11,4,15,72,20,8,100,25,14,2,41,221,37,22,280
"./Ship3_Latin-square/2019-09-23_11h30m_Subject 47229.txt","47229",2019-09-23,"11:30",79,60,8,11,19,14,1,3,18,33,11,2,46,804,100,199,1103
"./Ship3_Latin-square/2019-09-23_11h30m_Subject 47233.txt","47233",2019-09-23,"11:30",79,60,9,10,19,38,2,4,44,37,9,12,58,268,25,69,362
"./Ship3_Latin-square/2019-09-23_11h30m_Subject 47234.txt","47234",2019-09-23,"11:30",85,60,14,11,25,33,45,9,87,93,31,34,158,516,153,96,765
"./Ship3_Latin-square/2019-09-23_11h30m_Subject 47237.txt","47237",2019-09-23,"11:30",77,60,4,13,17,45,2,28,75,30,2,23,55,425,23,97,545
"./Ship3_Latin-square/2019-09-23_11h30m_Subject 47241.txt","47241",2019-09-23,"11:30",81,60,9,12,21,26,3,2,31,6,10,7,23,558,17,211,786
"./Ship3_Latin-square/2019-09-23_11h30m_Subject 47247.txt","47247",2019-09-23,"11:30",77,56,17,4,21,71,22,9,102,50,40,4,94,460,289,33,782
"./Ship3_Latin-square/2019-09-23_11h30m_Subject 47777.txt","47777",2019-09-23,"11:30",80,60,10,10,20,32,0,0,32,3,8,3,14,606,112,126,844
"./Ship3_Latin-square/2019-09-23_11h30m_Subject 47784.txt","47784",2019-09-23,"11:30",79,60,6,13,19,21,6,5,32,33,3,12,48,395,46,86,527
"./Ship3_Latin-square/2019-09-23_12h37m_Subject 46881.txt","46881",2019-09-23,"12:37",83,60,11,12,23,34,8,5,47,27,16,10,53,671,88,212,971
"./Ship3_Latin-square/2019-09-23_12h37m_Subject 47087.txt","47087",2019-09-23,"12:37",80,60,11,9,20,16,3,1,20,57,63,3,123,393,61,54,508
"./Ship3_Latin-square/2019-09-23_12h37m_Subject 47626.txt","47626",2019-09-23,"12:37",82,57,0,25,25,29,0,5,34,59,0,49,108,215,0,116,331
"./Ship3_Latin-square/2019-09-23_12h37m_Subject 47632.txt","47632",2019-09-23,"12:37",83,60,12,11,23,19,7,6,32,47,12,16,75,586,70,150,806
"./Ship3_Latin-square/2019-09-23_12h37m_Subject 47634.txt","47634",2019-09-23,"12:37",78,60,9,9,18,36,5,7,48,14,2,4,20,309,44,64,417
"./Ship3_Latin-square/2019-09-23_12h37m_Subject 47640.txt","47640",2019-09-23,"12:37",82,60,13,9,22,43,5,8,56,35,6,7,48,473,65,109,647
"./Ship3_Latin-square/2019-09-23_12h37m_Subject 47754.txt","47754",2019-09-23,"12:37",58,43,11,4,15,71,9,3,83,36,5,3,44,150,18,27,195
"./Ship3_Latin-square/2019-09-23_12h37m_Subject 47800.txt","47800",2019-09-23,"12:37",76,60,7,9,16,46,4,6,56,45,5,7,57,387,43,49,479
"./Ship3_Latin-square/2019-09-23_12h40m_Subject 46880.txt","46880",2019-09-23,"12:40",82,60,10,12,22,8,0,2,10,7,8,6,21,655,105,126,886
"./Ship3_Latin-square/2019-09-23_12h40m_Subject 46882.txt","46882",2019-09-23,"12:40",77,60,6,11,17,23,0,1,24,46,15,2,63,999,91,236,1326
"./Ship3_Latin-square/2019-09-23_12h40m_Subject 46883.txt","46883",2019-09-23,"12:40",81,60,10,11,21,30,7,2,39,25,5,8,38,426,74,79,579
"./Ship3_Latin-square/2019-09-23_12h40m_Subject 46894.txt","46894",2019-09-23,"12:40",74,53,14,7,21,66,15,9,90,25,8,0,33,139,7,27,173
"./Ship3_Latin-square/2019-09-23_12h40m_Subject 46896.txt","46896",2019-09-23,"12:40",76,56,10,10,20,87,3,18,108,53,5,44,102,293,8,50,351
"./Ship3_Latin-square/2019-09-23_12h40m_Subject 47088.txt","47088",2019-09-23,"12:40",76,60,6,10,16,52,4,20,76,34,6,5,45,728,117,128,973
"./Ship3_Latin-square/2019-09-23_12h40m_Subject 47228.txt","47228",2019-09-23,"12:40",84,60,9,15,24,32,5,8,45,12,1,13,26,249,17,147,413
"./Ship3_Latin-square/2019-09-23_12h40m_Subject 47243.txt","47243",2019-09-23,"12:40",86,60,12,14,26,95,11,30,136,50,53,11,114,370,17,154,541
"./Ship3_Latin-square/2019-09-23_12h40m_Subject 47249.txt","47249",2019-09-23,"12:40",81,60,10,11,21,42,12,6,60,113,22,21,156,336,44,70,450
"./Ship3_Latin-square/2019-09-23_12h40m_Subject 47639.txt","47639",2019-09-23,"12:40",67,48,12,7,19,83,8,16,107,56,23,13,92,228,7,23,258
"./Ship3_Latin-square/2019-09-23_12h40m_Subject 47649.txt","47649",2019-09-23,"12:40",64,48,12,4,16,27,8,0,35,13,3,2,18,163,23,15,201
"./Ship3_Latin-square/2019-09-23_12h40m_Subject 47753.txt","47753",2019-09-23,"12:40",77,60,4,13,17,36,0,6,42,36,0,9,45,742,51,132,925
"./Ship3_Latin-square/2019-09-23_12h40m_Subject 47758.txt","47758",2019-09-23,"12:40",80,60,10,10,20,17,0,2,19,18,1,6,25,827,119,156,1102
"./Ship3_Latin-square/2019-09-23_12h40m_Subject 47759.txt","47759",2019-09-23,"12:40",84,60,14,10,24,22,4,5,31,74,37,6,117,529,77,144,750
"./Ship3_Latin-square/2019-09-23_12h40m_Subject 47776.txt","47776",2019-09-23,"12:40",76,60,8,8,16,29,2,3,34,44,12,8,64,726,13,118,857
"./Ship3_Latin-square/2019-09-23_12h40m_Subject 47799.txt","47799",2019-09-23,"12:40",80,60,9,11,20,16,2,9,27,95,15,37,147,463,57,118,638
"./Ship3_Latin-square/2019-09-23_13h42m_Subject 46888.txt","46888",2019-09-23,"13:42",79,60,7,12,19,9,0,1,10,63,9,7,79,835,101,167,1103
"./Ship3_Latin-square/2019-09-23_13h42m_Subject 46889.txt","46889",2019-09-23,"13:42",78,60,12,6,18,39,5,2,46,17,5,1,23,656,66,107,829
"./Ship3_Latin-square/2019-09-23_13h42m_Subject 46890.txt","46890",2019-09-23,"13:42",83,60,10,13,23,25,3,3,31,10,3,4,17,246,48,74,368
"./Ship3_Latin-square/2019-09-23_13h42m_Subject 46892.txt","46892",2019-09-23,"13:42",82,60,15,7,22,66,12,1,79,42,49,1,92,318,19,63,400
"./Ship3_Latin-square/2019-09-23_13h42m_Subject 46898.txt","46898",2019-09-23,"13:42",87,60,10,17,27,41,5,11,57,18,4,9,31,555,126,131,812
"./Ship3_Latin-square/2019-09-23_13h42m_Subject 47097.txt","47097",2019-09-23,"13:42",83,60,11,12,23,43,2,4,49,78,19,13,110,690,106,139,935
"./Ship3_Latin-square/2019-09-23_13h42m_Subject 47099.txt","47099",2019-09-23,"13:42",41,29,11,1,12,8,5,0,13,18,237,0,255,189,40,6,235
"./Ship3_Latin-square/2019-09-23_13h42m_Subject 47798.txt","47798",2019-09-23,"13:42",65,49,9,7,16,50,4,11,65,18,14,7,39,88,0,24,112
"./Ship3_Latin-square/2019-09-23_13h50m_Subject 46876.txt","46876",2019-09-23,"13:50",72,52,13,7,20,26,11,4,41,9,2,4,15,370,67,73,510
"./Ship3_Latin-square/2019-09-23_13h50m_Subject 46877.txt","46877",2019-09-23,"13:50",86,60,17,9,26,29,4,5,38,95,19,15,129,610,31,140,781
"./Ship3_Latin-square/2019-09-23_13h50m_Subject 46893.txt","46893",2019-09-23,"13:50",79,60,11,8,19,45,2,10,57,93,26,7,126,666,18,169,853
"./Ship3_Latin-square/2019-09-23_13h50m_Subject 46895.txt","46895",2019-09-23,"13:50",69,50,14,5,19,69,13,7,89,34,41,5,80,169,31,19,219
"./Ship3_Latin-square/2019-09-23_13h50m_Subject 47638.txt","47638",2019-09-23,"13:50",72,50,18,4,22,56,19,5,80,39,36,0,75,203,20,16,239
"./Ship3_Latin-square/2019-09-23_13h50m_Subject 47757.txt","47757",2019-09-23,"13:50",76,56,11,9,20,96,19,11,126,36,9,4,49,281,60,45,386
"./Ship3_Latin-square/2019-09-23_13h50m_Subject 47769.txt","47769",2019-09-23,"13:50",71,50,14,7,21,90,15,26,131,52,33,7,92,328,21,25,374
"./Ship3_Latin-square/2019-09-23_13h50m_Subject 47771.txt","47771",2019-09-23,"13:50",83,60,13,10,23,41,3,10,54,26,58,2,86,454,49,85,588
"./Ship3_Latin-square/2019-09-23_13h50m_Subject 47775.txt","47775",2019-09-23,"13:50",77,60,10,7,17,128,24,14,166,47,13,2,62,246,28,46,320
"./Ship3_Latin-square/2019-09-23_13h50m_Subject 47781.txt","47781",2019-09-23,"13:50",79,60,8,11,19,15,2,5,22,22,10,3,35,1206,154,219,1579
"./Ship3_Latin-square/2019-09-23_13h50m_Subject 47782.txt","47782",2019-09-23,"13:50",81,60,11,10,21,19,0,11,30,21,15,2,38,707,108,156,971
"./Ship3_Latin-square/2019-09-23_13h50m_Subject 47783.txt","47783",2019-09-23,"13:50",80,60,7,13,20,56,5,8,69,46,7,12,65,668,64,56,788
"./Ship3_Latin-square/2019-09-23_13h50m_Subject 47785.txt","47785",2019-09-23,"13:50",80,60,10,10,20,8,2,1,11,52,22,19,93,1389,224,230,1843
"./Ship3_Latin-square/2019-09-23_13h50m_Subject 47786.txt","47786",2019-09-23,"13:50",72,53,6,13,19,74,11,19,104,15,8,27,50,243,23,77,343
"./Ship3_Latin-square/2019-09-23_13h50m_Subject 47788.txt","47788",2019-09-23,"13:50",77,60,8,9,17,43,4,13,60,65,8,8,81,579,84,109,772
"./Ship3_Latin-square/2019-09-23_15h00m_Subject 47080.txt","47080",2019-09-23,"15:00",77,60,5,12,17,9,0,2,11,58,3,8,69,1023,113,287,1423
"./Ship3_Latin-square/2019-09-23_15h00m_Subject 47089.txt","47089",2019-09-23,"15:00",83,60,15,8,23,22,5,4,31,50,15,8,73,488,95,74,657
"./Ship3_Latin-square/2019-09-23_15h00m_Subject 47762.txt","47762",2019-09-23,"15:00",76,56,12,8,20,72,11,14,97,71,26,23,120,147,4,36,187
"./Ship3_Latin-square/2019-09-23_15h00m_Subject 47791.txt","47791",2019-09-23,"15:00",82,60,12,10,22,14,0,1,15,39,14,7,60,576,72,134,782
"./Ship3_Latin-square/2019-09-24_09h50m_Subject 46884.txt","46884",2019-09-24,"09:50",71,60,5,6,11,29,1,2,32,23,1,4,28,277,7,26,310
"./Ship3_Latin-square/2019-09-24_09h50m_Subject 47083.txt","47083",2019-09-24,"09:50",80,57,11,12,23,52,10,18,80,47,14,18,79,294,42,105,441
"./Ship3_Latin-square/2019-09-24_09h50m_Subject 47086.txt","47086",2019-09-24,"09:50",82,60,15,7,22,93,15,15,123,24,3,9,36,195,13,10,218
"./Ship3_Latin-square/2019-09-24_09h50m_Subject 47246.txt","47246",2019-09-24,"09:50",81,60,8,13,21,9,2,2,13,21,8,9,38,490,79,103,672
"./Ship3_Latin-square/2019-09-24_09h50m_Subject 47635.txt","47635",2019-09-24,"09:50",87,60,13,14,27,79,10,33,122,62,16,25,103,198,2,98,298
"./Ship3_Latin-square/2019-09-24_09h50m_Subject 47779.txt","47779",2019-09-24,"09:50",51,38,9,4,13,36,6,4,46,44,9,2,55,50,7,10,67
"./Ship3_Latin-square/2019-09-24_09h50m_Subject 47790.txt","47790",2019-09-24,"09:50",80,60,7,13,20,18,0,0,18,8,1,12,21,978,63,225,1266
"./Ship3_Latin-square/2019-09-24_09h50m_Subject 47797.txt","47797",2019-09-24,"09:50",63,49,5,9,14,38,2,9,49,50,6,24,80,206,42,45,293
"./Ship3_Latin-square/2019-09-24_09h52m_Subject 46878.txt","46878",2019-09-24,"09:52",79,60,6,13,19,15,0,5,20,6,2,0,8,1165,122,224,1511
"./Ship3_Latin-square/2019-09-24_09h52m_Subject 46885.txt","46885",2019-09-24,"09:52",85,60,10,15,25,40,14,9,63,9,2,4,15,307,44,86,437
"./Ship3_Latin-square/2019-09-24_09h52m_Subject 46899.txt","46899",2019-09-24,"09:52",81,60,13,8,21,65,12,15,92,38,9,8,55,619,62,138,819
"./Ship3_Latin-square/2019-09-24_09h52m_Subject 47081.txt","47081",2019-09-24,"09:52",81,60,10,11,21,13,2,3,18,19,2,6,27,667,131,115,913
"./Ship3_Latin-square/2019-09-24_09h52m_Subject 47091.txt","47091",2019-09-24,"09:52",74,60,8,6,14,16,0,1,17,40,10,5,55,229,24,26,279
"./Ship3_Latin-square/2019-09-24_09h52m_Subject 47095.txt","47095",2019-09-24,"09:52",78,60,8,10,18,62,2,9,73,30,19,33,82,495,61,129,685
"./Ship3_Latin-square/2019-09-24_09h52m_Subject 47231.txt","47231",2019-09-24,"09:52",76,53,10,13,23,59,9,12,80,31,25,24,80,117,20,36,173
"./Ship3_Latin-square/2019-09-24_09h52m_Subject 47238.txt","47238",2019-09-24,"09:52",81,60,9,12,21,16,1,4,21,52,29,13,94,486,82,85,653
"./Ship3_Latin-square/2019-09-24_09h52m_Subject 47242.txt","47242",2019-09-24,"09:52",79,60,7,12,19,16,1,3,20,133,15,12,160,583,64,97,744
"./Ship3_Latin-square/2019-09-24_09h52m_Subject 47244.txt","47244",2019-09-24,"09:52",79,60,9,10,19,14,1,0,15,64,18,20,102,783,124,126,1033
"./Ship3_Latin-square/2019-09-24_09h52m_Subject 47633.txt","47633",2019-09-24,"09:52",75,60,6,9,15,23,2,4,29,58,8,12,78,425,27,85,537
"./Ship3_Latin-square/2019-09-24_09h52m_Subject 47636.txt","47636",2019-09-24,"09:52",66,48,11,7,18,112,8,27,147,101,15,11,127,193,14,31,238
"./Ship3_Latin-square/2019-09-24_09h52m_Subject 47752.txt","47752",2019-09-24,"09:52",79,60,13,6,19,63,15,3,81,28,24,2,54,397,51,35,483
"./Ship3_Latin-square/2019-09-24_09h52m_Subject 47767.txt","47767",2019-09-24,"09:52",78,60,8,10,18,27,4,3,34,40,11,14,65,347,39,59,445
"./Ship3_Latin-square/2019-09-24_09h52m_Subject 47768.txt","47768",2019-09-24,"09:52",76,54,12,10,22,68,7,14,89,48,9,12,69,206,7,51,264
"./Ship3_Latin-square/2019-09-24_09h52m_Subject 47780.txt","47780",2019-09-24,"09:52",78,60,7,11,18,49,5,1,55,48,11,4,63,458,41,81,580
"./Ship3_Latin-square/2019-09-24_11h01m_Subject 47229.txt","47229",2019-09-24,"11:01",79,60,10,9,19,12,3,1,16,42,7,5,54,1078,165,180,1423
"./Ship3_Latin-square/2019-09-24_11h01m_Subject 47233.txt","47233",2019-09-24,"11:01",78,60,9,9,18,11,2,2,15,29,10,2,41,390,53,69,512
"./Ship3_Latin-square/2019-09-24_11h01m_Subject 47234.txt","47234",2019-09-24,"11:01",87,60,13,14,27,39,6,10,55,52,14,24,90,377,21,150,548
"./Ship3_Latin-square/2019-09-24_11h01m_Subject 47237.txt","47237",2019-09-24,"11:01",79,60,14,5,19,21,1,5,27,49,36,13,98,426,8,48,482
"./Ship3_Latin-square/2019-09-24_11h01m_Subject 47241.txt","47241",2019-09-24,"11:01",85,60,2,23,25,8,0,4,12,9,0,2,11,1117,41,314,1472
"./Ship3_Latin-square/2019-09-24_11h01m_Subject 47247.txt","47247",2019-09-24,"11:01",74,60,7,7,14,39,4,2,45,44,5,5,54,231,26,43,300
"./Ship3_Latin-square/2019-09-24_11h01m_Subject 47777.txt","47777",2019-09-24,"11:01",72,60,5,7,12,35,5,4,44,19,6,4,29,591,52,63,706
"./Ship3_Latin-square/2019-09-24_11h01m_Subject 47784.txt","47784",2019-09-24,"11:01",78,60,11,7,18,70,3,13,86,42,12,8,62,780,76,109,965
"./Ship3_Latin-square/2019-09-24_11h03m_Subject 46900.txt","46900",2019-09-24,"11:03",82,60,9,13,22,3,0,0,3,56,9,11,76,689,87,240,1016
"./Ship3_Latin-square/2019-09-24_11h03m_Subject 46986.txt","46986",2019-09-24,"11:03",54,39,12,3,15,45,14,2,61,13,15,1,29,149,11,26,186
"./Ship3_Latin-square/2019-09-24_11h03m_Subject 47076.txt","47076",2019-09-24,"11:03",82,60,11,11,22,8,2,0,10,26,3,4,33,831,111,190,1132
"./Ship3_Latin-square/2019-09-24_11h03m_Subject 47079.txt","47079",2019-09-24,"11:03",78,60,8,10,18,11,1,1,13,54,9,9,72,357,55,71,483
"./Ship3_Latin-square/2019-09-24_11h03m_Subject 47082.txt","47082",2019-09-24,"11:03",81,60,11,10,21,20,5,4,29,17,20,7,44,318,73,81,472
"./Ship3_Latin-square/2019-09-24_11h03m_Subject 47092.txt","47092",2019-09-24,"11:03",80,60,10,10,20,18,0,3,21,16,8,5,29,918,169,120,1207
"./Ship3_Latin-square/2019-09-24_11h03m_Subject 47098.txt","47098",2019-09-24,"11:03",79,60,11,8,19,15,0,2,17,1,3,1,5,288,50,45,383
"./Ship3_Latin-square/2019-09-24_11h03m_Subject 47226.txt","47226",2019-09-24,"11:03",77,60,6,11,17,3,0,0,3,67,6,26,99,3360,318,710,4388
"./Ship3_Latin-square/2019-09-24_11h03m_Subject 47227.txt","47227",2019-09-24,"11:03",79,60,6,13,19,39,2,7,48,7,2,4,13,389,50,100,539
"./Ship3_Latin-square/2019-09-24_11h03m_Subject 47250.txt","47250",2019-09-24,"11:03",79,60,11,8,19,16,6,3,25,24,12,9,45,691,52,121,864
"./Ship3_Latin-square/2019-09-24_11h03m_Subject 47645.txt","47645",2019-09-24,"11:03",48,34,12,2,14,105,20,5,130,6,4,1,11,130,13,10,153
"./Ship3_Latin-square/2019-09-24_11h03m_Subject 47646.txt","47646",2019-09-24,"11:03",78,60,7,11,18,8,1,0,9,117,9,31,157,2012,226,446,2684
"./Ship3_Latin-square/2019-09-24_11h03m_Subject 47755.txt","47755",2019-09-24,"11:03",80,60,12,8,20,49,6,8,63,20,11,3,34,513,65,87,665
"./Ship3_Latin-square/2019-09-24_11h03m_Subject 47760.txt","47760",2019-09-24,"11:03",79,60,10,9,19,37,2,7,46,32,15,4,51,1030,223,146,1399
"./Ship3_Latin-square/2019-09-24_11h03m_Subject 47770.txt","47770",2019-09-24,"11:03",61,46,7,8,15,71,17,3,91,47,18,15,80,220,36,26,282
"./Ship3_Latin-square/2019-09-24_11h03m_Subject 47795.txt","47795",2019-09-24,"11:03",76,60,6,10,16,53,3,7,63,27,6,5,38,315,21,61,397
"./Ship3_Latin-square/2019-09-24_12h13m_Subject 46880.txt","46880",2019-09-24,"12:13",79,60,5,14,19,8,0,2,10,15,1,10,26,742,75,187,1004
"./Ship3_Latin-square/2019-09-24_12h13m_Subject 46882.txt","46882",2019-09-24,"12:13",79,60,8,11,19,30,3,5,38,93,5,10,108,432,25,73,530
"./Ship3_Latin-square/2019-09-24_12h13m_Subject 46883.txt","46883",2019-09-24,"12:13",79,58,13,8,21,71,11,11,93,52,78,10,140,242,36,33,311
"./Ship3_Latin-square/2019-09-24_12h13m_Subject 46894.txt","46894",2019-09-24,"12:13",82,60,10,12,22,43,3,7,53,18,5,6,29,518,68,125,711
"./Ship3_Latin-square/2019-09-24_12h13m_Subject 46896.txt","46896",2019-09-24,"12:13",78,60,9,9,18,56,2,8,66,35,6,6,47,564,40,140,744
"./Ship3_Latin-square/2019-09-24_12h13m_Subject 47088.txt","47088",2019-09-24,"12:13",82,60,5,17,22,18,1,6,25,46,5,27,78,1281,154,270,1705
"./Ship3_Latin-square/2019-09-24_12h13m_Subject 47228.txt","47228",2019-09-24,"12:13",79,60,8,11,19,22,0,7,29,22,0,8,30,535,95,121,751
"./Ship3_Latin-square/2019-09-24_12h13m_Subject 47243.txt","47243",2019-09-24,"12:13",81,60,11,10,21,35,6,6,47,32,67,4,103,800,147,165,1112
"./Ship3_Latin-square/2019-09-24_12h13m_Subject 47249.txt","47249",2019-09-24,"12:13",80,60,8,12,20,24,0,5,29,77,21,22,120,517,79,96,692
"./Ship3_Latin-square/2019-09-24_12h13m_Subject 47639.txt","47639",2019-09-24,"12:13",80,60,12,8,20,16,2,1,19,12,9,4,25,680,131,115,926
"./Ship3_Latin-square/2019-09-24_12h13m_Subject 47649.txt","47649",2019-09-24,"12:13",83,60,8,15,23,45,6,8,59,14,3,3,20,479,98,155,732
"./Ship3_Latin-square/2019-09-24_12h13m_Subject 47753.txt","47753",2019-09-24,"12:13",85,60,16,9,25,67,27,8,102,39,17,11,67,318,8,57,383
"./Ship3_Latin-square/2019-09-24_12h13m_Subject 47758.txt","47758",2019-09-24,"12:13",80,60,4,16,20,13,0,0,13,17,0,9,26,1343,78,322,1743
"./Ship3_Latin-square/2019-09-24_12h13m_Subject 47759.txt","47759",2019-09-24,"12:13",85,60,14,11,25,18,2,0,20,25,13,4,42,905,203,206,1314
"./Ship3_Latin-square/2019-09-24_12h13m_Subject 47776.txt","47776",2019-09-24,"12:13",80,60,9,11,20,12,0,1,13,57,16,2,75,962,117,196,1275
"./Ship3_Latin-square/2019-09-24_12h13m_Subject 47799.txt","47799",2019-09-24,"12:13",78,60,8,10,18,13,2,2,17,40,15,14,69,718,117,119,954
"./Ship3_Latin-square/2019-09-24_12h16m_Subject 46881.txt","46881",2019-09-24,"12:16",81,60,8,13,21,18,1,4,23,19,2,3,24,944,110,217,1271
"./Ship3_Latin-square/2019-09-24_12h16m_Subject 47087.txt","47087",2019-09-24,"12:16",79,60,10,9,19,18,1,1,20,102,19,5,126,391,75,53,519
"./Ship3_Latin-square/2019-09-24_12h16m_Subject 47626.txt","47626",2019-09-24,"12:16",82,60,11,11,22,33,4,2,39,28,12,6,46,246,29,55,330
"./Ship3_Latin-square/2019-09-24_12h16m_Subject 47632.txt","47632",2019-09-24,"12:16",80,60,8,12,20,26,3,5,34,36,2,18,56,693,79,153,925
"./Ship3_Latin-square/2019-09-24_12h16m_Subject 47634.txt","47634",2019-09-24,"12:16",81,60,11,10,21,51,5,11,67,19,5,4,28,330,51,78,459
"./Ship3_Latin-square/2019-09-24_12h16m_Subject 47640.txt","47640",2019-09-24,"12:16",79,60,9,10,19,38,9,3,50,33,8,7,48,363,45,100,508
"./Ship3_Latin-square/2019-09-24_12h16m_Subject 47754.txt","47754",2019-09-24,"12:16",45,33,8,4,12,81,11,16,108,23,17,2,42,55,4,8,67
"./Ship3_Latin-square/2019-09-24_12h16m_Subject 47800.txt","47800",2019-09-24,"12:16",75,60,8,7,15,44,6,6,56,64,9,6,79,283,33,39,355
"./Ship3_Latin-square/2019-09-24_13h24m_Subject 46888.txt","46888",2019-09-24,"13:24",79,60,10,9,19,16,0,1,17,54,17,11,82,541,72,127,740
"./Ship3_Latin-square/2019-09-24_13h24m_Subject 46889.txt","46889",2019-09-24,"13:24",80,60,9,11,20,7,4,2,13,22,3,5,30,1062,166,192,1420
"./Ship3_Latin-square/2019-09-24_13h24m_Subject 46890.txt","46890",2019-09-24,"13:24",81,60,9,12,21,19,2,1,22,4,0,17,21,408,65,98,571
"./Ship3_Latin-square/2019-09-24_13h24m_Subject 46892.txt","46892",2019-09-24,"13:24",75,60,7,8,15,16,0,0,16,13,5,6,24,792,83,106,981
"./Ship3_Latin-square/2019-09-24_13h24m_Subject 46898.txt","46898",2019-09-24,"13:24",74,60,6,8,14,17,0,0,17,25,2,2,29,848,72,91,1011
"./Ship3_Latin-square/2019-09-24_13h24m_Subject 47097.txt","47097",2019-09-24,"13:24",81,60,9,12,21,30,3,6,39,69,15,22,106,759,106,210,1075
"./Ship3_Latin-square/2019-09-24_13h24m_Subject 47099.txt","47099",2019-09-24,"13:24",78,60,11,7,18,7,1,0,8,32,38,1,71,1096,171,136,1403
"./Ship3_Latin-square/2019-09-24_13h24m_Subject 47798.txt","47798",2019-09-24,"13:24",77,60,3,14,17,23,0,3,26,8,0,0,8,287,5,58,350
"./Ship3_Latin-square/2019-09-24_13h27m_Subject 46876.txt","46876",2019-09-24,"13:27",79,60,10,9,19,38,7,7,52,19,16,19,54,500,30,90,620
"./Ship3_Latin-square/2019-09-24_13h27m_Subject 46877.txt","46877",2019-09-24,"13:27",82,60,10,12,22,6,0,0,6,23,5,9,37,1368,236,271,1875
"./Ship3_Latin-square/2019-09-24_13h27m_Subject 46893.txt","46893",2019-09-24,"13:27",73,60,8,5,13,12,1,1,14,61,10,2,73,1106,132,93,1331
"./Ship3_Latin-square/2019-09-24_13h27m_Subject 46895.txt","46895",2019-09-24,"13:27",81,60,4,17,21,36,4,13,53,26,0,15,41,294,15,97,406
"./Ship3_Latin-square/2019-09-24_13h27m_Subject 47638.txt","47638",2019-09-24,"13:27",74,54,10,10,20,130,10,14,154,68,12,26,106,243,45,55,343
"./Ship3_Latin-square/2019-09-24_13h27m_Subject 47757.txt","47757",2019-09-24,"13:27",79,58,6,15,21,72,7,13,92,30,5,5,40,343,34,100,477
"./Ship3_Latin-square/2019-09-24_13h27m_Subject 47769.txt","47769",2019-09-24,"13:27",81,60,14,7,21,50,5,5,60,36,15,6,57,535,85,39,659
"./Ship3_Latin-square/2019-09-24_13h27m_Subject 47771.txt","47771",2019-09-24,"13:27",88,60,16,12,28,60,5,13,78,27,11,12,50,356,5,102,463
"./Ship3_Latin-square/2019-09-24_13h27m_Subject 47775.txt","47775",2019-09-24,"13:27",82,60,15,7,22,142,46,14,202,50,38,8,96,221,6,57,284
"./Ship3_Latin-square/2019-09-24_13h27m_Subject 47781.txt","47781",2019-09-24,"13:27",80,60,9,11,20,49,0,5,54,36,7,4,47,698,33,186,917
"./Ship3_Latin-square/2019-09-24_13h27m_Subject 47782.txt","47782",2019-09-24,"13:27",82,60,7,15,22,14,5,2,21,14,2,10,26,711,63,131,905
"./Ship3_Latin-square/2019-09-24_13h27m_Subject 47783.txt","47783",2019-09-24,"13:27",80,60,11,9,20,58,5,10,73,27,2,9,38,554,33,73,660
"./Ship3_Latin-square/2019-09-24_13h27m_Subject 47785.txt","47785",2019-09-24,"13:27",82,60,13,9,22,12,4,1,17,57,15,11,83,779,80,210,1069
"./Ship3_Latin-square/2019-09-24_13h27m_Subject 47786.txt","47786",2019-09-24,"13:27",77,60,5,12,17,79,3,18,100,25,1,8,34,282,29,53,364
"./Ship3_Latin-square/2019-09-24_13h27m_Subject 47788.txt","47788",2019-09-24,"13:27",77,60,5,12,17,34,3,3,40,72,12,20,104,650,69,148,867
"./Ship3_Latin-square/2019-09-24_14h21m_Subject 47080.txt","47080",2019-09-24,"14:21",77,60,9,8,17,21,6,3,30,28,6,4,38,636,76,182,894
"./Ship3_Latin-square/2019-09-24_14h21m_Subject 47089.txt","47089",2019-09-24,"14:21",74,56,9,9,18,106,5,11,122,112,36,42,190,293,38,53,384
"./Ship3_Latin-square/2019-09-24_14h21m_Subject 47762.txt","47762",2019-09-24,"14:21",78,60,8,10,18,70,8,5,83,23,8,6,37,187,30,50,267
"./Ship3_Latin-square/2019-09-24_14h21m_Subject 47791.txt","47791",2019-09-24,"14:21",83,60,8,15,23,18,2,3,23,33,7,9,49,614,82,118,814
"./Ship3_Latin-square/2019-09-25_09h54m_Subject 46884.txt","46884",2019-09-25,"09:54",71,53,11,7,18,27,3,4,34,15,3,3,21,159,40,32,231
"./Ship3_Latin-square/2019-09-25_09h54m_Subject 47083.txt","47083",2019-09-25,"09:54",78,60,4,14,18,52,2,10,64,47,4,11,62,382,24,87,493
"./Ship3_Latin-square/2019-09-25_09h54m_Subject 47086.txt","47086",2019-09-25,"09:54",80,60,10,10,20,8,0,1,9,14,5,2,21,314,72,56,442
"./Ship3_Latin-square/2019-09-25_09h54m_Subject 47246.txt","47246",2019-09-25,"09:54",81,60,10,11,21,25,4,2,31,8,1,3,12,373,50,82,505
"./Ship3_Latin-square/2019-09-25_09h54m_Subject 47635.txt","47635",2019-09-25,"09:54",79,60,8,11,19,20,2,0,22,43,8,8,59,671,74,134,879
"./Ship3_Latin-square/2019-09-25_09h54m_Subject 47779.txt","47779",2019-09-25,"09:54",79,57,9,13,22,10,1,0,11,61,11,11,83,187,30,21,238
"./Ship3_Latin-square/2019-09-25_09h54m_Subject 47790.txt","47790",2019-09-25,"09:54",77,56,12,9,21,47,5,11,63,37,17,7,61,250,10,47,307
"./Ship3_Latin-square/2019-09-25_09h54m_Subject 47797.txt","47797",2019-09-25,"09:54",72,54,6,12,18,44,5,8,57,11,0,11,22,329,26,52,407
"./Ship3_Latin-square/2019-09-25_09h57m_Subject 46878.txt","46878",2019-09-25,"09:57",75,60,8,7,15,20,0,3,23,11,12,1,24,573,51,77,701
"./Ship3_Latin-square/2019-09-25_09h57m_Subject 46885.txt","46885",2019-09-25,"09:57",83,60,12,11,23,72,19,12,103,14,4,2,20,314,36,77,427
"./Ship3_Latin-square/2019-09-25_09h57m_Subject 46899.txt","46899",2019-09-25,"09:57",77,60,11,6,17,27,2,3,32,28,2,1,31,715,144,92,951
"./Ship3_Latin-square/2019-09-25_09h57m_Subject 47081.txt","47081",2019-09-25,"09:57",82,60,8,14,22,17,2,7,26,16,8,18,42,656,82,141,879
"./Ship3_Latin-square/2019-09-25_09h57m_Subject 47091.txt","47091",2019-09-25,"09:57",78,60,4,14,18,26,1,8,35,57,5,11,73,280,24,61,365
"./Ship3_Latin-square/2019-09-25_09h57m_Subject 47095.txt","47095",2019-09-25,"09:57",67,49,12,6,18,74,12,9,95,38,32,10,80,204,10,34,248
"./Ship3_Latin-square/2019-09-25_09h57m_Subject 47231.txt","47231",2019-09-25,"09:57",83,59,4,20,24,42,3,13,58,40,6,6,52,213,18,83,314
"./Ship3_Latin-square/2019-09-25_09h57m_Subject 47238.txt","47238",2019-09-25,"09:57",82,60,12,10,22,15,0,5,20,50,16,5,71,436,67,112,615
"./Ship3_Latin-square/2019-09-25_09h57m_Subject 47242.txt","47242",2019-09-25,"09:57",75,60,8,7,15,31,0,5,36,39,9,6,54,586,58,92,736
"./Ship3_Latin-square/2019-09-25_09h57m_Subject 47244.txt","47244",2019-09-25,"09:57",80,60,10,10,20,20,2,5,27,63,20,30,113,687,86,129,902
"./Ship3_Latin-square/2019-09-25_09h57m_Subject 47633.txt","47633",2019-09-25,"09:57",81,60,11,10,21,23,2,8,33,71,15,12,98,248,21,64,333
"./Ship3_Latin-square/2019-09-25_09h57m_Subject 47636.txt","47636",2019-09-25,"09:57",74,54,8,12,20,85,7,8,100,83,18,9,110,328,60,61,449
"./Ship3_Latin-square/2019-09-25_09h57m_Subject 47752.txt","47752",2019-09-25,"09:57",80,60,10,10,20,62,6,7,75,29,17,4,50,676,107,83,866
"./Ship3_Latin-square/2019-09-25_09h57m_Subject 47767.txt","47767",2019-09-25,"09:57",78,60,11,7,18,45,8,6,59,45,18,7,70,246,29,53,328
"./Ship3_Latin-square/2019-09-25_09h57m_Subject 47768.txt","47768",2019-09-25,"09:57",79,60,5,14,19,17,4,9,30,22,2,5,29,696,74,152,922
"./Ship3_Latin-square/2019-09-25_09h57m_Subject 47780.txt","47780",2019-09-25,"09:57",82,60,11,11,22,69,11,18,98,78,29,6,113,249,5,54,308
"./Ship3_Latin-square/2019-09-25_11h06m_Subject 47229.txt","47229",2019-09-25,"11:06",81,60,9,12,21,29,2,7,38,46,4,9,59,604,47,132,783
"./Ship3_Latin-square/2019-09-25_11h06m_Subject 47233.txt","47233",2019-09-25,"11:06",81,60,8,13,21,56,4,13,73,33,8,6,47,365,34,99,498
"./Ship3_Latin-square/2019-09-25_11h06m_Subject 47234.txt","47234",2019-09-25,"11:06",82,60,8,14,22,30,8,5,43,57,10,14,81,599,97,106,802
"./Ship3_Latin-square/2019-09-25_11h06m_Subject 47237.txt","47237",2019-09-25,"11:06",81,60,12,9,21,33,20,15,68,59,11,7,77,343,35,54,432
"./Ship3_Latin-square/2019-09-25_11h06m_Subject 47241.txt","47241",2019-09-25,"11:06",84,60,4,20,24,15,0,1,16,7,0,1,8,1095,97,292,1484
"./Ship3_Latin-square/2019-09-25_11h06m_Subject 47247.txt","47247",2019-09-25,"11:06",74,60,7,7,14,31,3,1,35,31,3,3,37,284,35,42,361
"./Ship3_Latin-square/2019-09-25_11h06m_Subject 47777.txt","47777",2019-09-25,"11:06",78,60,8,10,18,31,3,9,43,26,5,3,34,425,80,95,600
"./Ship3_Latin-square/2019-09-25_11h06m_Subject 47784.txt","47784",2019-09-25,"11:06",81,60,9,12,21,30,2,1,33,67,25,11,103,1454,243,273,1970
"./Ship3_Latin-square/2019-09-25_11h08m_Subject 46900.txt","46900",2019-09-25,"11:08",77,60,7,10,17,7,1,1,9,24,5,16,45,750,71,163,984
"./Ship3_Latin-square/2019-09-25_11h08m_Subject 46986.txt","46986",2019-09-25,"11:08",45,33,8,4,12,48,7,5,60,4,4,35,43,147,37,11,195
"./Ship3_Latin-square/2019-09-25_11h08m_Subject 47076.txt","47076",2019-09-25,"11:08",83,60,14,9,23,23,2,10,35,151,62,48,261,401,59,33,493
"./Ship3_Latin-square/2019-09-25_11h08m_Subject 47079.txt","47079",2019-09-25,"11:08",83,60,10,13,23,41,1,8,50,62,11,18,91,267,42,51,360
"./Ship3_Latin-square/2019-09-25_11h08m_Subject 47082.txt","47082",2019-09-25,"11:08",50,41,5,4,9,56,5,5,66,32,5,2,39,211,18,15,244
"./Ship3_Latin-square/2019-09-25_11h08m_Subject 47092.txt","47092",2019-09-25,"11:08",78,60,9,9,18,20,2,4,26,21,8,2,31,650,103,130,883
"./Ship3_Latin-square/2019-09-25_11h08m_Subject 47098.txt","47098",2019-09-25,"11:08",79,54,15,10,25,76,1,33,110,16,10,12,38,130,2,27,159
"./Ship3_Latin-square/2019-09-25_11h08m_Subject 47226.txt","47226",2019-09-25,"11:08",83,60,11,12,23,15,0,4,19,32,19,15,66,1528,171,643,2342
"./Ship3_Latin-square/2019-09-25_11h08m_Subject 47227.txt","47227",2019-09-25,"11:08",80,60,8,12,20,50,5,10,65,26,25,4,55,248,28,58,334
"./Ship3_Latin-square/2019-09-25_11h08m_Subject 47250.txt","47250",2019-09-25,"11:08",82,60,13,9,22,71,2,25,98,36,24,13,73,312,4,61,377
"./Ship3_Latin-square/2019-09-25_11h08m_Subject 47645.txt","47645",2019-09-25,"11:08",62,43,10,9,19,92,21,16,129,20,7,20,47,181,42,25,248
"./Ship3_Latin-square/2019-09-25_11h08m_Subject 47646.txt","47646",2019-09-25,"11:08",84,60,11,13,24,36,7,14,57,127,42,31,200,1181,39,454,1674
"./Ship3_Latin-square/2019-09-25_11h08m_Subject 47755.txt","47755",2019-09-25,"11:08",80,60,10,10,20,58,4,7,69,21,4,2,27,547,87,108,742
"./Ship3_Latin-square/2019-09-25_11h08m_Subject 47760.txt","47760",2019-09-25,"11:08",79,60,11,8,19,41,5,6,52,48,15,5,68,663,96,90,849
"./Ship3_Latin-square/2019-09-25_11h08m_Subject 47770.txt","47770",2019-09-25,"11:08",37,28,8,1,9,63,11,4,78,42,10,0,52,91,14,1,106
"./Ship3_Latin-square/2019-09-25_11h08m_Subject 47795.txt","47795",2019-09-25,"11:08",60,45,9,6,15,110,12,10,132,43,10,8,61,138,12,10,160
"./Ship3_Latin-square/2019-09-25_12h19m_Subject 46880.txt","46880",2019-09-25,"12:19",79,60,9,10,19,5,0,1,6,27,10,0,37,514,26,123,663
"./Ship3_Latin-square/2019-09-25_12h19m_Subject 46882.txt","46882",2019-09-25,"12:19",79,58,12,9,21,78,5,20,103,69,24,73,166,289,6,48,343
"./Ship3_Latin-square/2019-09-25_12h19m_Subject 46883.txt","46883",2019-09-25,"12:19",78,60,7,11,18,23,0,10,33,17,4,2,23,588,79,108,775
"./Ship3_Latin-square/2019-09-25_12h19m_Subject 46894.txt","46894",2019-09-25,"12:19",83,60,5,18,23,56,4,7,67,15,1,12,28,684,23,160,867
"./Ship3_Latin-square/2019-09-25_12h19m_Subject 46896.txt","46896",2019-09-25,"12:19",76,60,5,11,16,29,2,8,39,36,4,9,49,651,46,118,815
"./Ship3_Latin-square/2019-09-25_12h19m_Subject 47088.txt","47088",2019-09-25,"12:19",79,60,9,10,19,39,2,4,45,29,8,6,43,877,149,141,1167
"./Ship3_Latin-square/2019-09-25_12h19m_Subject 47228.txt","47228",2019-09-25,"12:19",81,60,9,12,21,23,6,3,32,37,12,5,54,576,69,104,749
"./Ship3_Latin-square/2019-09-25_12h19m_Subject 47243.txt","47243",2019-09-25,"12:19",79,60,10,9,19,45,3,2,50,17,10,0,27,1152,177,178,1507
"./Ship3_Latin-square/2019-09-25_12h19m_Subject 47249.txt","47249",2019-09-25,"12:19",78,60,7,11,18,42,5,3,50,90,10,24,124,479,49,81,609
"./Ship3_Latin-square/2019-09-25_12h19m_Subject 47639.txt","47639",2019-09-25,"12:19",81,60,8,13,21,19,3,2,24,5,4,4,13,1043,154,211,1408
"./Ship3_Latin-square/2019-09-25_12h19m_Subject 47649.txt","47649",2019-09-25,"12:19",82,60,12,10,22,67,10,5,82,53,1,4,58,382,39,110,531
"./Ship3_Latin-square/2019-09-25_12h19m_Subject 47753.txt","47753",2019-09-25,"12:19",78,60,7,11,18,16,4,5,25,44,9,8,61,700,89,118,907
"./Ship3_Latin-square/2019-09-25_12h19m_Subject 47758.txt","47758",2019-09-25,"12:19",78,60,6,12,18,12,2,1,15,21,3,4,28,1178,133,244,1555
"./Ship3_Latin-square/2019-09-25_12h19m_Subject 47759.txt","47759",2019-09-25,"12:19",78,60,9,9,18,9,3,1,13,28,1,3,32,702,71,127,900
"./Ship3_Latin-square/2019-09-25_12h19m_Subject 47776.txt","47776",2019-09-25,"12:19",81,60,8,13,21,18,2,1,21,49,15,28,92,1329,186,268,1783
"./Ship3_Latin-square/2019-09-25_12h19m_Subject 47799.txt","47799",2019-09-25,"12:19",81,60,8,13,21,27,1,1,29,81,16,21,118,543,68,99,710
"./Ship3_Latin-square/2019-09-25_12h22m_Subject 46881.txt","46881",2019-09-25,"12:22",76,60,7,9,16,48,2,8,58,88,4,14,106,547,49,101,697
"./Ship3_Latin-square/2019-09-25_12h22m_Subject 47087.txt","47087",2019-09-25,"12:22",82,60,13,9,22,38,6,6,50,45,20,7,72,216,31,29,276
"./Ship3_Latin-square/2019-09-25_12h22m_Subject 47626.txt","47626",2019-09-25,"12:22",77,60,10,7,17,10,2,0,12,64,46,7,117,264,39,51,354
"./Ship3_Latin-square/2019-09-25_12h22m_Subject 47632.txt","47632",2019-09-25,"12:22",81,60,12,9,21,23,2,2,27,13,11,4,28,728,76,99,903
"./Ship3_Latin-square/2019-09-25_12h22m_Subject 47634.txt","47634",2019-09-25,"12:22",83,60,13,10,23,63,25,13,101,11,4,10,25,190,26,58,274
"./Ship3_Latin-square/2019-09-25_12h22m_Subject 47640.txt","47640",2019-09-25,"12:22",81,58,14,9,23,47,8,6,61,33,10,5,48,242,32,50,324
"./Ship3_Latin-square/2019-09-25_12h22m_Subject 47754.txt","47754",2019-09-25,"12:22",61,43,11,7,18,39,37,3,79,49,33,24,106,152,32,33,217
"./Ship3_Latin-square/2019-09-25_12h22m_Subject 47800.txt","47800",2019-09-25,"12:22",81,60,10,11,21,65,11,7,83,75,13,28,116,161,3,57,221
"./Ship3_Latin-square/2019-09-25_13h32m_Subject 46888.txt","46888",2019-09-25,"13:32",68,50,14,4,18,35,13,1,49,51,25,50,126,202,8,21,231
"./Ship3_Latin-square/2019-09-25_13h32m_Subject 46889.txt","46889",2019-09-25,"13:32",82,60,9,13,22,17,2,5,24,26,9,8,43,774,109,192,1075
"./Ship3_Latin-square/2019-09-25_13h32m_Subject 46890.txt","46890",2019-09-25,"13:32",58,41,7,10,17,11,0,5,16,15,1,21,37,185,24,50,259
"./Ship3_Latin-square/2019-09-25_13h32m_Subject 46892.txt","46892",2019-09-25,"13:32",77,60,6,11,17,11,5,3,19,8,0,6,14,1022,118,184,1324
"./Ship3_Latin-square/2019-09-25_13h32m_Subject 46898.txt","46898",2019-09-25,"13:32",75,60,9,6,15,39,1,7,47,21,1,4,26,396,18,54,468
"./Ship3_Latin-square/2019-09-25_13h32m_Subject 47097.txt","47097",2019-09-25,"13:32",85,60,14,11,25,44,12,14,70,78,36,14,128,412,77,85,574
"./Ship3_Latin-square/2019-09-25_13h32m_Subject 47099.txt","47099",2019-09-25,"13:32",78,60,8,10,18,7,2,0,9,29,4,2,35,1345,190,186,1721
"./Ship3_Latin-square/2019-09-25_13h32m_Subject 47798.txt","47798",2019-09-25,"13:32",79,60,9,10,19,25,3,2,30,12,5,3,20,197,17,40,254
"./Ship3_Latin-square/2019-09-25_13h34m_Subject 46876.txt","46876",2019-09-25,"13:34",52,40,9,3,12,42,8,3,53,40,7,2,49,183,21,18,222
"./Ship3_Latin-square/2019-09-25_13h34m_Subject 46877.txt","46877",2019-09-25,"13:34",82,60,14,8,22,18,2,4,24,51,16,30,97,785,121,165,1071
"./Ship3_Latin-square/2019-09-25_13h34m_Subject 46893.txt","46893",2019-09-25,"13:34",75,60,6,9,15,10,1,2,13,74,19,4,97,1207,136,184,1527
"./Ship3_Latin-square/2019-09-25_13h34m_Subject 46895.txt","46895",2019-09-25,"13:34",49,38,6,5,11,74,29,9,112,73,48,11,132,113,11,6,130
"./Ship3_Latin-square/2019-09-25_13h34m_Subject 47638.txt","47638",2019-09-25,"13:34",80,60,10,10,20,77,9,9,95,28,6,14,48,397,65,51,513
"./Ship3_Latin-square/2019-09-25_13h34m_Subject 47757.txt","47757",2019-09-25,"13:34",74,55,11,8,19,73,12,9,94,16,3,7,26,272,65,30,367
"./Ship3_Latin-square/2019-09-25_13h34m_Subject 47769.txt","47769",2019-09-25,"13:34",81,60,11,10,21,25,3,4,32,40,13,3,56,619,123,83,825
"./Ship3_Latin-square/2019-09-25_13h34m_Subject 47771.txt","47771",2019-09-25,"13:34",81,60,9,12,21,29,2,6,37,11,5,4,20,673,61,162,896
"./Ship3_Latin-square/2019-09-25_13h34m_Subject 47775.txt","47775",2019-09-25,"13:34",83,60,11,12,23,76,8,23,107,56,16,18,90,457,44,103,604
"./Ship3_Latin-square/2019-09-25_13h34m_Subject 47781.txt","47781",2019-09-25,"13:34",82,60,12,10,22,23,5,2,30,54,18,9,81,586,21,113,720
"./Ship3_Latin-square/2019-09-25_13h34m_Subject 47782.txt","47782",2019-09-25,"13:34",82,60,9,13,22,21,3,5,29,22,20,3,45,532,88,135,755
"./Ship3_Latin-square/2019-09-25_13h34m_Subject 47783.txt","47783",2019-09-25,"13:34",78,60,10,8,18,103,18,12,133,38,9,8,55,265,8,75,348
"./Ship3_Latin-square/2019-09-25_13h34m_Subject 47785.txt","47785",2019-09-25,"13:34",85,60,15,10,25,29,3,10,42,51,19,20,90,604,15,185,804
"./Ship3_Latin-square/2019-09-25_13h34m_Subject 47786.txt","47786",2019-09-25,"13:34",68,53,8,7,15,74,6,16,96,34,2,3,39,149,9,20,178
"./Ship3_Latin-square/2019-09-25_13h34m_Subject 47788.txt","47788",2019-09-25,"13:34",80,60,8,12,20,23,1,12,36,69,12,12,93,638,95,113,846
"./Ship3_Latin-square/2019-09-25_14h37m_Subject 47080.txt","47080",2019-09-25,"14:37",84,60,12,12,24,19,1,3,23,41,14,7,62,520,16,221,757
"./Ship3_Latin-square/2019-09-25_14h37m_Subject 47089.txt","47089",2019-09-25,"14:37",79,56,14,9,23,55,13,13,81,78,37,11,126,247,31,41,319
"./Ship3_Latin-square/2019-09-25_14h37m_Subject 47762.txt","47762",2019-09-25,"14:37",74,57,13,4,17,74,14,6,94,25,18,0,43,161,20,7,188
"./Ship3_Latin-square/2019-09-25_14h37m_Subject 47791.txt","47791",2019-09-25,"14:37",79,60,8,11,19,6,0,0,6,8,5,1,14,715,69,136,920
"./Ship3_Latin-square/2019-09-26_10h00m_Subject 46884.txt","46884",2019-09-26,"10:00",77,60,8,9,17,28,2,3,33,21,4,2,27,354,49,41,444
"./Ship3_Latin-square/2019-09-26_10h00m_Subject 47083.txt","47083",2019-09-26,"10:00",69,52,9,8,17,78,10,8,96,35,7,8,50,357,50,44,451
"./Ship3_Latin-square/2019-09-26_10h00m_Subject 47086.txt","47086",2019-09-26,"10:00",81,60,7,14,21,13,2,1,16,29,5,2,36,611,68,147,826
"./Ship3_Latin-square/2019-09-26_10h00m_Subject 47246.txt","47246",2019-09-26,"10:00",83,60,10,13,23,20,3,0,23,6,6,4,16,442,74,112,628
"./Ship3_Latin-square/2019-09-26_10h00m_Subject 47635.txt","47635",2019-09-26,"10:00",82,60,10,12,22,47,3,3,53,49,14,13,76,414,57,101,572
"./Ship3_Latin-square/2019-09-26_10h00m_Subject 47779.txt","47779",2019-09-26,"10:00",49,36,9,4,13,31,6,3,40,46,17,2,65,50,13,6,69
"./Ship3_Latin-square/2019-09-26_10h00m_Subject 47790.txt","47790",2019-09-26,"10:00",81,60,10,11,21,10,5,2,17,14,8,16,38,722,98,94,914
"./Ship3_Latin-square/2019-09-26_10h00m_Subject 47797.txt","47797",2019-09-26,"10:00",52,40,8,4,12,66,8,8,82,62,11,31,104,82,10,16,108
"./Ship3_Latin-square/2019-09-26_10h03m_Subject 46878.txt","46878",2019-09-26,"10:03",80,60,9,11,20,12,2,4,18,13,10,48,71,965,180,148,1293
"./Ship3_Latin-square/2019-09-26_10h03m_Subject 46885.txt","46885",2019-09-26,"10:03",82,60,9,13,22,40,10,10,60,14,4,1,19,261,42,84,387
"./Ship3_Latin-square/2019-09-26_10h03m_Subject 46899.txt","46899",2019-09-26,"10:03",79,60,10,9,19,17,1,6,24,15,3,11,29,760,96,176,1032
"./Ship3_Latin-square/2019-09-26_10h03m_Subject 47081.txt","47081",2019-09-26,"10:03",79,60,11,8,19,46,6,4,56,43,5,10,58,268,10,65,343
"./Ship3_Latin-square/2019-09-26_10h03m_Subject 47091.txt","47091",2019-09-26,"10:03",77,60,9,8,17,40,4,2,46,47,9,7,63,231,29,32,292
"./Ship3_Latin-square/2019-09-26_10h03m_Subject 47095.txt","47095",2019-09-26,"10:03",77,60,5,12,17,28,4,7,39,19,1,14,34,457,46,68,571
"./Ship3_Latin-square/2019-09-26_10h03m_Subject 47231.txt","47231",2019-09-26,"10:03",77,60,7,10,17,45,5,10,60,72,6,3,81,145,12,37,194
"./Ship3_Latin-square/2019-09-26_10h03m_Subject 47238.txt","47238",2019-09-26,"10:03",85,60,9,16,25,19,3,9,31,68,21,33,122,272,16,133,421
"./Ship3_Latin-square/2019-09-26_10h03m_Subject 47242.txt","47242",2019-09-26,"10:03",83,60,14,9,23,84,4,21,109,58,24,15,97,423,4,110,537
"./Ship3_Latin-square/2019-09-26_10h03m_Subject 47244.txt","47244",2019-09-26,"10:03",81,60,9,12,21,18,2,0,20,58,11,26,95,862,142,175,1179
"./Ship3_Latin-square/2019-09-26_10h03m_Subject 47633.txt","47633",2019-09-26,"10:03",76,60,6,10,16,30,1,3,34,63,8,16,87,521,62,72,655
"./Ship3_Latin-square/2019-09-26_10h03m_Subject 47636.txt","47636",2019-09-26,"10:03",67,51,11,5,16,51,9,3,63,45,25,4,74,207,35,15,257
"./Ship3_Latin-square/2019-09-26_10h03m_Subject 47752.txt","47752",2019-09-26,"10:03",82,60,12,10,22,61,14,9,84,20,15,2,37,378,67,79,524
"./Ship3_Latin-square/2019-09-26_10h03m_Subject 47767.txt","47767",2019-09-26,"10:03",61,46,12,3,15,133,15,22,170,58,50,3,111,209,4,8,221
"./Ship3_Latin-square/2019-09-26_10h03m_Subject 47768.txt","47768",2019-09-26,"10:03",84,60,12,12,24,63,6,7,76,40,10,11,61,475,64,83,622
"./Ship3_Latin-square/2019-09-26_10h03m_Subject 47780.txt","47780",2019-09-26,"10:03",82,60,9,13,22,43,6,6,55,66,25,14,105,494,77,113,684
"./Ship3_Latin-square/2019-09-26_11h10m_Subject 47229.txt","47229",2019-09-26,"11:10",85,60,13,12,25,58,3,15,76,61,22,14,97,513,15,122,650
"./Ship3_Latin-square/2019-09-26_11h10m_Subject 47233.txt","47233",2019-09-26,"11:10",83,60,11,12,23,22,3,6,31,30,4,5,39,407,70,78,555
"./Ship3_Latin-square/2019-09-26_11h10m_Subject 47234.txt","47234",2019-09-26,"11:10",82,60,8,14,22,48,6,16,70,38,19,17,74,726,122,122,970
"./Ship3_Latin-square/2019-09-26_11h10m_Subject 47237.txt","47237",2019-09-26,"11:10",77,60,8,9,17,30,0,4,34,13,2,1,16,401,32,75,508
"./Ship3_Latin-square/2019-09-26_11h10m_Subject 47241.txt","47241",2019-09-26,"11:10",83,60,12,11,23,17,5,3,25,22,8,9,39,623,14,174,811
"./Ship3_Latin-square/2019-09-26_11h10m_Subject 47247.txt","47247",2019-09-26,"11:10",76,60,10,6,16,69,5,1,75,20,4,2,26,371,55,35,461
"./Ship3_Latin-square/2019-09-26_11h10m_Subject 47777.txt","47777",2019-09-26,"11:10",80,60,9,11,20,84,7,5,96,15,2,16,33,372,42,80,494
"./Ship3_Latin-square/2019-09-26_11h10m_Subject 47784.txt","47784",2019-09-26,"11:10",81,60,8,13,21,24,1,5,30,44,13,7,64,1349,124,395,1868
"./Ship3_Latin-square/2019-09-26_11h12m_Subject 46900.txt","46900",2019-09-26,"11:12",81,60,11,10,21,13,1,2,16,19,14,7,40,477,48,102,627
"./Ship3_Latin-square/2019-09-26_11h12m_Subject 46986.txt","46986",2019-09-26,"11:12",75,53,8,14,22,49,5,6,60,15,3,23,41,269,44,58,371
"./Ship3_Latin-square/2019-09-26_11h12m_Subject 47076.txt","47076",2019-09-26,"11:12",74,55,14,5,19,87,5,11,103,58,32,13,103,309,12,31,352
"./Ship3_Latin-square/2019-09-26_11h12m_Subject 47079.txt","47079",2019-09-26,"11:12",79,60,7,12,19,31,1,4,36,52,17,11,80,326,49,57,432
"./Ship3_Latin-square/2019-09-26_11h12m_Subject 47082.txt","47082",2019-09-26,"11:12",39,28,10,1,11,55,27,1,83,21,10,1,32,121,16,5,142
"./Ship3_Latin-square/2019-09-26_11h12m_Subject 47092.txt","47092",2019-09-26,"11:12",78,60,9,9,18,13,1,0,14,24,6,1,31,905,132,161,1198
"./Ship3_Latin-square/2019-09-26_11h12m_Subject 47098.txt","47098",2019-09-26,"11:12",57,41,13,3,16,91,14,14,119,39,51,2,92,128,24,10,162
"./Ship3_Latin-square/2019-09-26_11h12m_Subject 47226.txt","47226",2019-09-26,"11:12",78,60,11,7,18,53,2,12,67,59,36,4,99,1105,9,129,1243
"./Ship3_Latin-square/2019-09-26_11h12m_Subject 47227.txt","47227",2019-09-26,"11:12",79,60,11,8,19,100,18,15,133,40,15,10,65,147,6,46,199
"./Ship3_Latin-square/2019-09-26_11h12m_Subject 47250.txt","47250",2019-09-26,"11:12",83,60,13,10,23,14,4,2,20,19,9,7,35,803,146,155,1104
"./Ship3_Latin-square/2019-09-26_11h12m_Subject 47645.txt","47645",2019-09-26,"11:12",68,48,8,12,20,85,11,24,120,18,3,21,42,258,58,51,367
"./Ship3_Latin-square/2019-09-26_11h12m_Subject 47646.txt","47646",2019-09-26,"11:12",77,60,10,7,17,65,4,8,77,99,16,4,119,568,5,191,764
"./Ship3_Latin-square/2019-09-26_11h12m_Subject 47755.txt","47755",2019-09-26,"11:12",78,60,11,7,18,41,6,2,49,15,9,2,26,597,94,84,775
"./Ship3_Latin-square/2019-09-26_11h12m_Subject 47760.txt","47760",2019-09-26,"11:12",76,60,7,9,16,27,1,5,33,31,4,13,48,973,124,134,1231
"./Ship3_Latin-square/2019-09-26_11h12m_Subject 47770.txt","47770",2019-09-26,"11:12",57,44,7,6,13,47,12,2,61,47,9,9,65,155,32,12,199
"./Ship3_Latin-square/2019-09-26_11h12m_Subject 47795.txt","47795",2019-09-26,"11:12",48,35,13,0,13,73,36,0,109,20,48,0,68,146,9,0,155
"./Ship3_Latin-square/2019-09-26_12h13m_Subject 46881.txt","46881",2019-09-26,"12:13",81,60,12,9,21,47,4,11,62,32,9,4,45,358,13,80,451
"./Ship3_Latin-square/2019-09-26_12h13m_Subject 47087.txt","47087",2019-09-26,"12:13",84,60,13,11,24,57,5,12,74,54,45,8,107,263,19,59,341
"./Ship3_Latin-square/2019-09-26_12h13m_Subject 47626.txt","47626",2019-09-26,"12:13",78,60,8,10,18,56,8,10,74,70,20,7,97,240,18,61,319
"./Ship3_Latin-square/2019-09-26_12h13m_Subject 47632.txt","47632",2019-09-26,"12:13",80,60,10,10,20,27,5,2,34,23,5,5,33,648,129,60,837
"./Ship3_Latin-square/2019-09-26_12h13m_Subject 47634.txt","47634",2019-09-26,"12:13",81,57,14,10,24,75,17,20,112,40,19,22,81,177,4,62,243
"./Ship3_Latin-square/2019-09-26_12h13m_Subject 47640.txt","47640",2019-09-26,"12:13",72,52,13,7,20,67,9,10,86,81,19,19,119,145,3,23,171
"./Ship3_Latin-square/2019-09-26_12h13m_Subject 47754.txt","47754",2019-09-26,"12:13",74,54,6,14,20,50,25,12,87,60,3,76,139,473,36,92,601
"./Ship3_Latin-square/2019-09-26_12h13m_Subject 47800.txt","47800",2019-09-26,"12:13",82,60,6,16,22,56,9,11,76,45,5,12,62,367,29,72,468
"./Ship3_Latin-square/2019-09-26_12h23m_Subject 46880.txt","46880",2019-09-26,"12:23",83,60,12,11,23,43,0,12,55,34,18,19,71,360,3,109,472
"./Ship3_Latin-square/2019-09-26_12h23m_Subject 46882.txt","46882",2019-09-26,"12:23",77,60,8,9,17,58,17,3,78,81,40,42,163,647,125,121,893
"./Ship3_Latin-square/2019-09-26_12h23m_Subject 46883.txt","46883",2019-09-26,"12:23",79,60,9,10,19,57,7,2,66,66,11,2,79,387,44,76,507
"./Ship3_Latin-square/2019-09-26_12h23m_Subject 46894.txt","46894",2019-09-26,"12:23",80,60,9,11,20,37,4,8,49,25,2,1,28,377,69,65,511
"./Ship3_Latin-square/2019-09-26_12h23m_Subject 46896.txt","46896",2019-09-26,"12:23",79,60,9,10,19,22,9,5,36,29,8,10,47,549,39,128,716
"./Ship3_Latin-square/2019-09-26_12h23m_Subject 47088.txt","47088",2019-09-26,"12:23",82,60,6,16,22,29,12,7,48,35,7,13,55,881,99,297,1277
"./Ship3_Latin-square/2019-09-26_12h23m_Subject 47228.txt","47228",2019-09-26,"12:23",80,60,8,12,20,24,2,5,31,22,4,3,29,461,60,127,648
"./Ship3_Latin-square/2019-09-26_12h23m_Subject 47243.txt","47243",2019-09-26,"12:23",76,60,8,8,16,29,3,1,33,44,1,13,58,927,131,129,1187
"./Ship3_Latin-square/2019-09-26_12h23m_Subject 47249.txt","47249",2019-09-26,"12:23",79,60,8,11,19,34,3,8,45,92,22,34,148,451,57,85,593
"./Ship3_Latin-square/2019-09-26_12h23m_Subject 47639.txt","47639",2019-09-26,"12:23",79,60,7,12,19,14,2,1,17,15,10,1,26,933,112,210,1255
"./Ship3_Latin-square/2019-09-26_12h23m_Subject 47649.txt","47649",2019-09-26,"12:23",79,60,9,10,19,36,9,8,53,9,1,2,12,375,78,90,543
"./Ship3_Latin-square/2019-09-26_12h23m_Subject 47753.txt","47753",2019-09-26,"12:23",80,60,10,10,20,54,3,2,59,18,7,39,64,657,105,131,893
"./Ship3_Latin-square/2019-09-26_12h23m_Subject 47758.txt","47758",2019-09-26,"12:23",78,60,5,13,18,12,0,1,13,22,9,9,40,1169,88,247,1504
"./Ship3_Latin-square/2019-09-26_12h23m_Subject 47759.txt","47759",2019-09-26,"12:23",80,60,10,10,20,11,2,1,14,22,2,19,43,748,95,138,981
"./Ship3_Latin-square/2019-09-26_12h23m_Subject 47776.txt","47776",2019-09-26,"12:23",80,60,10,10,20,10,1,4,15,45,14,15,74,1105,175,202,1482
"./Ship3_Latin-square/2019-09-26_12h23m_Subject 47799.txt","47799",2019-09-26,"12:23",80,60,6,14,20,35,4,3,42,61,10,33,104,444,54,127,625
"./Ship3_Latin-square/2019-09-26_13h24m_Subject 46888.txt","46888",2019-09-26,"13:24",81,60,9,12,21,22,0,4,26,34,7,8,49,626,99,165,890
"./Ship3_Latin-square/2019-09-26_13h24m_Subject 46889.txt","46889",2019-09-26,"13:24",76,60,5,11,16,13,0,1,14,23,4,5,32,931,79,200,1210
"./Ship3_Latin-square/2019-09-26_13h24m_Subject 46890.txt","46890",2019-09-26,"13:24",71,54,11,6,17,56,12,12,80,9,19,2,30,159,2,29,190
"./Ship3_Latin-square/2019-09-26_13h24m_Subject 46892.txt","46892",2019-09-26,"13:24",77,60,8,9,17,17,3,0,20,5,6,2,13,932,127,131,1190
"./Ship3_Latin-square/2019-09-26_13h24m_Subject 46898.txt","46898",2019-09-26,"13:24",83,60,9,14,23,21,4,5,30,15,2,3,20,637,79,93,809
"./Ship3_Latin-square/2019-09-26_13h24m_Subject 47097.txt","47097",2019-09-26,"13:24",83,60,16,7,23,94,7,11,112,73,38,15,126,327,16,39,382
"./Ship3_Latin-square/2019-09-26_13h24m_Subject 47099.txt","47099",2019-09-26,"13:24",75,60,8,7,15,7,0,1,8,85,14,8,107,1148,179,166,1493
"./Ship3_Latin-square/2019-09-26_13h24m_Subject 47798.txt","47798",2019-09-26,"13:24",81,60,7,14,21,19,1,3,23,9,1,2,12,245,20,54,319
"./Ship3_Latin-square/2019-09-26_13h30m_Subject 46876.txt","46876",2019-09-26,"13:30",51,38,11,2,13,49,10,3,62,13,18,1,32,151,0,9,160
"./Ship3_Latin-square/2019-09-26_13h30m_Subject 46877.txt","46877",2019-09-26,"13:30",79,60,10,9,19,6,1,3,10,35,27,48,110,1332,252,217,1801
"./Ship3_Latin-square/2019-09-26_13h30m_Subject 46893.txt","46893",2019-09-26,"13:30",82,60,8,14,22,3,2,2,7,81,12,20,113,1313,177,335,1825
"./Ship3_Latin-square/2019-09-26_13h30m_Subject 46895.txt","46895",2019-09-26,"13:30",82,59,12,11,23,54,5,7,66,23,9,8,40,230,42,57,329
"./Ship3_Latin-square/2019-09-26_13h30m_Subject 47638.txt","47638",2019-09-26,"13:30",83,60,12,11,23,76,6,10,92,17,8,3,28,256,49,49,354
"./Ship3_Latin-square/2019-09-26_13h30m_Subject 47757.txt","47757",2019-09-26,"13:30",75,56,10,9,19,69,16,9,94,19,3,1,23,237,51,46,334
"./Ship3_Latin-square/2019-09-26_13h30m_Subject 47769.txt","47769",2019-09-26,"13:30",84,60,12,12,24,32,4,4,40,50,11,10,71,476,80,89,645
"./Ship3_Latin-square/2019-09-26_13h30m_Subject 47771.txt","47771",2019-09-26,"13:30",79,60,9,10,19,14,1,0,15,4,2,0,6,1002,166,179,1347
"./Ship3_Latin-square/2019-09-26_13h30m_Subject 47775.txt","47775",2019-09-26,"13:30",82,60,8,14,22,54,2,9,65,5,6,0,11,510,58,124,692
"./Ship3_Latin-square/2019-09-26_13h30m_Subject 47781.txt","47781",2019-09-26,"13:30",82,60,10,12,22,13,0,2,15,21,5,10,36,1025,181,216,1422
"./Ship3_Latin-square/2019-09-26_13h30m_Subject 47782.txt","47782",2019-09-26,"13:30",79,60,7,12,19,17,0,2,19,11,2,1,14,663,88,114,865
"./Ship3_Latin-square/2019-09-26_13h30m_Subject 47783.txt","47783",2019-09-26,"13:30",79,60,9,10,19,71,6,8,85,35,13,9,57,434,101,98,633
"./Ship3_Latin-square/2019-09-26_13h30m_Subject 47785.txt","47785",2019-09-26,"13:30",81,60,9,12,21,14,3,0,17,48,9,20,77,1045,151,215,1411
"./Ship3_Latin-square/2019-09-26_13h30m_Subject 47786.txt","47786",2019-09-26,"13:30",79,60,8,11,19,60,9,11,80,26,2,7,35,315,46,41,402
"./Ship3_Latin-square/2019-09-26_13h30m_Subject 47788.txt","47788",2019-09-26,"13:30",77,60,5,12,17,29,0,12,41,47,6,9,62,745,61,140,946
"./Ship3_Latin-square/2019-09-26_14h27m_Subject 47080.txt","47080",2019-09-26,"14:27",79,60,9,10,19,18,3,1,22,39,10,13,62,804,97,126,1027
"./Ship3_Latin-square/2019-09-26_14h27m_Subject 47089.txt","47089",2019-09-26,"14:27",50,34,15,1,16,58,6,1,65,45,90,0,135,143,1,0,144
"./Ship3_Latin-square/2019-09-26_14h27m_Subject 47762.txt","47762",2019-09-26,"14:27",79,60,6,13,19,35,5,2,42,17,3,6,26,305,32,74,411
"./Ship3_Latin-square/2019-09-26_14h27m_Subject 47791.txt","47791",2019-09-26,"14:27",83,60,8,15,23,6,0,0,6,23,4,10,37,770,102,163,1035
"./Ship3_Latin-square/2019-09-27_09h49m_Subject 46884.txt","46884",2019-09-27,"09:49",48,37,8,3,11,39,3,2,44,34,6,3,43,165,19,11,195
"./Ship3_Latin-square/2019-09-27_09h49m_Subject 47083.txt","47083",2019-09-27,"09:49",80,60,5,15,20,67,0,10,77,43,4,16,63,258,29,99,386
"./Ship3_Latin-square/2019-09-27_09h49m_Subject 47086.txt","47086",2019-09-27,"09:49",79,57,13,9,22,86,15,28,129,43,11,19,73,166,12,31,209
"./Ship3_Latin-square/2019-09-27_09h49m_Subject 47246.txt","47246",2019-09-27,"09:49",79,60,7,12,19,29,3,5,37,14,3,5,22,305,31,92,428
"./Ship3_Latin-square/2019-09-27_09h49m_Subject 47635.txt","47635",2019-09-27,"09:49",81,60,4,17,21,29,1,7,37,42,2,15,59,477,42,142,661
"./Ship3_Latin-square/2019-09-27_09h49m_Subject 47779.txt","47779",2019-09-27,"09:49",76,56,9,11,20,48,3,10,61,64,20,21,105,184,22,59,265
"./Ship3_Latin-square/2019-09-27_09h49m_Subject 47790.txt","47790",2019-09-27,"09:49",78,60,10,8,18,35,3,4,42,14,5,5,24,715,91,83,889
"./Ship3_Latin-square/2019-09-27_09h49m_Subject 47797.txt","47797",2019-09-27,"09:49",77,58,3,16,19,49,0,7,56,9,0,12,21,326,13,61,400
"./Ship3_Latin-square/2019-09-27_09h52m_Subject 46878.txt","46878",2019-09-27,"09:52",79,60,10,9,19,51,4,6,61,60,12,34,106,722,119,94,935
"./Ship3_Latin-square/2019-09-27_09h52m_Subject 46885.txt","46885",2019-09-27,"09:52",46,36,7,3,10,123,14,14,151,34,7,2,43,114,13,6,133
"./Ship3_Latin-square/2019-09-27_09h52m_Subject 46899.txt","46899",2019-09-27,"09:52",79,60,6,13,19,25,5,2,32,14,5,6,25,730,34,266,1030
"./Ship3_Latin-square/2019-09-27_09h52m_Subject 47081.txt","47081",2019-09-27,"09:52",75,60,4,11,15,20,0,0,20,32,0,6,38,562,45,118,725
"./Ship3_Latin-square/2019-09-27_09h52m_Subject 47091.txt","47091",2019-09-27,"09:52",75,60,5,10,15,29,9,1,39,52,6,7,65,285,30,57,372
"./Ship3_Latin-square/2019-09-27_09h52m_Subject 47095.txt","47095",2019-09-27,"09:52",78,58,6,14,20,50,1,9,60,29,4,19,52,283,43,74,400
"./Ship3_Latin-square/2019-09-27_09h52m_Subject 47231.txt","47231",2019-09-27,"09:52",78,60,6,12,18,62,4,14,80,5,8,3,16,154,15,55,224
"./Ship3_Latin-square/2019-09-27_09h52m_Subject 47238.txt","47238",2019-09-27,"09:52",81,60,12,9,21,26,3,3,32,50,21,11,82,427,103,87,617
"./Ship3_Latin-square/2019-09-27_09h52m_Subject 47242.txt","47242",2019-09-27,"09:52",78,60,7,11,18,25,0,33,58,52,6,9,67,640,79,129,848
"./Ship3_Latin-square/2019-09-27_09h52m_Subject 47244.txt","47244",2019-09-27,"09:52",79,60,9,10,19,34,3,6,43,78,18,12,108,476,49,75,600
"./Ship3_Latin-square/2019-09-27_09h52m_Subject 47633.txt","47633",2019-09-27,"09:52",78,60,7,11,18,24,1,0,25,57,8,8,73,361,33,95,489
"./Ship3_Latin-square/2019-09-27_09h52m_Subject 47636.txt","47636",2019-09-27,"09:52",68,51,7,10,17,56,4,11,71,124,39,6,169,255,38,39,332
"./Ship3_Latin-square/2019-09-27_09h52m_Subject 47752.txt","47752",2019-09-27,"09:52",83,60,12,11,23,48,9,5,62,22,14,6,42,459,61,154,674
"./Ship3_Latin-square/2019-09-27_09h52m_Subject 47767.txt","47767",2019-09-27,"09:52",81,60,10,11,21,31,1,6,38,55,11,13,79,394,62,76,532
"./Ship3_Latin-square/2019-09-27_09h52m_Subject 47768.txt","47768",2019-09-27,"09:52",82,60,11,11,22,60,12,7,79,21,6,7,34,495,108,90,693
"./Ship3_Latin-square/2019-09-27_09h52m_Subject 47780.txt","47780",2019-09-27,"09:52",78,60,8,10,18,70,4,10,84,49,15,11,75,291,25,66,382
"./Ship3_Latin-square/2019-09-27_11h00m_Subject 47229.txt","47229",2019-09-27,"11:00",81,60,10,11,21,21,1,2,24,44,8,11,63,914,149,179,1242
"./Ship3_Latin-square/2019-09-27_11h00m_Subject 47233.txt","47233",2019-09-27,"11:00",84,60,10,14,24,33,1,11,45,33,12,12,57,371,33,121,525
"./Ship3_Latin-square/2019-09-27_11h00m_Subject 47234.txt","47234",2019-09-27,"11:00",83,60,14,9,23,48,2,14,64,57,13,8,78,215,27,49,291
"./Ship3_Latin-square/2019-09-27_11h00m_Subject 47237.txt","47237",2019-09-27,"11:00",76,60,9,7,16,24,1,5,30,78,24,28,130,491,34,38,563
"./Ship3_Latin-square/2019-09-27_11h00m_Subject 47241.txt","47241",2019-09-27,"11:00",78,60,5,13,18,11,1,2,14,9,2,2,13,1128,115,199,1442
"./Ship3_Latin-square/2019-09-27_11h00m_Subject 47247.txt","47247",2019-09-27,"11:00",75,60,7,8,15,12,2,2,16,17,4,2,23,389,54,38,481
"./Ship3_Latin-square/2019-09-27_11h00m_Subject 47777.txt","47777",2019-09-27,"11:00",73,52,12,9,21,93,21,13,127,34,4,6,44,93,10,26,129
"./Ship3_Latin-square/2019-09-27_11h00m_Subject 47784.txt","47784",2019-09-27,"11:00",80,60,8,12,20,31,7,2,40,103,25,28,156,1658,219,340,2217
"./Ship3_Latin-square/2019-09-27_11h03m_Subject 46900.txt","46900",2019-09-27,"11:03",83,60,14,9,23,36,11,5,52,43,14,14,71,309,6,73,388
"./Ship3_Latin-square/2019-09-27_11h03m_Subject 46986.txt","46986",2019-09-27,"11:03",56,41,12,3,15,43,7,3,53,16,9,0,25,117,10,6,133
"./Ship3_Latin-square/2019-09-27_11h03m_Subject 47076.txt","47076",2019-09-27,"11:03",81,60,10,11,21,17,1,4,22,25,29,18,72,599,80,153,832
"./Ship3_Latin-square/2019-09-27_11h03m_Subject 47079.txt","47079",2019-09-27,"11:03",80,60,11,9,20,39,3,4,46,54,14,6,74,224,38,38,300
"./Ship3_Latin-square/2019-09-27_11h03m_Subject 47082.txt","47082",2019-09-27,"11:03",74,58,8,8,16,71,11,4,86,33,44,3,80,396,47,35,478
"./Ship3_Latin-square/2019-09-27_11h03m_Subject 47092.txt","47092",2019-09-27,"11:03",80,60,10,10,20,18,3,1,22,32,5,5,42,648,64,147,859
"./Ship3_Latin-square/2019-09-27_11h03m_Subject 47098.txt","47098",2019-09-27,"11:03",49,35,12,2,14,30,9,0,39,112,70,0,182,123,39,6,168
"./Ship3_Latin-square/2019-09-27_11h03m_Subject 47226.txt","47226",2019-09-27,"11:03",77,60,9,8,17,12,2,4,18,112,27,19,158,2271,329,180,2780
"./Ship3_Latin-square/2019-09-27_11h03m_Subject 47227.txt","47227",2019-09-27,"11:03",79,60,10,9,19,57,21,4,82,23,10,14,47,355,61,41,457
"./Ship3_Latin-square/2019-09-27_11h03m_Subject 47250.txt","47250",2019-09-27,"11:03",79,60,5,14,19,29,1,5,35,24,5,12,41,978,68,232,1278
"./Ship3_Latin-square/2019-09-27_11h03m_Subject 47645.txt","47645",2019-09-27,"11:03",48,36,9,3,12,102,23,8,133,24,4,2,30,102,12,3,117
"./Ship3_Latin-square/2019-09-27_11h03m_Subject 47646.txt","47646",2019-09-27,"11:03",79,60,8,11,19,21,3,4,28,162,43,37,242,1616,105,437,2158
"./Ship3_Latin-square/2019-09-27_11h03m_Subject 47755.txt","47755",2019-09-27,"11:03",81,60,10,11,21,42,4,2,48,24,13,12,49,614,116,127,857
"./Ship3_Latin-square/2019-09-27_11h03m_Subject 47760.txt","47760",2019-09-27,"11:03",75,60,9,6,15,40,2,5,47,27,13,3,43,576,44,49,669
"./Ship3_Latin-square/2019-09-27_11h03m_Subject 47770.txt","47770",2019-09-27,"11:03",52,40,6,6,12,69,20,6,95,47,7,9,63,198,16,24,238
"./Ship3_Latin-square/2019-09-27_11h03m_Subject 47795.txt","47795",2019-09-27,"11:03",81,60,10,11,21,51,6,6,63,38,14,30,82,333,53,80,466
"./Ship3_Latin-square/2019-09-27_12h06m_Subject 46881.txt","46881",2019-09-27,"12:06",75,60,6,9,15,73,5,6,84,28,4,3,35,535,26,70,631
"./Ship3_Latin-square/2019-09-27_12h06m_Subject 47087.txt","47087",2019-09-27,"12:06",60,46,5,9,14,29,2,8,39,43,4,6,53,246,31,56,333
"./Ship3_Latin-square/2019-09-27_12h06m_Subject 47626.txt","47626",2019-09-27,"12:06",70,51,11,8,19,65,4,15,84,54,8,6,68,149,9,30,188
"./Ship3_Latin-square/2019-09-27_12h06m_Subject 47632.txt","47632",2019-09-27,"12:06",84,60,11,13,24,35,8,13,56,42,16,15,73,318,23,134,475
"./Ship3_Latin-square/2019-09-27_12h06m_Subject 47634.txt","47634",2019-09-27,"12:06",84,60,11,13,24,48,11,6,65,14,43,21,78,249,28,65,342
"./Ship3_Latin-square/2019-09-27_12h06m_Subject 47640.txt","47640",2019-09-27,"12:06",57,40,12,5,17,46,14,4,64,13,29,2,44,155,48,15,218
"./Ship3_Latin-square/2019-09-27_12h06m_Subject 47754.txt","47754",2019-09-27,"12:06",60,44,7,9,16,49,5,12,66,87,2,13,102,188,45,53,286
"./Ship3_Latin-square/2019-09-27_12h06m_Subject 47800.txt","47800",2019-09-27,"12:06",83,60,9,14,23,43,5,8,56,38,10,10,58,406,67,84,557
"./Ship3_Latin-square/2019-09-27_12h16m_Subject 46880.txt","46880",2019-09-27,"12:16",82,60,11,11,22,11,0,1,12,51,12,3,66,634,71,149,854
"./Ship3_Latin-square/2019-09-27_12h16m_Subject 46882.txt","46882",2019-09-27,"12:16",79,60,6,13,19,13,2,0,15,63,12,53,128,1267,132,290,1689
"./Ship3_Latin-square/2019-09-27_12h16m_Subject 46883.txt","46883",2019-09-27,"12:16",77,60,7,10,17,46,2,7,55,203,33,14,250,412,51,54,517
"./Ship3_Latin-square/2019-09-27_12h16m_Subject 46894.txt","46894",2019-09-27,"12:16",81,60,8,13,21,33,7,13,53,22,4,6,32,466,82,128,676
"./Ship3_Latin-square/2019-09-27_12h16m_Subject 46896.txt","46896",2019-09-27,"12:16",77,60,7,10,17,26,1,3,30,58,8,2,68,784,63,137,984
"./Ship3_Latin-square/2019-09-27_12h16m_Subject 47088.txt","47088",2019-09-27,"12:16",77,60,6,11,17,22,0,2,24,30,7,8,45,1025,166,184,1375
"./Ship3_Latin-square/2019-09-27_12h16m_Subject 47228.txt","47228",2019-09-27,"12:16",79,60,8,11,19,22,1,4,27,10,4,7,21,540,96,77,713
"./Ship3_Latin-square/2019-09-27_12h16m_Subject 47243.txt","47243",2019-09-27,"12:16",79,60,8,11,19,54,3,4,61,57,23,3,83,872,120,178,1170
"./Ship3_Latin-square/2019-09-27_12h16m_Subject 47249.txt","47249",2019-09-27,"12:16",80,60,8,12,20,38,9,1,48,66,12,28,106,511,61,97,669
"./Ship3_Latin-square/2019-09-27_12h16m_Subject 47639.txt","47639",2019-09-27,"12:16",79,60,3,16,19,16,5,0,21,25,0,1,26,787,40,170,997
"./Ship3_Latin-square/2019-09-27_12h16m_Subject 47649.txt","47649",2019-09-27,"12:16",59,43,12,4,16,39,10,1,50,7,2,0,9,206,22,36,264
"./Ship3_Latin-square/2019-09-27_12h16m_Subject 47753.txt","47753",2019-09-27,"12:16",77,60,3,14,17,17,0,2,19,14,0,5,19,767,38,177,982
"./Ship3_Latin-square/2019-09-27_12h16m_Subject 47758.txt","47758",2019-09-27,"12:16",77,60,7,10,17,3,0,2,5,19,8,1,28,1302,148,147,1597
"./Ship3_Latin-square/2019-09-27_12h16m_Subject 47759.txt","47759",2019-09-27,"12:16",83,60,12,11,23,10,2,3,15,23,17,14,54,774,162,130,1066
"./Ship3_Latin-square/2019-09-27_12h16m_Subject 47776.txt","47776",2019-09-27,"12:16",81,60,9,12,21,20,6,1,27,54,25,14,93,1027,134,239,1400
"./Ship3_Latin-square/2019-09-27_12h16m_Subject 47799.txt","47799",2019-09-27,"12:16",81,60,10,11,21,29,4,5,38,51,22,9,82,524,99,122,745
"./Ship3_Latin-square/2019-09-27_13h13m_Subject 46888.txt","46888",2019-09-27,"13:13",80,60,6,14,20,17,0,2,19,75,11,9,95,918,136,185,1239
"./Ship3_Latin-square/2019-09-27_13h13m_Subject 46889.txt","46889",2019-09-27,"13:13",76,60,8,8,16,14,2,2,18,22,3,0,25,713,45,100,858
"./Ship3_Latin-square/2019-09-27_13h13m_Subject 46890.txt","46890",2019-09-27,"13:13",80,60,10,10,20,31,6,6,43,15,28,8,51,155,15,27,197
"./Ship3_Latin-square/2019-09-27_13h13m_Subject 46892.txt","46892",2019-09-27,"13:13",80,60,8,12,20,14,0,2,16,27,0,6,33,982,124,184,1290
"./Ship3_Latin-square/2019-09-27_13h13m_Subject 46898.txt","46898",2019-09-27,"13:13",79,60,12,7,19,34,3,6,43,14,8,11,33,275,52,25,352
"./Ship3_Latin-square/2019-09-27_13h13m_Subject 47097.txt","47097",2019-09-27,"13:13",78,60,8,10,18,72,7,15,94,72,8,17,97,453,72,100,625
"./Ship3_Latin-square/2019-09-27_13h13m_Subject 47099.txt","47099",2019-09-27,"13:13",76,60,5,11,16,9,0,2,11,42,9,19,70,1334,93,232,1659
"./Ship3_Latin-square/2019-09-27_13h13m_Subject 47798.txt","47798",2019-09-27,"13:13",78,60,9,9,18,32,0,4,36,7,4,4,15,202,23,22,247
"./Ship3_Latin-square/2019-09-27_13h22m_Subject 46876.txt","46876",2019-09-27,"13:22",77,56,8,13,21,49,16,9,74,67,23,12,102,250,32,92,374
"./Ship3_Latin-square/2019-09-27_13h22m_Subject 46877.txt","46877",2019-09-27,"13:22",78,60,9,9,18,4,0,1,5,59,12,33,104,1203,179,214,1596
"./Ship3_Latin-square/2019-09-27_13h22m_Subject 46893.txt","46893",2019-09-27,"13:22",79,60,8,11,19,8,0,0,8,78,13,15,106,1404,215,242,1861
"./Ship3_Latin-square/2019-09-27_13h22m_Subject 46895.txt","46895",2019-09-27,"13:22",34,23,8,3,11,63,10,6,79,60,25,1,86,67,18,5,90
"./Ship3_Latin-square/2019-09-27_13h22m_Subject 47638.txt","47638",2019-09-27,"13:22",80,60,10,10,20,50,10,12,72,19,2,17,38,336,55,67,458
"./Ship3_Latin-square/2019-09-27_13h22m_Subject 47757.txt","47757",2019-09-27,"13:22",81,60,7,14,21,57,5,13,75,18,2,9,29,287,38,89,414
"./Ship3_Latin-square/2019-09-27_13h22m_Subject 47769.txt","47769",2019-09-27,"13:22",81,60,11,10,21,26,3,11,40,36,10,14,60,460,118,112,690
"./Ship3_Latin-square/2019-09-27_13h22m_Subject 47771.txt","47771",2019-09-27,"13:22",78,60,7,11,18,12,0,1,13,6,4,1,11,947,75,175,1197
"./Ship3_Latin-square/2019-09-27_13h22m_Subject 47775.txt","47775",2019-09-27,"13:22",82,60,10,12,22,42,9,11,62,13,5,8,26,457,68,85,610
"./Ship3_Latin-square/2019-09-27_13h22m_Subject 47781.txt","47781",2019-09-27,"13:22",81,60,8,13,21,14,1,2,17,19,5,3,27,1142,197,186,1525
"./Ship3_Latin-square/2019-09-27_13h22m_Subject 47782.txt","47782",2019-09-27,"13:22",80,60,1,19,20,10,2,1,13,18,0,30,48,800,14,151,965
"./Ship3_Latin-square/2019-09-27_13h22m_Subject 47783.txt","47783",2019-09-27,"13:22",80,60,6,14,20,33,1,5,39,43,7,11,61,942,81,176,1199
"./Ship3_Latin-square/2019-09-27_13h22m_Subject 47785.txt","47785",2019-09-27,"13:22",76,60,7,9,16,11,0,5,16,54,13,9,76,1521,168,197,1886
"./Ship3_Latin-square/2019-09-27_13h22m_Subject 47786.txt","47786",2019-09-27,"13:22",77,60,9,8,17,63,4,13,80,32,5,65,102,170,21,19,210
"./Ship3_Latin-square/2019-09-27_13h22m_Subject 47788.txt","47788",2019-09-27,"13:22",78,60,7,11,18,34,2,3,39,46,7,11,64,685,68,122,875
"./Ship3_Latin-square/2019-09-27_14h16m_Subject 47080.txt","47080",2019-09-27,"14:16",80,60,7,13,20,8,0,0,8,43,13,6,62,954,130,188,1272
"./Ship3_Latin-square/2019-09-27_14h16m_Subject 47089.txt","47089",2019-09-27,"14:16",82,59,13,10,23,20,3,3,26,95,23,11,129,251,42,50,343
"./Ship3_Latin-square/2019-09-27_14h16m_Subject 47762.txt","47762",2019-09-27,"14:16",81,60,11,10,21,59,7,15,81,30,11,7,48,222,53,35,310
"./Ship3_Latin-square/2019-09-27_14h16m_Subject 47791.txt","47791",2019-09-27,"14:16",82,60,10,12,22,16,1,1,18,19,13,12,44,451,55,99,605
"./Ship3_Latin-square/2019-09-28_09h49m_Subject 46884.txt","46884",2019-09-28,"09:49",47,35,8,4,12,87,4,16,107,36,4,5,45,140,1,10,151
"./Ship3_Latin-square/2019-09-28_09h49m_Subject 47083.txt","47083",2019-09-28,"09:49",78,60,10,8,18,84,19,13,116,50,14,10,74,298,36,52,386
"./Ship3_Latin-square/2019-09-28_09h49m_Subject 47086.txt","47086",2019-09-28,"09:49",81,60,7,14,21,17,0,2,19,16,2,5,23,499,72,105,676
"./Ship3_Latin-square/2019-09-28_09h49m_Subject 47246.txt","47246",2019-09-28,"09:49",81,60,10,11,21,78,9,8,95,26,5,16,47,175,7,65,247
"./Ship3_Latin-square/2019-09-28_09h49m_Subject 47635.txt","47635",2019-09-28,"09:49",77,60,6,11,17,27,3,11,41,50,8,10,68,393,39,94,526
"./Ship3_Latin-square/2019-09-28_09h49m_Subject 47779.txt","47779",2019-09-28,"09:49",62,45,10,7,17,51,5,2,58,42,12,3,57,65,18,33,116
"./Ship3_Latin-square/2019-09-28_09h49m_Subject 47790.txt","47790",2019-09-28,"09:49",79,60,9,10,19,24,5,2,31,18,9,4,31,783,121,169,1073
"./Ship3_Latin-square/2019-09-28_09h49m_Subject 47797.txt","47797",2019-09-28,"09:49",71,50,11,10,21,34,2,11,47,64,17,11,92,261,32,48,341
"./Ship3_Latin-square/2019-09-28_09h51m_Subject 46878.txt","46878",2019-09-28,"09:51",82,60,10,12,22,16,10,3,29,11,22,20,53,816,175,168,1159
"./Ship3_Latin-square/2019-09-28_09h51m_Subject 46885.txt","46885",2019-09-28,"09:51",42,31,9,2,11,130,19,7,156,40,41,13,94,93,4,12,109
"./Ship3_Latin-square/2019-09-28_09h51m_Subject 46899.txt","46899",2019-09-28,"09:51",71,56,10,5,15,104,5,19,128,55,9,7,71,377,36,36,449
"./Ship3_Latin-square/2019-09-28_09h51m_Subject 47081.txt","47081",2019-09-28,"09:51",79,60,10,9,19,21,1,3,25,23,3,6,32,402,54,79,535
"./Ship3_Latin-square/2019-09-28_09h51m_Subject 47091.txt","47091",2019-09-28,"09:51",78,60,9,9,18,26,0,3,29,50,14,11,75,226,29,39,294
"./Ship3_Latin-square/2019-09-28_09h51m_Subject 47095.txt","47095",2019-09-28,"09:51",81,60,8,13,21,19,6,17,42,17,9,16,42,540,86,122,748
"./Ship3_Latin-square/2019-09-28_09h51m_Subject 47238.txt","47238",2019-09-28,"09:51",83,60,12,11,23,20,4,7,31,45,24,12,81,529,102,127,758
"./Ship3_Latin-square/2019-09-28_09h51m_Subject 47242.txt","47242",2019-09-28,"09:51",76,60,5,11,16,25,2,3,30,36,3,88,127,702,63,141,906
"./Ship3_Latin-square/2019-09-28_09h51m_Subject 47244.txt","47244",2019-09-28,"09:51",76,60,11,5,16,59,3,1,63,86,17,6,109,411,15,53,479
"./Ship3_Latin-square/2019-09-28_09h51m_Subject 47633.txt","47633",2019-09-28,"09:51",81,60,8,13,21,25,4,4,33,60,13,6,79,399,60,106,565
"./Ship3_Latin-square/2019-09-28_09h51m_Subject 47636.txt","47636",2019-09-28,"09:51",80,60,8,12,20,88,12,9,109,66,13,12,91,395,39,73,507
"./Ship3_Latin-square/2019-09-28_09h51m_Subject 47752.txt","47752",2019-09-28,"09:51",84,59,15,10,25,98,23,11,132,53,18,14,85,299,69,92,460
"./Ship3_Latin-square/2019-09-28_09h51m_Subject 47767.txt","47767",2019-09-28,"09:51",78,60,7,11,18,20,1,8,29,38,7,4,49,446,65,102,613
"./Ship3_Latin-square/2019-09-28_09h51m_Subject 47768.txt","47768",2019-09-28,"09:51",78,60,10,8,18,42,4,4,50,15,5,1,21,562,71,57,690
"./Ship3_Latin-square/2019-09-28_09h51m_Subject 47780.txt","47780",2019-09-28,"09:51",79,60,7,12,19,37,4,5,46,57,10,14,81,395,55,86,536
"./Ship3_Latin-square/2019-09-28_10h58m_Subject 47229.txt","47229",2019-09-28,"10:58",83,60,10,13,23,16,2,5,23,32,9,5,46,962,223,228,1413
"./Ship3_Latin-square/2019-09-28_10h58m_Subject 47233.txt","47233",2019-09-28,"10:58",82,60,10,12,22,57,7,13,77,56,11,18,85,264,4,117,385
"./Ship3_Latin-square/2019-09-28_10h58m_Subject 47234.txt","47234",2019-09-28,"10:58",80,60,8,12,20,25,2,5,32,55,17,9,81,756,106,133,995
"./Ship3_Latin-square/2019-09-28_10h58m_Subject 47237.txt","47237",2019-09-28,"10:58",78,60,11,7,18,24,4,0,28,8,19,14,41,649,140,87,876
"./Ship3_Latin-square/2019-09-28_10h58m_Subject 47241.txt","47241",2019-09-28,"10:58",78,60,8,10,18,13,1,3,17,13,6,0,19,725,66,169,960
"./Ship3_Latin-square/2019-09-28_10h58m_Subject 47247.txt","47247",2019-09-28,"10:58",78,60,8,10,18,43,5,7,55,38,7,4,49,193,24,31,248
"./Ship3_Latin-square/2019-09-28_10h58m_Subject 47777.txt","47777",2019-09-28,"10:58",83,60,10,13,23,28,5,7,40,36,12,14,62,557,66,173,796
"./Ship3_Latin-square/2019-09-28_10h58m_Subject 47784.txt","47784",2019-09-28,"10:58",77,60,8,9,17,65,4,3,72,57,18,5,80,917,74,161,1152
"./Ship3_Latin-square/2019-09-28_11h00m_Subject 46900.txt","46900",2019-09-28,"11:00",79,60,9,10,19,8,11,0,19,169,38,37,244,772,97,225,1094
"./Ship3_Latin-square/2019-09-28_11h00m_Subject 46986.txt","46986",2019-09-28,"11:00",81,60,12,9,21,29,5,1,35,16,3,3,22,525,86,91,702
"./Ship3_Latin-square/2019-09-28_11h00m_Subject 47076.txt","47076",2019-09-28,"11:00",81,60,9,12,21,12,0,2,14,4,2,7,13,1182,195,232,1609
"./Ship3_Latin-square/2019-09-28_11h00m_Subject 47079.txt","47079",2019-09-28,"11:00",74,59,9,6,15,65,5,7,77,70,12,5,87,182,5,13,200
"./Ship3_Latin-square/2019-09-28_11h00m_Subject 47082.txt","47082",2019-09-28,"11:00",82,60,9,13,22,28,4,7,39,30,8,14,52,417,75,103,595
"./Ship3_Latin-square/2019-09-28_11h00m_Subject 47092.txt","47092",2019-09-28,"11:00",82,60,11,11,22,47,0,22,69,53,11,16,80,485,0,167,652
"./Ship3_Latin-square/2019-09-28_11h00m_Subject 47098.txt","47098",2019-09-28,"11:00",58,39,10,9,19,40,3,6,49,27,7,39,73,111,20,26,157
"./Ship3_Latin-square/2019-09-28_11h00m_Subject 47226.txt","47226",2019-09-28,"11:00",79,60,7,12,19,13,0,2,15,48,18,17,83,2900,379,639,3918
"./Ship3_Latin-square/2019-09-28_11h00m_Subject 47227.txt","47227",2019-09-28,"11:00",79,60,7,12,19,23,2,7,32,14,11,8,33,578,79,154,811
"./Ship3_Latin-square/2019-09-28_11h00m_Subject 47645.txt","47645",2019-09-28,"11:00",78,56,8,14,22,81,8,21,110,15,0,6,21,323,31,73,427
"./Ship3_Latin-square/2019-09-28_11h00m_Subject 47646.txt","47646",2019-09-28,"11:00",79,60,7,12,19,8,2,2,12,103,8,31,142,2215,302,402,2919
"./Ship3_Latin-square/2019-09-28_11h00m_Subject 47755.txt","47755",2019-09-28,"11:00",84,60,15,9,24,69,13,4,86,22,24,3,49,407,84,62,553
"./Ship3_Latin-square/2019-09-28_11h00m_Subject 47760.txt","47760",2019-09-28,"11:00",62,47,11,4,15,94,6,26,126,47,14,6,67,316,13,16,345
"./Ship3_Latin-square/2019-09-28_11h00m_Subject 47770.txt","47770",2019-09-28,"11:00",51,39,8,4,12,64,12,6,82,46,62,8,116,186,36,17,239
"./Ship3_Latin-square/2019-09-28_11h00m_Subject 47795.txt","47795",2019-09-28,"11:00",80,60,4,16,20,53,2,5,60,22,17,8,47,399,16,94,509
"./Ship3_Latin-square/2019-09-28_12h00m_Subject 46881.txt","46881",2019-09-28,"12:00",82,60,8,14,22,28,0,5,33,17,7,3,27,969,174,222,1365
"./Ship3_Latin-square/2019-09-28_12h00m_Subject 47087.txt","47087",2019-09-28,"12:00",82,60,10,12,22,32,3,2,37,44,10,17,71,522,116,82,720
"./Ship3_Latin-square/2019-09-28_12h00m_Subject 47626.txt","47626",2019-09-28,"12:00",79,60,9,10,19,23,2,3,28,49,6,9,64,225,26,56,307
"./Ship3_Latin-square/2019-09-28_12h00m_Subject 47632.txt","47632",2019-09-28,"12:00",79,60,9,10,19,12,0,1,13,41,23,3,67,1167,210,158,1535
"./Ship3_Latin-square/2019-09-28_12h00m_Subject 47634.txt","47634",2019-09-28,"12:00",82,60,8,14,22,48,6,6,60,20,6,16,42,395,57,127,579
"./Ship3_Latin-square/2019-09-28_12h00m_Subject 47640.txt","47640",2019-09-28,"12:00",80,60,9,11,20,36,4,9,49,22,4,6,32,813,125,138,1076
"./Ship3_Latin-square/2019-09-28_12h00m_Subject 47754.txt","47754",2019-09-28,"12:00",82,60,9,13,22,36,4,4,44,100,23,46,169,479,41,126,646
"./Ship3_Latin-square/2019-09-28_12h00m_Subject 47800.txt","47800",2019-09-28,"12:00",81,60,10,11,21,13,0,3,16,49,11,12,72,499,93,84,676
"./Ship3_Latin-square/2019-09-28_12h10m_Subject 46880.txt","46880",2019-09-28,"12:10",81,60,4,17,21,14,3,1,18,15,10,8,33,697,64,250,1011
"./Ship3_Latin-square/2019-09-28_12h10m_Subject 46882.txt","46882",2019-09-28,"12:10",81,60,10,11,21,16,0,5,21,30,13,12,55,790,139,128,1057
"./Ship3_Latin-square/2019-09-28_12h10m_Subject 46883.txt","46883",2019-09-28,"12:10",58,44,10,4,14,87,25,11,123,43,12,0,55,181,25,21,227
"./Ship3_Latin-square/2019-09-28_12h10m_Subject 46894.txt","46894",2019-09-28,"12:10",79,60,5,14,19,36,1,8,45,11,0,19,30,650,100,123,873
"./Ship3_Latin-square/2019-09-28_12h10m_Subject 46896.txt","46896",2019-09-28,"12:10",76,58,4,14,18,73,0,14,87,45,5,34,84,228,4,115,347
"./Ship3_Latin-square/2019-09-28_12h10m_Subject 47088.txt","47088",2019-09-28,"12:10",85,60,6,19,25,41,2,8,51,60,7,12,79,837,125,188,1150
"./Ship3_Latin-square/2019-09-28_12h10m_Subject 47228.txt","47228",2019-09-28,"12:10",61,41,0,20,20,33,0,11,44,15,0,92,107,211,0,125,336
"./Ship3_Latin-square/2019-09-28_12h10m_Subject 47243.txt","47243",2019-09-28,"12:10",81,60,9,12,21,24,1,5,30,34,7,0,41,1042,168,250,1460
"./Ship3_Latin-square/2019-09-28_12h10m_Subject 47249.txt","47249",2019-09-28,"12:10",79,60,8,11,19,40,7,9,56,91,10,37,138,404,55,76,535
"./Ship3_Latin-square/2019-09-28_12h10m_Subject 47649.txt","47649",2019-09-28,"12:10",46,35,7,4,11,66,4,14,84,25,4,1,30,92,7,15,114
"./Ship3_Latin-square/2019-09-28_12h10m_Subject 47753.txt","47753",2019-09-28,"12:10",84,60,13,11,24,48,1,5,54,24,4,1,29,359,64,80,503
"./Ship3_Latin-square/2019-09-28_12h10m_Subject 47758.txt","47758",2019-09-28,"12:10",84,60,9,15,24,10,3,1,14,5,8,1,14,983,141,269,1393
"./Ship3_Latin-square/2019-09-28_12h10m_Subject 47759.txt","47759",2019-09-28,"12:10",77,60,8,9,17,18,1,2,21,16,13,0,29,789,78,139,1006
"./Ship3_Latin-square/2019-09-28_12h10m_Subject 47776.txt","47776",2019-09-28,"12:10",84,60,12,12,24,15,2,0,17,49,25,14,88,1197,263,235,1695
"./Ship3_Latin-square/2019-09-28_12h10m_Subject 47799.txt","47799",2019-09-28,"12:10",79,60,8,11,19,28,2,3,33,48,16,12,76,461,55,87,603
"./Ship3_Latin-square/2019-09-28_13h05m_Subject 46888.txt","46888",2019-09-28,"13:05",78,60,9,9,18,19,2,2,23,26,24,3,53,794,139,105,1038
"./Ship3_Latin-square/2019-09-28_13h05m_Subject 46889.txt","46889",2019-09-28,"13:05",81,60,11,10,21,69,8,24,101,50,6,14,70,381,15,85,481
"./Ship3_Latin-square/2019-09-28_13h05m_Subject 46890.txt","46890",2019-09-28,"13:05",55,38,6,11,17,23,0,0,23,18,0,97,115,161,41,57,259
"./Ship3_Latin-square/2019-09-28_13h05m_Subject 46892.txt","46892",2019-09-28,"13:05",79,60,7,12,19,27,2,0,29,16,2,9,27,1027,132,180,1339
"./Ship3_Latin-square/2019-09-28_13h05m_Subject 46898.txt","46898",2019-09-28,"13:05",79,60,8,11,19,31,4,2,37,11,3,2,16,627,67,83,777
"./Ship3_Latin-square/2019-09-28_13h05m_Subject 47097.txt","47097",2019-09-28,"13:05",76,60,4,12,16,18,0,4,22,62,9,7,78,902,64,218,1184
"./Ship3_Latin-square/2019-09-28_13h05m_Subject 47099.txt","47099",2019-09-28,"13:05",77,60,6,11,17,7,0,0,7,33,8,31,72,1066,114,140,1320
"./Ship3_Latin-square/2019-09-28_13h05m_Subject 47798.txt","47798",2019-09-28,"13:05",82,60,6,16,22,31,3,4,38,15,3,2,20,199,21,64,284
"./Ship3_Latin-square/2019-09-28_13h17m_Subject 46876.txt","46876",2019-09-28,"13:17",80,60,8,12,20,16,5,2,23,2,2,8,12,843,83,231,1157
"./Ship3_Latin-square/2019-09-28_13h17m_Subject 46877.txt","46877",2019-09-28,"13:17",83,60,10,13,23,20,1,0,21,60,16,29,105,1359,241,296,1896
"./Ship3_Latin-square/2019-09-28_13h17m_Subject 46893.txt","46893",2019-09-28,"13:17",52,37,15,0,15,117,25,0,142,31,42,0,73,297,193,0,490
"./Ship3_Latin-square/2019-09-28_13h17m_Subject 46895.txt","46895",2019-09-28,"13:17",42,30,10,2,12,52,6,4,62,23,47,0,70,76,2,2,80
"./Ship3_Latin-square/2019-09-28_13h17m_Subject 47638.txt","47638",2019-09-28,"13:17",80,57,13,10,23,76,18,16,110,41,9,20,70,242,44,39,325
"./Ship3_Latin-square/2019-09-28_13h17m_Subject 47757.txt","47757",2019-09-28,"13:17",68,47,7,14,21,53,8,14,75,19,0,13,32,224,33,70,327
"./Ship3_Latin-square/2019-09-28_13h17m_Subject 47771.txt","47771",2019-09-28,"13:17",79,60,9,10,19,18,1,2,21,6,2,0,8,927,135,154,1216
"./Ship3_Latin-square/2019-09-28_13h17m_Subject 47775.txt","47775",2019-09-28,"13:17",81,60,8,13,21,49,7,26,82,6,3,2,11,443,73,68,584
"./Ship3_Latin-square/2019-09-28_13h17m_Subject 47781.txt","47781",2019-09-28,"13:17",78,60,9,9,18,11,1,1,13,20,3,2,25,911,169,182,1262
"./Ship3_Latin-square/2019-09-28_13h17m_Subject 47782.txt","47782",2019-09-28,"13:17",79,60,9,10,19,12,3,1,16,12,12,10,34,533,59,88,680
"./Ship3_Latin-square/2019-09-28_13h17m_Subject 47783.txt","47783",2019-09-28,"13:17",81,60,9,12,21,57,3,18,78,43,10,8,61,549,79,162,790
"./Ship3_Latin-square/2019-09-28_13h17m_Subject 47785.txt","47785",2019-09-28,"13:17",80,60,7,13,20,5,0,2,7,55,13,17,85,1300,176,275,1751
"./Ship3_Latin-square/2019-09-28_13h17m_Subject 47786.txt","47786",2019-09-28,"13:17",78,59,6,13,19,85,28,15,128,12,2,54,68,263,17,90,370
"./Ship3_Latin-square/2019-09-28_13h17m_Subject 47788.txt","47788",2019-09-28,"13:17",77,60,8,9,17,36,2,8,46,59,16,9,84,436,60,94,590
"./Ship3_Latin-square/2019-09-28_14h10m_Subject 47080.txt","47080",2019-09-28,"14:10",76,60,5,11,16,9,0,1,10,31,2,6,39,778,61,130,969
"./Ship3_Latin-square/2019-09-28_14h10m_Subject 47089.txt","47089",2019-09-28,"14:10",82,60,11,11,22,49,9,8,66,75,41,18,134,404,74,100,578
"./Ship3_Latin-square/2019-09-28_14h10m_Subject 47762.txt","47762",2019-09-28,"14:10",79,60,6,13,19,49,4,6,59,28,4,4,36,262,42,41,345
"./Ship3_Latin-square/2019-09-28_14h10m_Subject 47791.txt","47791",2019-09-28,"14:10",85,60,13,12,25,19,4,5,28,35,14,14,63,301,12,119,432
"./Ship3_Latin-square/2019-09-29_10h10m_Subject 46878.txt","46878",2019-09-29,"10:10",78,60,10,8,18,35,5,3,43,9,6,1,16,612,68,104,784
"./Ship3_Latin-square/2019-09-29_10h10m_Subject 46885.txt","46885",2019-09-29,"10:10",81,60,11,10,21,48,3,4,55,9,9,2,20,413,79,84,576
"./Ship3_Latin-square/2019-09-29_10h10m_Subject 46899.txt","46899",2019-09-29,"10:10",76,60,10,6,16,135,6,37,178,57,12,10,79,399,3,75,477
"./Ship3_Latin-square/2019-09-29_10h10m_Subject 47081.txt","47081",2019-09-29,"10:10",81,60,9,12,21,18,4,1,23,38,13,4,55,553,94,102,749
"./Ship3_Latin-square/2019-09-29_10h10m_Subject 47091.txt","47091",2019-09-29,"10:10",81,60,9,12,21,38,14,13,65,82,17,36,135,144,11,59,214
"./Ship3_Latin-square/2019-09-29_10h10m_Subject 47095.txt","47095",2019-09-29,"10:10",85,60,12,13,25,28,2,5,35,23,4,6,33,496,80,127,703
"./Ship3_Latin-square/2019-09-29_10h10m_Subject 47231.txt","47231",2019-09-29,"10:10",78,60,14,4,18,62,8,4,74,74,67,3,144,332,51,18,401
"./Ship3_Latin-square/2019-09-29_10h10m_Subject 47238.txt","47238",2019-09-29,"10:10",83,60,13,10,23,17,2,0,19,50,23,14,87,537,131,115,783
"./Ship3_Latin-square/2019-09-29_10h10m_Subject 47242.txt","47242",2019-09-29,"10:10",78,60,5,13,18,25,2,5,32,49,6,16,71,759,56,167,982
"./Ship3_Latin-square/2019-09-29_10h10m_Subject 47244.txt","47244",2019-09-29,"10:10",81,60,12,9,21,18,3,3,24,71,24,19,114,698,137,116,951
"./Ship3_Latin-square/2019-09-29_10h10m_Subject 47633.txt","47633",2019-09-29,"10:10",80,60,9,11,20,28,3,5,36,74,20,21,115,253,37,75,365
"./Ship3_Latin-square/2019-09-29_10h10m_Subject 47636.txt","47636",2019-09-29,"10:10",83,60,13,10,23,59,13,10,82,103,24,11,138,406,89,75,570
"./Ship3_Latin-square/2019-09-29_10h10m_Subject 47752.txt","47752",2019-09-29,"10:10",84,60,14,10,24,40,5,4,49,63,45,24,132,552,22,236,810
"./Ship3_Latin-square/2019-09-29_10h10m_Subject 47767.txt","47767",2019-09-29,"10:10",81,60,11,10,21,24,5,0,29,28,18,20,66,400,98,68,566
"./Ship3_Latin-square/2019-09-29_10h10m_Subject 47768.txt","47768",2019-09-29,"10:10",77,60,9,8,17,27,5,4,36,22,2,3,27,512,92,41,645
"./Ship3_Latin-square/2019-09-29_10h10m_Subject 47780.txt","47780",2019-09-29,"10:10",79,60,8,11,19,58,1,6,65,46,31,20,97,422,66,120,608
"./Ship3_Latin-square/2019-09-29_10h16m_Subject 46884.txt","46884",2019-09-29,"10:16",79,59,11,9,20,44,6,12,62,147,15,9,171,279,64,44,387
"./Ship3_Latin-square/2019-09-29_10h16m_Subject 47083.txt","47083",2019-09-29,"10:16",73,52,12,9,21,120,16,10,146,43,8,15,66,189,15,56,260
"./Ship3_Latin-square/2019-09-29_10h16m_Subject 47086.txt","47086",2019-09-29,"10:16",36,26,9,1,10,56,5,2,63,36,169,1,206,69,25,2,96
"./Ship3_Latin-square/2019-09-29_10h16m_Subject 47246.txt","47246",2019-09-29,"10:16",80,60,8,12,20,19,1,3,23,12,0,7,19,432,56,118,606
"./Ship3_Latin-square/2019-09-29_10h16m_Subject 47635.txt","47635",2019-09-29,"10:16",78,60,8,10,18,19,3,2,24,31,6,6,43,579,70,119,768
"./Ship3_Latin-square/2019-09-29_10h16m_Subject 47779.txt","47779",2019-09-29,"10:16",63,46,10,7,17,37,6,1,44,88,29,4,121,88,16,34,138
"./Ship3_Latin-square/2019-09-29_10h16m_Subject 47790.txt","47790",2019-09-29,"10:16",81,60,9,12,21,42,3,7,52,29,7,7,43,293,91,50,434
"./Ship3_Latin-square/2019-09-29_10h16m_Subject 47797.txt","47797",2019-09-29,"10:16",80,60,8,12,20,33,2,10,45,23,3,21,47,309,72,47,428
"./Ship3_Latin-square/2019-09-29_11h30m_Subject 46900.txt","46900",2019-09-29,"11:30",79,60,9,10,19,10,0,0,10,100,9,17,126,1354,222,227,1803
"./Ship3_Latin-square/2019-09-29_11h30m_Subject 46986.txt","46986",2019-09-29,"11:30",85,60,13,12,25,46,7,10,63,26,5,41,72,270,47,44,361
"./Ship3_Latin-square/2019-09-29_11h30m_Subject 47076.txt","47076",2019-09-29,"11:30",80,60,10,10,20,7,0,4,11,8,5,11,24,824,131,153,1108
"./Ship3_Latin-square/2019-09-29_11h30m_Subject 47079.txt","47079",2019-09-29,"11:30",79,60,9,10,19,37,4,4,45,66,17,11,94,240,37,34,311
"./Ship3_Latin-square/2019-09-29_11h30m_Subject 47082.txt","47082",2019-09-29,"11:30",79,60,9,10,19,29,5,4,38,60,7,4,71,361,67,54,482
"./Ship3_Latin-square/2019-09-29_11h30m_Subject 47092.txt","47092",2019-09-29,"11:30",75,60,6,9,15,15,3,1,19,28,2,2,32,817,69,142,1028
"./Ship3_Latin-square/2019-09-29_11h30m_Subject 47098.txt","47098",2019-09-29,"11:30",87,60,14,13,27,20,1,1,22,35,13,67,115,346,78,105,529
"./Ship3_Latin-square/2019-09-29_11h30m_Subject 47226.txt","47226",2019-09-29,"11:30",74,60,7,7,14,11,1,1,13,50,17,8,75,2157,224,308,2689
"./Ship3_Latin-square/2019-09-29_11h30m_Subject 47227.txt","47227",2019-09-29,"11:30",79,60,9,10,19,42,2,3,47,25,16,7,48,431,66,50,547
"./Ship3_Latin-square/2019-09-29_11h30m_Subject 47250.txt","47250",2019-09-29,"11:30",77,60,7,10,17,26,2,1,29,18,9,5,32,699,98,143,940
"./Ship3_Latin-square/2019-09-29_11h30m_Subject 47645.txt","47645",2019-09-29,"11:30",72,55,11,6,17,86,12,14,112,18,5,4,27,262,32,31,325
"./Ship3_Latin-square/2019-09-29_11h30m_Subject 47646.txt","47646",2019-09-29,"11:30",78,60,8,10,18,10,2,0,12,101,16,20,137,1963,292,351,2606
"./Ship3_Latin-square/2019-09-29_11h30m_Subject 47755.txt","47755",2019-09-29,"11:30",86,60,15,11,26,100,8,25,133,60,19,23,102,320,17,88,425
"./Ship3_Latin-square/2019-09-29_11h30m_Subject 47760.txt","47760",2019-09-29,"11:30",78,60,8,10,18,43,4,9,56,30,9,4,43,644,74,140,858
"./Ship3_Latin-square/2019-09-29_11h30m_Subject 47770.txt","47770",2019-09-29,"11:30",46,34,6,6,12,55,9,5,69,37,13,11,61,129,16,17,162
"./Ship3_Latin-square/2019-09-29_11h30m_Subject 47795.txt","47795",2019-09-29,"11:30",80,60,6,14,20,30,3,9,42,21,6,9,36,502,53,92,647
"./Ship3_Latin-square/2019-09-29_11h35m_Subject 47229.txt","47229",2019-09-29,"11:35",80,60,7,13,20,25,1,4,30,44,18,3,65,837,130,174,1141
"./Ship3_Latin-square/2019-09-29_11h35m_Subject 47233.txt","47233",2019-09-29,"11:35",80,60,8,12,20,23,4,4,31,30,6,7,43,382,51,97,530
"./Ship3_Latin-square/2019-09-29_11h35m_Subject 47234.txt","47234",2019-09-29,"11:35",79,60,14,5,19,32,5,3,40,88,17,4,109,373,79,50,502
"./Ship3_Latin-square/2019-09-29_11h35m_Subject 47237.txt","47237",2019-09-29,"11:35",79,58,12,9,21,83,3,24,110,40,12,31,83,286,3,60,349
"./Ship3_Latin-square/2019-09-29_11h35m_Subject 47241.txt","47241",2019-09-29,"11:35",81,60,7,14,21,12,0,1,13,13,11,2,26,1034,130,244,1408
"./Ship3_Latin-square/2019-09-29_11h35m_Subject 47247.txt","47247",2019-09-29,"11:35",74,60,9,5,14,68,9,5,82,50,13,4,67,191,5,13,209
"./Ship3_Latin-square/2019-09-29_11h35m_Subject 47777.txt","47777",2019-09-29,"11:35",70,53,7,10,17,39,9,10,58,144,22,20,186,411,96,67,574
"./Ship3_Latin-square/2019-09-29_11h35m_Subject 47784.txt","47784",2019-09-29,"11:35",80,57,14,9,23,120,18,21,159,75,37,13,125,588,30,86,704
"./Ship3_Latin-square/2019-09-29_12h50m_Subject 46880.txt","46880",2019-09-29,"12:50",82,60,8,14,22,12,0,0,12,10,1,5,16,731,95,188,1014
"./Ship3_Latin-square/2019-09-29_12h50m_Subject 46882.txt","46882",2019-09-29,"12:50",79,60,6,13,19,18,1,0,19,128,14,23,165,1121,156,245,1522
"./Ship3_Latin-square/2019-09-29_12h50m_Subject 46883.txt","46883",2019-09-29,"12:50",77,55,13,9,22,127,13,19,159,26,17,20,63,204,0,46,250
"./Ship3_Latin-square/2019-09-29_12h50m_Subject 46894.txt","46894",2019-09-29,"12:50",76,60,6,10,16,26,3,1,30,24,1,1,26,660,28,94,782
"./Ship3_Latin-square/2019-09-29_12h50m_Subject 46896.txt","46896",2019-09-29,"12:50",80,60,6,14,20,22,4,4,30,32,8,5,45,919,83,214,1216
"./Ship3_Latin-square/2019-09-29_12h50m_Subject 47088.txt","47088",2019-09-29,"12:50",83,60,14,9,23,68,10,8,86,51,13,12,76,420,14,88,522
"./Ship3_Latin-square/2019-09-29_12h50m_Subject 47228.txt","47228",2019-09-29,"12:50",81,60,8,13,21,21,2,10,33,25,2,6,33,519,111,100,730
"./Ship3_Latin-square/2019-09-29_12h50m_Subject 47243.txt","47243",2019-09-29,"12:50",83,60,13,10,23,27,1,3,31,21,8,0,29,939,221,205,1365
"./Ship3_Latin-square/2019-09-29_12h50m_Subject 47249.txt","47249",2019-09-29,"12:50",84,60,16,8,24,97,9,25,131,52,68,12,132,327,16,67,410
"./Ship3_Latin-square/2019-09-29_12h50m_Subject 47639.txt","47639",2019-09-29,"12:50",82,60,4,18,22,20,0,1,21,12,0,5,17,906,40,201,1147
"./Ship3_Latin-square/2019-09-29_12h50m_Subject 47649.txt","47649",2019-09-29,"12:50",84,60,13,11,24,45,8,8,61,23,8,6,37,394,53,141,588
"./Ship3_Latin-square/2019-09-29_12h50m_Subject 47753.txt","47753",2019-09-29,"12:50",64,47,11,6,17,64,5,11,80,131,75,19,225,219,10,29,258
"./Ship3_Latin-square/2019-09-29_12h50m_Subject 47758.txt","47758",2019-09-29,"12:50",86,60,14,12,26,51,0,23,74,46,10,47,103,436,6,133,575
"./Ship3_Latin-square/2019-09-29_12h50m_Subject 47759.txt","47759",2019-09-29,"12:50",85,60,15,10,25,78,4,27,109,64,12,37,113,270,1,84,355
"./Ship3_Latin-square/2019-09-29_12h50m_Subject 47776.txt","47776",2019-09-29,"12:50",79,60,9,10,19,15,1,1,17,49,16,6,71,1208,170,215,1593
"./Ship3_Latin-square/2019-09-29_12h50m_Subject 47799.txt","47799",2019-09-29,"12:50",71,52,13,6,19,80,16,16,112,72,104,4,180,124,4,22,150
"./Ship3_Latin-square/2019-09-29_12h53m_Subject 46881.txt","46881",2019-09-29,"12:53",80,60,8,12,20,22,4,3,29,31,8,29,68,799,108,157,1064
"./Ship3_Latin-square/2019-09-29_12h53m_Subject 47087.txt","47087",2019-09-29,"12:53",77,60,8,9,17,34,3,7,44,33,11,3,47,300,53,49,402
"./Ship3_Latin-square/2019-09-29_12h53m_Subject 47626.txt","47626",2019-09-29,"12:53",83,60,6,17,23,14,6,1,21,14,3,43,60,375,39,143,557
"./Ship3_Latin-square/2019-09-29_12h53m_Subject 47632.txt","47632",2019-09-29,"12:53",79,60,10,9,19,10,1,0,11,39,13,0,52,1310,246,196,1752
"./Ship3_Latin-square/2019-09-29_12h53m_Subject 47634.txt","47634",2019-09-29,"12:53",85,60,13,12,25,30,4,7,41,20,10,8,38,393,75,114,582
"./Ship3_Latin-square/2019-09-29_12h53m_Subject 47640.txt","47640",2019-09-29,"12:53",83,60,9,14,23,35,11,9,55,33,11,6,50,432,84,106,622
"./Ship3_Latin-square/2019-09-29_12h53m_Subject 47754.txt","47754",2019-09-29,"12:53",75,60,4,11,15,40,5,3,48,87,0,48,135,429,50,71,550
"./Ship3_Latin-square/2019-09-29_12h53m_Subject 47800.txt","47800",2019-09-29,"12:53",75,60,3,12,15,24,0,5,29,60,3,9,72,394,37,82,513
"./Ship3_Latin-square/2019-09-29_14h04m_Subject 46876.txt","46876",2019-09-29,"14:04",82,60,11,11,22,23,4,5,32,4,3,2,9,642,104,139,885
"./Ship3_Latin-square/2019-09-29_14h04m_Subject 46877.txt","46877",2019-09-29,"14:04",81,60,10,11,21,17,1,3,21,34,13,51,98,836,91,250,1177
"./Ship3_Latin-square/2019-09-29_14h04m_Subject 46893.txt","46893",2019-09-29,"14:04",77,60,5,12,17,6,1,1,8,96,11,6,113,1568,147,353,2068
"./Ship3_Latin-square/2019-09-29_14h04m_Subject 46895.txt","46895",2019-09-29,"14:04",40,27,8,5,13,28,10,14,52,49,48,93,190,91,31,17,139
"./Ship3_Latin-square/2019-09-29_14h04m_Subject 47638.txt","47638",2019-09-29,"14:04",77,60,8,9,17,47,3,4,54,20,0,13,33,454,65,54,573
"./Ship3_Latin-square/2019-09-29_14h04m_Subject 47757.txt","47757",2019-09-29,"14:04",50,35,12,3,15,103,61,12,176,48,17,3,68,133,16,15,164
"./Ship3_Latin-square/2019-09-29_14h04m_Subject 47769.txt","47769",2019-09-29,"14:04",84,60,13,11,24,13,2,0,15,40,14,9,63,892,213,247,1352
"./Ship3_Latin-square/2019-09-29_14h04m_Subject 47771.txt","47771",2019-09-29,"14:04",79,60,7,12,19,13,1,2,16,9,1,8,18,1111,142,183,1436
"./Ship3_Latin-square/2019-09-29_14h04m_Subject 47775.txt","47775",2019-09-29,"14:04",78,60,9,9,18,63,10,12,85,8,1,4,13,336,50,56,442
"./Ship3_Latin-square/2019-09-29_14h04m_Subject 47781.txt","47781",2019-09-29,"14:04",80,60,10,10,20,9,0,0,9,20,9,7,36,1138,187,172,1497
"./Ship3_Latin-square/2019-09-29_14h04m_Subject 47782.txt","47782",2019-09-29,"14:04",81,60,9,12,21,25,5,6,36,12,6,10,28,322,12,93,427
"./Ship3_Latin-square/2019-09-29_14h04m_Subject 47783.txt","47783",2019-09-29,"14:04",80,60,6,14,20,46,6,5,57,56,6,46,108,583,53,146,782
"./Ship3_Latin-square/2019-09-29_14h04m_Subject 47785.txt","47785",2019-09-29,"14:04",83,60,11,12,23,17,2,3,22,69,12,37,118,1433,300,257,1990
"./Ship3_Latin-square/2019-09-29_14h04m_Subject 47786.txt","47786",2019-09-29,"14:04",78,60,9,9,18,69,4,8,81,22,4,5,31,270,32,46,348
"./Ship3_Latin-square/2019-09-29_14h04m_Subject 47788.txt","47788",2019-09-29,"14:04",81,59,12,10,22,97,14,26,137,77,24,25,126,175,13,44,232
"./Ship3_Latin-square/2019-09-29_14h07m_Subject 46888.txt","46888",2019-09-29,"14:07",80,60,9,11,20,14,0,1,15,99,9,2,110,752,107,166,1025
"./Ship3_Latin-square/2019-09-29_14h07m_Subject 46889.txt","46889",2019-09-29,"14:07",77,60,6,11,17,19,1,0,20,28,5,8,41,955,82,202,1239
"./Ship3_Latin-square/2019-09-29_14h07m_Subject 46890.txt","46890",2019-09-29,"14:07",64,47,5,12,17,33,2,2,37,8,0,84,92,190,15,98,303
"./Ship3_Latin-square/2019-09-29_14h07m_Subject 46892.txt","46892",2019-09-29,"14:07",75,60,5,10,15,19,1,2,22,7,2,5,14,1127,94,149,1370
"./Ship3_Latin-square/2019-09-29_14h07m_Subject 46898.txt","46898",2019-09-29,"14:07",72,54,10,8,18,34,6,4,44,36,10,9,55,396,65,99,560
"./Ship3_Latin-square/2019-09-29_14h07m_Subject 47097.txt","47097",2019-09-29,"14:07",80,60,10,10,20,12,1,6,19,59,11,9,79,821,123,136,1080
"./Ship3_Latin-square/2019-09-29_14h07m_Subject 47099.txt","47099",2019-09-29,"14:07",83,60,9,14,23,3,0,1,4,40,14,23,77,993,140,230,1363
"./Ship3_Latin-square/2019-09-29_14h07m_Subject 47798.txt","47798",2019-09-29,"14:07",76,60,6,10,16,27,3,5,35,16,3,0,19,192,15,36,243
"./Ship3_Latin-square/2019-09-29_15h10m_Subject 47080.txt","47080",2019-09-29,"15:10",80,60,7,13,20,14,3,3,20,20,2,13,35,867,101,156,1124
"./Ship3_Latin-square/2019-09-29_15h10m_Subject 47089.txt","47089",2019-09-29,"15:10",81,60,11,10,21,58,8,13,79,70,12,19,101,288,45,57,390
"./Ship3_Latin-square/2019-09-29_15h10m_Subject 47762.txt","47762",2019-09-29,"15:10",82,60,12,10,22,68,10,11,89,42,23,6,71,182,27,38,247
"./Ship3_Latin-square/2019-09-29_15h10m_Subject 47791.txt","47791",2019-09-29,"15:10",75,60,8,7,15,14,1,0,15,23,2,1,26,688,83,113,884
"./Ship3_Latin-square/2019-09-30_10h20m_Subject 46878.txt","46878",2019-09-30,"10:20",81,60,10,11,21,24,2,5,31,16,10,25,51,514,12,137,663
"./Ship3_Latin-square/2019-09-30_10h20m_Subject 46885.txt","46885",2019-09-30,"10:20",81,60,10,11,21,33,7,5,45,18,7,8,33,558,93,99,750
"./Ship3_Latin-square/2019-09-30_10h20m_Subject 46899.txt","46899",2019-09-30,"10:20",78,60,8,10,18,17,1,2,20,25,5,10,40,928,85,213,1226
"./Ship3_Latin-square/2019-09-30_10h20m_Subject 47081.txt","47081",2019-09-30,"10:20",75,60,5,10,15,19,2,1,22,23,2,5,30,616,53,117,786
"./Ship3_Latin-square/2019-09-30_10h20m_Subject 47091.txt","47091",2019-09-30,"10:20",80,60,7,13,20,21,4,5,30,64,16,14,94,341,40,101,482
"./Ship3_Latin-square/2019-09-30_10h20m_Subject 47095.txt","47095",2019-09-30,"10:20",76,55,13,8,21,65,8,18,91,71,23,36,130,243,5,33,281
"./Ship3_Latin-square/2019-09-30_10h20m_Subject 47231.txt","47231",2019-09-30,"10:20",68,50,14,4,18,75,12,5,92,75,73,2,150,247,24,18,289
"./Ship3_Latin-square/2019-09-30_10h20m_Subject 47238.txt","47238",2019-09-30,"10:20",80,60,11,9,20,11,0,1,12,43,13,10,66,534,109,75,718
"./Ship3_Latin-square/2019-09-30_10h20m_Subject 47242.txt","47242",2019-09-30,"10:20",82,60,10,12,22,42,5,5,52,18,18,17,53,753,129,157,1039
"./Ship3_Latin-square/2019-09-30_10h20m_Subject 47244.txt","47244",2019-09-30,"10:20",78,60,6,12,18,13,2,2,17,45,7,12,64,1047,112,164,1323
"./Ship3_Latin-square/2019-09-30_10h20m_Subject 47633.txt","47633",2019-09-30,"10:20",80,60,13,7,20,62,14,17,93,56,25,12,93,264,13,56,333
"./Ship3_Latin-square/2019-09-30_10h20m_Subject 47636.txt","47636",2019-09-30,"10:20",82,58,12,12,24,67,8,24,99,98,20,39,157,341,54,51,446
"./Ship3_Latin-square/2019-09-30_10h20m_Subject 47752.txt","47752",2019-09-30,"10:20",79,60,9,10,19,37,9,4,50,29,14,5,48,669,93,131,893
"./Ship3_Latin-square/2019-09-30_10h20m_Subject 47767.txt","47767",2019-09-30,"10:20",86,60,13,13,26,38,0,5,43,28,18,13,59,341,87,58,486
"./Ship3_Latin-square/2019-09-30_10h20m_Subject 47768.txt","47768",2019-09-30,"10:20",82,60,13,9,22,25,1,11,37,38,20,3,61,441,50,116,607
"./Ship3_Latin-square/2019-09-30_10h20m_Subject 47780.txt","47780",2019-09-30,"10:20",82,60,11,11,22,76,7,13,96,61,14,15,90,337,55,99,491
"./Ship3_Latin-square/2019-09-30_10h25m_Subject 46884.txt","46884",2019-09-30,"10:25",79,60,10,9,19,15,0,7,22,25,6,15,46,536,130,79,745
"./Ship3_Latin-square/2019-09-30_10h25m_Subject 47083.txt","47083",2019-09-30,"10:25",82,60,8,14,22,57,4,6,67,61,10,17,88,485,51,151,687
"./Ship3_Latin-square/2019-09-30_10h25m_Subject 47086.txt","47086",2019-09-30,"10:25",80,60,10,10,20,9,3,0,12,6,2,2,10,493,75,94,662
"./Ship3_Latin-square/2019-09-30_10h25m_Subject 47246.txt","47246",2019-09-30,"10:25",79,60,3,16,19,16,0,2,18,9,1,8,18,564,27,107,698
"./Ship3_Latin-square/2019-09-30_10h25m_Subject 47635.txt","47635",2019-09-30,"10:25",81,60,12,9,21,21,2,1,24,36,34,8,78,506,58,88,652
"./Ship3_Latin-square/2019-09-30_10h25m_Subject 47779.txt","47779",2019-09-30,"10:25",52,37,9,6,15,18,7,2,27,35,17,10,62,77,20,9,106
"./Ship3_Latin-square/2019-09-30_10h25m_Subject 47790.txt","47790",2019-09-30,"10:25",81,59,16,6,22,41,10,5,56,34,24,4,62,249,19,30,298
"./Ship3_Latin-square/2019-09-30_10h25m_Subject 47797.txt","47797",2019-09-30,"10:25",72,50,8,14,22,41,2,12,55,83,23,21,127,228,30,45,303
"./Ship3_Latin-square/2019-09-30_11h40m_Subject 46900.txt","46900",2019-09-30,"11:40",81,60,7,14,21,7,0,0,7,123,19,34,176,1173,133,329,1635
"./Ship3_Latin-square/2019-09-30_11h40m_Subject 46986.txt","46986",2019-09-30,"11:40",80,60,9,11,20,36,5,3,44,12,2,10,24,367,51,60,478
"./Ship3_Latin-square/2019-09-30_11h40m_Subject 47076.txt","47076",2019-09-30,"11:40",79,60,9,10,19,6,1,1,8,10,26,5,41,1030,162,185,1377
"./Ship3_Latin-square/2019-09-30_11h40m_Subject 47079.txt","47079",2019-09-30,"11:40",77,60,9,8,17,18,4,6,28,52,12,15,79,365,67,36,468
"./Ship3_Latin-square/2019-09-30_11h40m_Subject 47082.txt","47082",2019-09-30,"11:40",75,60,7,8,15,38,4,9,51,48,7,10,65,266,35,25,326
"./Ship3_Latin-square/2019-09-30_11h40m_Subject 47092.txt","47092",2019-09-30,"11:40",79,60,8,11,19,13,0,0,13,25,2,5,32,1008,141,164,1313
"./Ship3_Latin-square/2019-09-30_11h40m_Subject 47098.txt","47098",2019-09-30,"11:40",83,57,16,10,26,106,8,21,135,44,19,23,86,186,2,29,217
"./Ship3_Latin-square/2019-09-30_11h40m_Subject 47226.txt","47226",2019-09-30,"11:40",78,60,8,10,18,10,2,1,13,43,6,12,61,2595,240,374,3209
"./Ship3_Latin-square/2019-09-30_11h40m_Subject 47227.txt","47227",2019-09-30,"11:40",84,59,7,18,25,53,2,26,81,27,8,13,48,367,51,76,494
"./Ship3_Latin-square/2019-09-30_11h40m_Subject 47250.txt","47250",2019-09-30,"11:40",81,60,12,9,21,12,6,0,18,13,5,8,26,791,130,125,1046
"./Ship3_Latin-square/2019-09-30_11h40m_Subject 47645.txt","47645",2019-09-30,"11:40",79,57,10,12,22,60,5,17,82,16,1,8,25,360,65,54,479
"./Ship3_Latin-square/2019-09-30_11h40m_Subject 47646.txt","47646",2019-09-30,"11:40",82,60,9,13,22,15,2,0,17,90,22,39,151,1669,309,421,2399
"./Ship3_Latin-square/2019-09-30_11h40m_Subject 47755.txt","47755",2019-09-30,"11:40",81,60,12,9,21,41,12,9,62,33,18,4,55,570,84,95,749
"./Ship3_Latin-square/2019-09-30_11h40m_Subject 47760.txt","47760",2019-09-30,"11:40",77,60,8,9,17,23,0,10,33,36,12,7,55,1058,219,144,1421
"./Ship3_Latin-square/2019-09-30_11h40m_Subject 47770.txt","47770",2019-09-30,"11:40",38,29,7,2,9,93,15,5,113,34,13,2,49,67,4,4,75
"./Ship3_Latin-square/2019-09-30_11h40m_Subject 47795.txt","47795",2019-09-30,"11:40",80,60,9,11,20,29,6,4,39,46,6,6,58,342,76,62,480
"./Ship3_Latin-square/2019-09-30_11h43m_Subject 47229.txt","47229",2019-09-30,"11:43",79,60,8,11,19,14,0,4,18,40,5,5,50,798,90,83,971
"./Ship3_Latin-square/2019-09-30_11h43m_Subject 47233.txt","47233",2019-09-30,"11:43",80,60,5,15,20,24,0,2,26,21,2,7,30,483,48,82,613
"./Ship3_Latin-square/2019-09-30_11h43m_Subject 47234.txt","47234",2019-09-30,"11:43",81,60,12,9,21,23,22,4,49,83,9,79,171,460,143,92,695
"./Ship3_Latin-square/2019-09-30_11h43m_Subject 47237.txt","47237",2019-09-30,"11:43",77,60,10,7,17,37,1,1,39,18,5,7,30,676,84,93,853
"./Ship3_Latin-square/2019-09-30_11h43m_Subject 47241.txt","47241",2019-09-30,"11:43",80,60,8,12,20,16,1,3,20,5,8,2,15,874,113,215,1202
"./Ship3_Latin-square/2019-09-30_11h43m_Subject 47247.txt","47247",2019-09-30,"11:43",73,60,6,7,13,25,2,0,27,42,4,4,50,338,33,41,412
"./Ship3_Latin-square/2019-09-30_11h43m_Subject 47777.txt","47777",2019-09-30,"11:43",82,60,10,12,22,44,10,6,60,19,3,17,39,361,71,93,525
"./Ship3_Latin-square/2019-09-30_11h43m_Subject 47784.txt","47784",2019-09-30,"11:43",81,60,11,10,21,43,15,16,74,94,40,36,170,964,151,143,1258
"./Ship3_Latin-square/2019-09-30_12h51m_Subject 46881.txt","46881",2019-09-30,"12:51",77,60,8,9,17,16,1,3,20,56,8,4,68,854,118,156,1128
"./Ship3_Latin-square/2019-09-30_12h51m_Subject 47087.txt","47087",2019-09-30,"12:51",80,60,9,11,20,20,0,2,22,47,7,4,58,430,73,71,574
"./Ship3_Latin-square/2019-09-30_12h51m_Subject 47626.txt","47626",2019-09-30,"12:51",74,60,5,9,14,14,1,1,16,30,9,6,45,361,42,51,454
"./Ship3_Latin-square/2019-09-30_12h51m_Subject 47632.txt","47632",2019-09-30,"12:51",77,60,10,7,17,26,1,1,28,20,10,13,43,507,6,104,617
"./Ship3_Latin-square/2019-09-30_12h51m_Subject 47634.txt","47634",2019-09-30,"12:51",76,60,5,11,16,40,5,10,55,16,3,11,30,366,28,82,476
"./Ship3_Latin-square/2019-09-30_12h51m_Subject 47640.txt","47640",2019-09-30,"12:51",80,59,9,12,21,54,7,9,70,30,12,5,47,364,23,104,491
"./Ship3_Latin-square/2019-09-30_12h51m_Subject 47754.txt","47754",2019-09-30,"12:51",72,52,11,9,20,36,5,2,43,110,13,34,157,294,68,39,401
"./Ship3_Latin-square/2019-09-30_12h51m_Subject 47800.txt","47800",2019-09-30,"12:51",77,60,3,14,17,31,3,7,41,42,7,10,59,370,25,92,487
"./Ship3_Latin-square/2019-09-30_12h54m_Subject 46880.txt","46880",2019-09-30,"12:54",78,60,6,12,18,6,0,0,6,29,0,2,31,873,69,210,1152
"./Ship3_Latin-square/2019-09-30_12h54m_Subject 46882.txt","46882",2019-09-30,"12:54",84,60,11,13,24,13,16,0,29,96,8,18,122,1110,249,281,1640
"./Ship3_Latin-square/2019-09-30_12h54m_Subject 46883.txt","46883",2019-09-30,"12:54",82,60,11,11,22,34,3,6,43,14,19,17,50,425,82,116,623
"./Ship3_Latin-square/2019-09-30_12h54m_Subject 46894.txt","46894",2019-09-30,"12:54",84,60,14,10,24,57,8,28,93,36,25,12,73,194,20,45,259
"./Ship3_Latin-square/2019-09-30_12h54m_Subject 46896.txt","46896",2019-09-30,"12:54",80,60,7,13,20,21,1,2,24,29,2,9,40,1034,143,241,1418
"./Ship3_Latin-square/2019-09-30_12h54m_Subject 47088.txt","47088",2019-09-30,"12:54",48,38,5,5,10,31,3,4,38,68,10,143,221,425,42,66,533
"./Ship3_Latin-square/2019-09-30_12h54m_Subject 47228.txt","47228",2019-09-30,"12:54",80,60,10,10,20,43,2,8,53,15,7,5,27,309,21,64,394
"./Ship3_Latin-square/2019-09-30_12h54m_Subject 47243.txt","47243",2019-09-30,"12:54",82,60,11,11,22,91,12,17,120,45,14,15,74,424,14,134,572
"./Ship3_Latin-square/2019-09-30_12h54m_Subject 47249.txt","47249",2019-09-30,"12:54",81,60,8,13,21,13,6,3,22,60,22,24,106,652,100,205,957
"./Ship3_Latin-square/2019-09-30_12h54m_Subject 47639.txt","47639",2019-09-30,"12:54",80,60,11,9,20,19,3,3,25,7,4,4,15,760,138,119,1017
"./Ship3_Latin-square/2019-09-30_12h54m_Subject 47649.txt","47649",2019-09-30,"12:54",80,60,7,13,20,29,8,6,43,7,3,2,12,583,67,166,816
"./Ship3_Latin-square/2019-09-30_12h54m_Subject 47753.txt","47753",2019-09-30,"12:54",80,60,10,10,20,58,27,15,100,40,28,9,77,386,32,77,495
"./Ship3_Latin-square/2019-09-30_12h54m_Subject 47758.txt","47758",2019-09-30,"12:54",82,60,11,11,22,9,1,1,11,15,0,16,31,945,181,259,1385
"./Ship3_Latin-square/2019-09-30_12h54m_Subject 47759.txt","47759",2019-09-30,"12:54",78,60,8,10,18,20,2,3,25,23,2,13,38,622,59,155,836
"./Ship3_Latin-square/2019-09-30_12h54m_Subject 47776.txt","47776",2019-09-30,"12:54",80,60,11,9,20,35,1,9,45,54,22,6,82,743,18,160,921
"./Ship3_Latin-square/2019-09-30_12h54m_Subject 47799.txt","47799",2019-09-30,"12:54",81,60,9,12,21,28,3,4,35,109,54,27,190,534,73,119,726
"./Ship3_Latin-square/2019-09-30_14h02m_Subject 46876.txt","46876",2019-09-30,"14:02",77,60,7,10,17,26,2,4,32,3,1,3,7,676,80,121,877
"./Ship3_Latin-square/2019-09-30_14h02m_Subject 46877.txt","46877",2019-09-30,"14:02",85,60,15,10,25,14,4,3,21,40,31,18,89,648,31,190,869
"./Ship3_Latin-square/2019-09-30_14h02m_Subject 46893.txt","46893",2019-09-30,"14:02",78,60,11,7,18,49,0,8,57,109,36,4,149,762,21,124,907
"./Ship3_Latin-square/2019-09-30_14h02m_Subject 46895.txt","46895",2019-09-30,"14:02",81,58,8,15,23,31,7,7,45,18,35,9,62,250,42,82,374
"./Ship3_Latin-square/2019-09-30_14h02m_Subject 47638.txt","47638",2019-09-30,"14:02",77,57,14,6,20,99,18,13,130,51,26,7,84,221,14,20,255
"./Ship3_Latin-square/2019-09-30_14h02m_Subject 47757.txt","47757",2019-09-30,"14:02",80,60,12,8,20,67,12,9,88,55,11,5,71,305,58,57,420
"./Ship3_Latin-square/2019-09-30_14h02m_Subject 47769.txt","47769",2019-09-30,"14:02",81,60,10,11,21,17,2,2,21,57,14,11,82,711,114,135,960
"./Ship3_Latin-square/2019-09-30_14h02m_Subject 47771.txt","47771",2019-09-30,"14:02",77,60,9,8,17,10,1,2,13,13,2,1,16,1143,167,168,1478
"./Ship3_Latin-square/2019-09-30_14h02m_Subject 47775.txt","47775",2019-09-30,"14:02",76,60,6,10,16,56,3,6,65,29,4,0,33,383,42,74,499
"./Ship3_Latin-square/2019-09-30_14h02m_Subject 47781.txt","47781",2019-09-30,"14:02",80,60,10,10,20,5,0,0,5,53,9,4,66,1330,281,238,1849
"./Ship3_Latin-square/2019-09-30_14h02m_Subject 47782.txt","47782",2019-09-30,"14:02",84,60,12,12,24,12,0,4,16,3,16,4,23,659,151,139,949
"./Ship3_Latin-square/2019-09-30_14h02m_Subject 47783.txt","47783",2019-09-30,"14:02",80,60,10,10,20,57,10,9,76,37,9,7,53,481,65,79,625
"./Ship3_Latin-square/2019-09-30_14h02m_Subject 47785.txt","47785",2019-09-30,"14:02",80,60,7,13,20,8,0,3,11,82,3,8,93,1903,287,324,2514
"./Ship3_Latin-square/2019-09-30_14h02m_Subject 47786.txt","47786",2019-09-30,"14:02",77,60,8,9,17,77,8,9,94,39,6,4,49,340,33,54,427
"./Ship3_Latin-square/2019-09-30_14h02m_Subject 47788.txt","47788",2019-09-30,"14:02",49,36,4,9,13,13,1,4,18,45,185,10,240,334,29,85,448
"./Ship3_Latin-square/2019-09-30_14h06m_Subject 46888.txt","46888",2019-09-30,"14:06",80,60,9,11,20,7,0,0,7,60,9,3,72,937,136,177,1250
"./Ship3_Latin-square/2019-09-30_14h06m_Subject 46889.txt","46889",2019-09-30,"14:06",77,60,4,13,17,10,0,2,12,20,2,19,41,1297,89,250,1636
"./Ship3_Latin-square/2019-09-30_14h06m_Subject 46890.txt","46890",2019-09-30,"14:06",82,59,10,13,23,33,2,2,37,1,1,4,6,365,93,75,533
"./Ship3_Latin-square/2019-09-30_14h06m_Subject 46892.txt","46892",2019-09-30,"14:06",76,53,15,8,23,70,18,58,146,47,28,7,82,310,22,57,389
"./Ship3_Latin-square/2019-09-30_14h06m_Subject 46898.txt","46898",2019-09-30,"14:06",75,60,6,9,15,34,0,5,39,24,2,5,31,701,65,81,847
"./Ship3_Latin-square/2019-09-30_14h06m_Subject 47097.txt","47097",2019-09-30,"14:06",83,60,10,13,23,19,2,1,22,54,14,9,77,1018,138,237,1393
"./Ship3_Latin-square/2019-09-30_14h06m_Subject 47099.txt","47099",2019-09-30,"14:06",81,60,15,6,21,60,13,3,76,33,36,16,85,549,5,72,626
"./Ship3_Latin-square/2019-09-30_14h06m_Subject 47798.txt","47798",2019-09-30,"14:06",67,48,13,6,19,43,8,4,55,16,16,2,34,124,1,33,158
"./Ship3_Latin-square/2019-09-30_15h13m_Subject 47080.txt","47080",2019-09-30,"15:13",81,60,7,14,21,9,0,2,11,22,2,4,28,1063,135,218,1416
"./Ship3_Latin-square/2019-09-30_15h13m_Subject 47089.txt","47089",2019-09-30,"15:13",82,60,13,9,22,28,2,2,32,70,16,18,104,375,71,49,495
"./Ship3_Latin-square/2019-09-30_15h13m_Subject 47762.txt","47762",2019-09-30,"15:13",67,49,13,5,18,49,11,10,70,37,21,6,64,148,9,19,176
"./Ship3_Latin-square/2019-09-30_15h13m_Subject 47791.txt","47791",2019-09-30,"15:13",82,60,6,16,22,11,0,3,14,12,1,5,18,1013,142,273,1428
"./Ship3_Latin-square/2019-10-01_10h03m_Subject 46884.txt","46884",2019-10-01,"10:03",70,52,11,7,18,46,8,6,60,41,13,1,55,207,29,23,259
"./Ship3_Latin-square/2019-10-01_10h03m_Subject 47083.txt","47083",2019-10-01,"10:03",79,59,6,14,20,59,1,12,72,33,8,15,56,376,32,94,502
"./Ship3_Latin-square/2019-10-01_10h03m_Subject 47086.txt","47086",2019-10-01,"10:03",79,60,10,9,19,17,4,0,21,1,0,1,2,483,74,89,646
"./Ship3_Latin-square/2019-10-01_10h03m_Subject 47246.txt","47246",2019-10-01,"10:03",77,60,7,10,17,7,4,3,14,11,1,0,12,455,49,88,592
"./Ship3_Latin-square/2019-10-01_10h03m_Subject 47635.txt","47635",2019-10-01,"10:03",86,60,13,13,26,82,6,26,114,43,16,14,73,280,1,129,410
"./Ship3_Latin-square/2019-10-01_10h03m_Subject 47779.txt","47779",2019-10-01,"10:03",37,27,7,3,10,61,7,7,75,24,21,3,48,36,7,4,47
"./Ship3_Latin-square/2019-10-01_10h03m_Subject 47790.txt","47790",2019-10-01,"10:03",60,43,11,6,17,58,10,39,107,25,11,3,39,189,26,13,228
"./Ship3_Latin-square/2019-10-01_10h03m_Subject 47797.txt","47797",2019-10-01,"10:03",77,55,10,12,22,35,10,15,60,47,27,9,83,231,60,85,376
"./Ship3_Latin-square/2019-10-01_10h06m_Subject 46878.txt","46878",2019-10-01,"10:06",80,60,9,11,20,11,2,3,16,4,11,8,23,846,140,147,1133
"./Ship3_Latin-square/2019-10-01_10h06m_Subject 46885.txt","46885",2019-10-01,"10:06",77,60,8,9,17,27,4,6,37,11,4,3,18,421,51,59,531
"./Ship3_Latin-square/2019-10-01_10h06m_Subject 46899.txt","46899",2019-10-01,"10:06",81,60,8,13,21,12,1,1,14,19,3,7,29,1069,150,250,1469
"./Ship3_Latin-square/2019-10-01_10h06m_Subject 47081.txt","47081",2019-10-01,"10:06",80,60,7,13,20,16,1,6,23,28,3,11,42,564,67,121,752
"./Ship3_Latin-square/2019-10-01_10h06m_Subject 47091.txt","47091",2019-10-01,"10:06",77,60,5,12,17,22,1,2,25,52,7,6,65,348,28,76,452
"./Ship3_Latin-square/2019-10-01_10h06m_Subject 47095.txt","47095",2019-10-01,"10:06",71,50,13,8,21,34,9,4,47,53,10,34,97,276,39,64,379
"./Ship3_Latin-square/2019-10-01_10h06m_Subject 47231.txt","47231",2019-10-01,"10:06",76,60,9,7,16,60,8,6,74,116,18,2,136,258,37,41,336
"./Ship3_Latin-square/2019-10-01_10h06m_Subject 47238.txt","47238",2019-10-01,"10:06",81,60,10,11,21,13,1,0,14,41,13,10,64,664,120,102,886
"./Ship3_Latin-square/2019-10-01_10h06m_Subject 47242.txt","47242",2019-10-01,"10:06",80,60,6,14,20,28,2,9,39,24,5,36,65,636,66,165,867
"./Ship3_Latin-square/2019-10-01_10h06m_Subject 47244.txt","47244",2019-10-01,"10:06",78,60,7,11,18,11,1,0,12,58,10,11,79,741,100,151,992
"./Ship3_Latin-square/2019-10-01_10h06m_Subject 47633.txt","47633",2019-10-01,"10:06",80,60,12,8,20,28,23,5,56,55,21,10,86,466,64,77,607
"./Ship3_Latin-square/2019-10-01_10h06m_Subject 47636.txt","47636",2019-10-01,"10:06",52,38,12,2,14,101,31,6,138,100,28,2,130,140,19,7,166
"./Ship3_Latin-square/2019-10-01_10h06m_Subject 47752.txt","47752",2019-10-01,"10:06",80,60,9,11,20,45,5,4,54,16,9,8,33,939,119,205,1263
"./Ship3_Latin-square/2019-10-01_10h06m_Subject 47767.txt","47767",2019-10-01,"10:06",83,60,10,13,23,25,0,2,27,70,6,9,85,371,77,73,521
"./Ship3_Latin-square/2019-10-01_10h06m_Subject 47768.txt","47768",2019-10-01,"10:06",73,53,12,8,20,67,11,12,90,48,19,10,77,153,5,36,194
"./Ship3_Latin-square/2019-10-01_10h06m_Subject 47780.txt","47780",2019-10-01,"10:06",79,60,8,11,19,54,13,5,72,79,12,8,99,251,18,95,364
"./Ship3_Latin-square/2019-10-01_11h15m_Subject 46900.txt","46900",2019-10-01,"11:15",79,60,5,14,19,6,0,3,9,111,11,23,145,1127,108,311,1546
"./Ship3_Latin-square/2019-10-01_11h15m_Subject 46986.txt","46986",2019-10-01,"11:15",80,60,11,9,20,40,1,9,50,16,2,2,20,311,43,50,404
"./Ship3_Latin-square/2019-10-01_11h15m_Subject 47076.txt","47076",2019-10-01,"11:15",81,60,9,12,21,4,0,2,6,15,0,3,18,1289,208,275,1772
"./Ship3_Latin-square/2019-10-01_11h15m_Subject 47079.txt","47079",2019-10-01,"11:15",75,60,8,7,15,21,3,2,26,45,12,4,61,321,57,23,401
"./Ship3_Latin-square/2019-10-01_11h15m_Subject 47082.txt","47082",2019-10-01,"11:15",79,60,8,11,19,38,2,1,41,24,5,14,43,293,36,56,385
"./Ship3_Latin-square/2019-10-01_11h15m_Subject 47092.txt","47092",2019-10-01,"11:15",80,60,9,11,20,17,5,2,24,25,5,2,32,979,160,189,1328
"./Ship3_Latin-square/2019-10-01_11h15m_Subject 47098.txt","47098",2019-10-01,"11:15",86,60,12,14,26,18,4,1,23,11,45,21,77,369,57,112,538
"./Ship3_Latin-square/2019-10-01_11h15m_Subject 47226.txt","47226",2019-10-01,"11:15",79,60,8,11,19,14,1,0,15,35,8,11,54,2970,423,408,3801
"./Ship3_Latin-square/2019-10-01_11h15m_Subject 47227.txt","47227",2019-10-01,"11:15",79,60,4,15,19,30,1,5,36,12,3,8,23,502,60,114,676
"./Ship3_Latin-square/2019-10-01_11h15m_Subject 47250.txt","47250",2019-10-01,"11:15",80,60,8,12,20,17,3,1,21,7,5,5,17,1045,147,230,1422
"./Ship3_Latin-square/2019-10-01_11h15m_Subject 47645.txt","47645",2019-10-01,"11:15",79,58,11,10,21,71,10,17,98,15,13,5,33,286,42,73,401
"./Ship3_Latin-square/2019-10-01_11h15m_Subject 47646.txt","47646",2019-10-01,"11:15",79,60,5,14,19,27,0,0,27,54,16,22,92,1890,116,357,2363
"./Ship3_Latin-square/2019-10-01_11h15m_Subject 47755.txt","47755",2019-10-01,"11:15",82,60,12,10,22,25,5,6,36,33,18,7,58,742,136,112,990
"./Ship3_Latin-square/2019-10-01_11h15m_Subject 47760.txt","47760",2019-10-01,"11:15",80,60,9,11,20,15,6,3,24,28,15,8,51,1051,141,219,1411
"./Ship3_Latin-square/2019-10-01_11h15m_Subject 47770.txt","47770",2019-10-01,"11:15",44,33,7,4,11,53,10,7,70,73,9,2,84,129,22,13,164
"./Ship3_Latin-square/2019-10-01_11h15m_Subject 47795.txt","47795",2019-10-01,"11:15",81,60,8,13,21,25,3,3,31,21,15,11,47,485,44,86,615
"./Ship3_Latin-square/2019-10-01_11h19m_Subject 47229.txt","47229",2019-10-01,"11:19",75,60,3,12,15,16,1,0,17,26,1,1,28,1011,33,177,1221
"./Ship3_Latin-square/2019-10-01_11h19m_Subject 47233.txt","47233",2019-10-01,"11:19",82,60,10,12,22,14,3,7,24,35,10,8,53,415,71,86,572
"./Ship3_Latin-square/2019-10-01_11h19m_Subject 47234.txt","47234",2019-10-01,"11:19",82,60,13,9,22,40,3,5,48,26,11,6,43,523,89,96,708
"./Ship3_Latin-square/2019-10-01_11h19m_Subject 47237.txt","47237",2019-10-01,"11:19",78,60,8,10,18,10,0,3,13,13,0,17,30,795,106,154,1055
"./Ship3_Latin-square/2019-10-01_11h19m_Subject 47241.txt","47241",2019-10-01,"11:19",79,60,8,11,19,15,1,5,21,7,11,1,19,1049,144,157,1350
"./Ship3_Latin-square/2019-10-01_11h19m_Subject 47247.txt","47247",2019-10-01,"11:19",78,60,9,9,18,18,1,0,19,26,1,0,27,397,62,57,516
"./Ship3_Latin-square/2019-10-01_11h19m_Subject 47777.txt","47777",2019-10-01,"11:19",77,60,5,12,17,36,2,33,71,66,14,7,87,453,23,89,565
"./Ship3_Latin-square/2019-10-01_11h19m_Subject 47784.txt","47784",2019-10-01,"11:19",76,60,3,13,16,26,5,7,38,67,1,25,93,1441,124,246,1811
"./Ship3_Latin-square/2019-10-01_12h26m_Subject 46881.txt","46881",2019-10-01,"12:26",74,60,4,10,14,7,3,0,10,43,4,4,51,1018,72,201,1291
"./Ship3_Latin-square/2019-10-01_12h26m_Subject 47087.txt","47087",2019-10-01,"12:26",81,60,9,12,21,28,2,2,32,29,12,5,46,358,49,67,474
"./Ship3_Latin-square/2019-10-01_12h26m_Subject 47626.txt","47626",2019-10-01,"12:26",80,60,6,14,20,11,0,3,14,56,10,6,72,310,36,93,439
"./Ship3_Latin-square/2019-10-01_12h26m_Subject 47632.txt","47632",2019-10-01,"12:26",80,60,7,13,20,20,1,6,27,15,6,8,29,1097,127,224,1448
"./Ship3_Latin-square/2019-10-01_12h26m_Subject 47634.txt","47634",2019-10-01,"12:26",81,60,11,10,21,36,5,6,47,25,4,1,30,384,67,55,506
"./Ship3_Latin-square/2019-10-01_12h26m_Subject 47640.txt","47640",2019-10-01,"12:26",81,60,10,11,21,30,4,6,40,12,6,7,25,622,69,119,810
"./Ship3_Latin-square/2019-10-01_12h26m_Subject 47800.txt","47800",2019-10-01,"12:26",82,60,8,14,22,43,6,6,55,42,7,15,64,304,38,57,399
"./Ship3_Latin-square/2019-10-01_12h32m_Subject 46880.txt","46880",2019-10-01,"12:32",81,60,2,19,21,15,0,0,15,15,0,15,30,964,27,299,1290
"./Ship3_Latin-square/2019-10-01_12h32m_Subject 46882.txt","46882",2019-10-01,"12:32",80,60,6,14,20,27,1,1,29,80,4,41,125,857,101,270,1228
"./Ship3_Latin-square/2019-10-01_12h32m_Subject 46883.txt","46883",2019-10-01,"12:32",80,60,7,13,20,25,2,1,28,18,4,6,28,607,65,134,806
"./Ship3_Latin-square/2019-10-01_12h32m_Subject 46894.txt","46894",2019-10-01,"12:32",80,60,9,11,20,31,2,4,37,14,2,5,21,533,95,79,707
"./Ship3_Latin-square/2019-10-01_12h32m_Subject 46896.txt","46896",2019-10-01,"12:32",76,60,8,8,16,22,3,4,29,28,18,7,53,476,14,101,591
"./Ship3_Latin-square/2019-10-01_12h32m_Subject 47088.txt","47088",2019-10-01,"12:32",78,60,9,9,18,41,7,12,60,82,22,20,124,390,69,90,549
"./Ship3_Latin-square/2019-10-01_12h32m_Subject 47228.txt","47228",2019-10-01,"12:32",77,60,9,8,17,20,0,4,24,18,7,6,31,532,96,76,704
"./Ship3_Latin-square/2019-10-01_12h32m_Subject 47243.txt","47243",2019-10-01,"12:32",78,60,9,9,18,27,7,4,38,28,10,4,42,918,126,173,1217
"./Ship3_Latin-square/2019-10-01_12h32m_Subject 47249.txt","47249",2019-10-01,"12:32",78,60,11,7,18,58,3,14,75,69,36,14,119,245,34,33,312
"./Ship3_Latin-square/2019-10-01_12h32m_Subject 47639.txt","47639",2019-10-01,"12:32",62,48,10,4,14,63,7,6,76,59,22,6,87,194,4,10,208
"./Ship3_Latin-square/2019-10-01_12h32m_Subject 47649.txt","47649",2019-10-01,"12:32",77,58,7,12,19,51,3,4,58,12,6,5,23,431,36,155,622
"./Ship3_Latin-square/2019-10-01_12h32m_Subject 47753.txt","47753",2019-10-01,"12:32",82,60,11,11,22,40,29,7,76,22,7,7,36,474,57,138,669
"./Ship3_Latin-square/2019-10-01_12h32m_Subject 47758.txt","47758",2019-10-01,"12:32",85,60,14,11,25,8,0,2,10,18,3,4,25,790,92,201,1083
"./Ship3_Latin-square/2019-10-01_12h32m_Subject 47759.txt","47759",2019-10-01,"12:32",81,60,14,7,21,60,11,1,72,48,19,4,71,396,34,119,549
"./Ship3_Latin-square/2019-10-01_12h32m_Subject 47776.txt","47776",2019-10-01,"12:32",81,60,12,9,21,14,4,1,19,52,18,9,79,1044,180,173,1397
"./Ship3_Latin-square/2019-10-01_12h32m_Subject 47799.txt","47799",2019-10-01,"12:32",78,57,10,11,21,55,8,12,75,79,34,13,126,140,16,39,195
"./Ship3_Latin-square/2019-10-01_13h39m_Subject 46888.txt","46888",2019-10-01,"13:39",80,60,9,11,20,8,0,4,12,57,17,8,82,752,123,135,1010
"./Ship3_Latin-square/2019-10-01_13h39m_Subject 46889.txt","46889",2019-10-01,"13:39",80,60,5,15,20,11,0,1,12,15,0,12,27,1005,102,276,1383
"./Ship3_Latin-square/2019-10-01_13h39m_Subject 46890.txt","46890",2019-10-01,"13:39",83,60,14,9,23,51,2,5,58,12,2,6,20,181,2,53,236
"./Ship3_Latin-square/2019-10-01_13h39m_Subject 46892.txt","46892",2019-10-01,"13:39",78,60,5,13,18,11,1,1,13,3,0,2,5,939,69,224,1232
"./Ship3_Latin-square/2019-10-01_13h39m_Subject 46898.txt","46898",2019-10-01,"13:39",84,59,14,11,25,46,9,5,60,35,8,7,50,467,60,67,594
"./Ship3_Latin-square/2019-10-01_13h39m_Subject 47097.txt","47097",2019-10-01,"13:39",78,60,8,10,18,10,0,0,10,57,11,10,78,866,129,128,1123
"./Ship3_Latin-square/2019-10-01_13h39m_Subject 47099.txt","47099",2019-10-01,"13:39",79,60,9,10,19,5,2,1,8,86,9,11,106,1185,151,208,1544
"./Ship3_Latin-square/2019-10-01_13h39m_Subject 47798.txt","47798",2019-10-01,"13:39",81,60,8,13,21,17,3,5,25,15,5,1,21,247,27,44,318
"./Ship3_Latin-square/2019-10-01_13h42m_Subject 46876.txt","46876",2019-10-01,"13:42",75,60,5,10,15,15,0,1,16,9,2,6,17,883,78,130,1091
"./Ship3_Latin-square/2019-10-01_13h42m_Subject 46877.txt","46877",2019-10-01,"13:42",80,60,10,10,20,19,5,2,26,47,18,8,73,1193,187,244,1624
"./Ship3_Latin-square/2019-10-01_13h42m_Subject 46893.txt","46893",2019-10-01,"13:42",75,60,7,8,15,9,0,1,10,76,13,9,98,1437,158,194,1789
"./Ship3_Latin-square/2019-10-01_13h42m_Subject 46895.txt","46895",2019-10-01,"13:42",82,60,12,10,22,36,6,8,50,18,5,4,27,166,43,27,236
"./Ship3_Latin-square/2019-10-01_13h42m_Subject 47638.txt","47638",2019-10-01,"13:42",78,60,11,7,18,52,8,3,63,22,4,1,27,425,65,43,533
"./Ship3_Latin-square/2019-10-01_13h42m_Subject 47757.txt","47757",2019-10-01,"13:42",60,45,10,5,15,96,22,8,126,64,34,5,103,185,32,35,252
"./Ship3_Latin-square/2019-10-01_13h42m_Subject 47769.txt","47769",2019-10-01,"13:42",87,60,17,10,27,98,10,26,134,56,37,17,110,424,21,55,500
"./Ship3_Latin-square/2019-10-01_13h42m_Subject 47771.txt","47771",2019-10-01,"13:42",83,60,13,10,23,33,5,10,48,33,23,28,84,399,7,87,493
"./Ship3_Latin-square/2019-10-01_13h42m_Subject 47775.txt","47775",2019-10-01,"13:42",81,60,13,8,21,109,30,20,159,70,16,5,91,205,8,45,258
"./Ship3_Latin-square/2019-10-01_13h42m_Subject 47781.txt","47781",2019-10-01,"13:42",82,60,9,13,22,8,0,0,8,39,12,14,65,1214,191,355,1760
"./Ship3_Latin-square/2019-10-01_13h42m_Subject 47782.txt","47782",2019-10-01,"13:42",82,60,10,12,22,15,1,2,18,4,4,1,9,600,61,106,767
"./Ship3_Latin-square/2019-10-01_13h42m_Subject 47783.txt","47783",2019-10-01,"13:42",81,60,9,12,21,47,13,12,72,48,6,8,62,846,90,216,1152
"./Ship3_Latin-square/2019-10-01_13h42m_Subject 47785.txt","47785",2019-10-01,"13:42",82,60,10,12,22,26,0,2,28,49,21,32,102,1604,250,255,2109
"./Ship3_Latin-square/2019-10-01_13h42m_Subject 47786.txt","47786",2019-10-01,"13:42",81,60,13,8,21,77,10,7,94,68,19,3,90,161,14,35,210
"./Ship3_Latin-square/2019-10-01_13h42m_Subject 47788.txt","47788",2019-10-01,"13:42",79,60,8,11,19,63,4,11,78,61,20,15,96,361,47,87,495
"./Ship3_Latin-square/2019-10-01_14h44m_Subject 47080.txt","47080",2019-10-01,"14:44",80,60,9,11,20,11,0,1,12,20,28,3,51,904,141,138,1183
"./Ship3_Latin-square/2019-10-01_14h44m_Subject 47089.txt","47089",2019-10-01,"14:44",80,60,9,11,20,22,1,1,24,52,8,16,76,489,72,109,670
"./Ship3_Latin-square/2019-10-01_14h44m_Subject 47762.txt","47762",2019-10-01,"14:44",79,60,10,9,19,35,2,3,40,21,4,1,26,303,36,70,409
"./Ship3_Latin-square/2019-10-01_14h44m_Subject 47791.txt","47791",2019-10-01,"14:44",80,60,7,13,20,4,0,0,4,21,17,2,40,890,114,186,1190
"./Ship3_Latin-square/2019-10-02_10h08m_Subject 46878.txt","46878",2019-10-02,"10:08",77,60,6,11,17,8,0,1,9,8,5,7,20,1102,112,170,1384
"./Ship3_Latin-square/2019-10-02_10h08m_Subject 46885.txt","46885",2019-10-02,"10:08",78,60,8,10,18,56,4,4,64,25,8,2,35,330,35,51,416
"./Ship3_Latin-square/2019-10-02_10h08m_Subject 46899.txt","46899",2019-10-02,"10:08",78,60,8,10,18,6,0,2,8,26,13,3,42,847,132,171,1150
"./Ship3_Latin-square/2019-10-02_10h08m_Subject 47081.txt","47081",2019-10-02,"10:08",81,60,12,9,21,17,5,6,28,26,12,19,57,527,38,93,658
"./Ship3_Latin-square/2019-10-02_10h08m_Subject 47091.txt","47091",2019-10-02,"10:08",82,60,9,13,22,13,1,1,15,62,13,11,86,336,49,72,457
"./Ship3_Latin-square/2019-10-02_10h08m_Subject 47095.txt","47095",2019-10-02,"10:08",80,59,13,8,21,27,7,5,39,31,15,27,73,323,62,58,443
"./Ship3_Latin-square/2019-10-02_10h08m_Subject 47231.txt","47231",2019-10-02,"10:08",80,60,4,16,20,57,4,15,76,29,3,6,38,358,25,95,478
"./Ship3_Latin-square/2019-10-02_10h08m_Subject 47238.txt","47238",2019-10-02,"10:08",82,60,11,11,22,9,0,2,11,43,13,13,69,485,84,100,669
"./Ship3_Latin-square/2019-10-02_10h08m_Subject 47242.txt","47242",2019-10-02,"10:08",80,60,6,14,20,28,2,6,36,25,6,8,39,694,93,187,974
"./Ship3_Latin-square/2019-10-02_10h08m_Subject 47244.txt","47244",2019-10-02,"10:08",84,60,10,14,24,14,1,5,20,73,18,22,113,853,140,199,1192
"./Ship3_Latin-square/2019-10-02_10h08m_Subject 47633.txt","47633",2019-10-02,"10:08",78,60,8,10,18,44,2,3,49,52,11,12,75,513,70,81,664
"./Ship3_Latin-square/2019-10-02_10h08m_Subject 47636.txt","47636",2019-10-02,"10:08",79,60,5,14,19,51,3,15,69,72,10,26,108,310,38,50,398
"./Ship3_Latin-square/2019-10-02_10h08m_Subject 47752.txt","47752",2019-10-02,"10:08",82,60,10,12,22,36,7,7,50,29,35,5,69,548,128,94,770
"./Ship3_Latin-square/2019-10-02_10h08m_Subject 47767.txt","47767",2019-10-02,"10:08",84,60,13,11,24,14,4,5,23,64,18,7,89,317,91,59,467
"./Ship3_Latin-square/2019-10-02_10h08m_Subject 47768.txt","47768",2019-10-02,"10:08",84,60,11,13,24,24,8,9,41,23,7,21,51,409,77,169,655
"./Ship3_Latin-square/2019-10-02_10h08m_Subject 47780.txt","47780",2019-10-02,"10:08",82,60,11,11,22,65,10,19,94,37,12,6,55,328,11,133,472
"./Ship3_Latin-square/2019-10-02_10h22m_Subject 46884.txt","46884",2019-10-02,"10:22",78,60,8,10,18,32,0,2,34,32,7,3,42,275,44,32,351
"./Ship3_Latin-square/2019-10-02_10h22m_Subject 47083.txt","47083",2019-10-02,"10:22",80,60,5,15,20,70,16,8,94,26,2,13,41,357,24,109,490
"./Ship3_Latin-square/2019-10-02_10h22m_Subject 47086.txt","47086",2019-10-02,"10:22",77,60,9,8,17,22,5,2,29,9,3,0,12,629,83,87,799
"./Ship3_Latin-square/2019-10-02_10h22m_Subject 47246.txt","47246",2019-10-02,"10:22",80,60,7,13,20,32,1,5,38,12,2,6,20,363,54,98,515
"./Ship3_Latin-square/2019-10-02_10h22m_Subject 47635.txt","47635",2019-10-02,"10:22",78,60,9,9,18,28,6,2,36,44,11,4,59,432,74,80,586
"./Ship3_Latin-square/2019-10-02_10h22m_Subject 47779.txt","47779",2019-10-02,"10:22",57,44,6,7,13,58,10,9,77,63,12,10,85,84,13,15,112
"./Ship3_Latin-square/2019-10-02_10h22m_Subject 47790.txt","47790",2019-10-02,"10:22",56,40,9,7,16,57,7,74,138,32,10,7,49,105,35,18,158
"./Ship3_Latin-square/2019-10-02_10h22m_Subject 47797.txt","47797",2019-10-02,"10:22",73,55,12,6,18,63,12,6,81,40,18,5,63,181,30,19,230
"./Ship3_Latin-square/2019-10-02_11h25m_Subject 46900.txt","46900",2019-10-02,"11:25",74,60,6,8,14,7,0,0,7,65,4,34,103,1386,100,223,1709
"./Ship3_Latin-square/2019-10-02_11h25m_Subject 46986.txt","46986",2019-10-02,"11:25",67,49,8,10,18,41,3,7,51,12,6,4,22,193,26,36,255
"./Ship3_Latin-square/2019-10-02_11h25m_Subject 47076.txt","47076",2019-10-02,"11:25",79,60,8,11,19,5,1,1,7,11,6,2,19,1094,123,211,1428
"./Ship3_Latin-square/2019-10-02_11h25m_Subject 47079.txt","47079",2019-10-02,"11:25",76,60,6,10,16,11,1,2,14,52,9,7,68,434,56,86,576
"./Ship3_Latin-square/2019-10-02_11h25m_Subject 47082.txt","47082",2019-10-02,"11:25",84,60,11,13,24,27,2,5,34,22,0,28,50,306,50,88,444
"./Ship3_Latin-square/2019-10-02_11h25m_Subject 47092.txt","47092",2019-10-02,"11:25",79,60,9,10,19,19,1,2,22,47,4,5,56,1028,140,176,1344
"./Ship3_Latin-square/2019-10-02_11h25m_Subject 47098.txt","47098",2019-10-02,"11:25",82,60,9,13,22,10,4,0,14,8,0,0,8,460,75,102,637
"./Ship3_Latin-square/2019-10-02_11h25m_Subject 47226.txt","47226",2019-10-02,"11:25",80,60,9,11,20,11,2,0,13,55,12,13,80,2595,546,543,3684
"./Ship3_Latin-square/2019-10-02_11h25m_Subject 47227.txt","47227",2019-10-02,"11:25",79,60,4,15,19,51,1,4,56,16,6,7,29,496,21,138,655
"./Ship3_Latin-square/2019-10-02_11h25m_Subject 47250.txt","47250",2019-10-02,"11:25",85,60,10,15,25,15,1,2,18,23,12,10,45,959,199,236,1394
"./Ship3_Latin-square/2019-10-02_11h25m_Subject 47645.txt","47645",2019-10-02,"11:25",74,53,9,12,21,105,12,12,129,8,3,6,17,221,47,82,350
"./Ship3_Latin-square/2019-10-02_11h25m_Subject 47646.txt","47646",2019-10-02,"11:25",81,60,9,12,21,18,1,2,21,88,28,24,140,1395,206,292,1893
"./Ship3_Latin-square/2019-10-02_11h25m_Subject 47755.txt","47755",2019-10-02,"11:25",80,60,7,13,20,30,3,5,38,55,23,8,86,651,64,201,916
"./Ship3_Latin-square/2019-10-02_11h25m_Subject 47760.txt","47760",2019-10-02,"11:25",79,60,9,10,19,21,2,2,25,32,17,20,69,1020,197,136,1353
"./Ship3_Latin-square/2019-10-02_11h25m_Subject 47770.txt","47770",2019-10-02,"11:25",55,41,6,8,14,117,8,6,131,42,7,14,63,164,20,27,211
"./Ship3_Latin-square/2019-10-02_11h25m_Subject 47795.txt","47795",2019-10-02,"11:25",79,60,7,12,19,28,7,6,41,40,8,23,71,520,30,127,677
"./Ship3_Latin-square/2019-10-02_11h29m_Subject 47229.txt","47229",2019-10-02,"11:29",78,60,7,11,18,11,4,2,17,35,6,8,49,898,101,146,1145
"./Ship3_Latin-square/2019-10-02_11h29m_Subject 47233.txt","47233",2019-10-02,"11:29",78,60,6,12,18,31,3,0,34,36,6,7,49,442,36,105,583
"./Ship3_Latin-square/2019-10-02_11h29m_Subject 47234.txt","47234",2019-10-02,"11:29",81,60,14,7,21,27,5,5,37,41,15,8,64,585,140,90,815
"./Ship3_Latin-square/2019-10-02_11h29m_Subject 47237.txt","47237",2019-10-02,"11:29",73,53,11,9,20,63,9,29,101,77,8,36,121,282,8,57,347
"./Ship3_Latin-square/2019-10-02_11h29m_Subject 47241.txt","47241",2019-10-02,"11:29",80,60,10,10,20,18,2,4,24,6,9,0,15,691,58,174,923
"./Ship3_Latin-square/2019-10-02_11h29m_Subject 47247.txt","47247",2019-10-02,"11:29",74,60,7,7,14,18,2,2,22,17,2,3,22,336,28,53,417
"./Ship3_Latin-square/2019-10-02_11h29m_Subject 47777.txt","47777",2019-10-02,"11:29",80,60,7,13,20,66,5,16,87,40,4,13,57,277,29,60,366
"./Ship3_Latin-square/2019-10-02_11h29m_Subject 47784.txt","47784",2019-10-02,"11:29",77,60,8,9,17,35,3,3,41,73,19,22,114,1199,170,153,1522
"./Ship3_Latin-square/2019-10-02_12h36m_Subject 46880.txt","46880",2019-10-02,"12:36",82,60,4,18,22,6,1,2,9,7,1,4,12,781,31,236,1048
"./Ship3_Latin-square/2019-10-02_12h36m_Subject 46882.txt","46882",2019-10-02,"12:36",67,51,12,4,16,64,18,2,84,38,36,3,77,234,10,24,268
"./Ship3_Latin-square/2019-10-02_12h36m_Subject 46883.txt","46883",2019-10-02,"12:36",75,60,5,10,15,16,1,0,17,26,13,6,45,660,49,109,818
"./Ship3_Latin-square/2019-10-02_12h36m_Subject 46894.txt","46894",2019-10-02,"12:36",84,60,13,11,24,88,14,10,112,18,35,3,56,272,36,52,360
"./Ship3_Latin-square/2019-10-02_12h36m_Subject 46896.txt","46896",2019-10-02,"12:36",81,60,6,15,21,23,2,2,27,32,6,11,49,985,81,259,1325
"./Ship3_Latin-square/2019-10-02_12h36m_Subject 47088.txt","47088",2019-10-02,"12:36",79,60,9,10,19,19,2,2,23,38,12,9,59,778,96,185,1059
"./Ship3_Latin-square/2019-10-02_12h36m_Subject 47228.txt","47228",2019-10-02,"12:36",79,60,9,10,19,18,2,4,24,9,3,0,12,552,58,123,733
"./Ship3_Latin-square/2019-10-02_12h36m_Subject 47243.txt","47243",2019-10-02,"12:36",83,60,13,10,23,64,8,8,80,64,50,12,126,577,81,103,761
"./Ship3_Latin-square/2019-10-02_12h36m_Subject 47249.txt","47249",2019-10-02,"12:36",81,60,12,9,21,37,6,7,50,50,27,7,84,388,79,70,537
"./Ship3_Latin-square/2019-10-02_12h36m_Subject 47639.txt","47639",2019-10-02,"12:36",85,60,11,14,25,15,3,1,19,9,9,1,19,716,77,222,1015
"./Ship3_Latin-square/2019-10-02_12h36m_Subject 47649.txt","47649",2019-10-02,"12:36",81,60,9,12,21,22,5,6,33,20,1,3,24,429,84,96,609
"./Ship3_Latin-square/2019-10-02_12h36m_Subject 47753.txt","47753",2019-10-02,"12:36",82,60,13,9,22,84,9,17,110,41,28,16,85,433,38,60,531
"./Ship3_Latin-square/2019-10-02_12h36m_Subject 47758.txt","47758",2019-10-02,"12:36",81,60,11,10,21,11,4,0,15,56,57,0,113,875,165,154,1194
"./Ship3_Latin-square/2019-10-02_12h36m_Subject 47759.txt","47759",2019-10-02,"12:36",79,60,10,9,19,27,5,7,39,54,7,20,81,506,48,123,677
"./Ship3_Latin-square/2019-10-02_12h36m_Subject 47776.txt","47776",2019-10-02,"12:36",82,60,9,13,22,19,0,6,25,47,22,9,78,918,77,260,1255
"./Ship3_Latin-square/2019-10-02_12h36m_Subject 47799.txt","47799",2019-10-02,"12:36",84,60,12,12,24,23,0,8,31,56,31,13,100,473,97,136,706
"./Ship3_Latin-square/2019-10-02_12h41m_Subject 46881.txt","46881",2019-10-02,"12:41",79,60,7,12,19,17,0,1,18,48,18,18,84,980,71,222,1273
"./Ship3_Latin-square/2019-10-02_12h41m_Subject 47087.txt","47087",2019-10-02,"12:41",76,60,6,10,16,20,1,1,22,35,6,2,43,394,51,54,499
"./Ship3_Latin-square/2019-10-02_12h41m_Subject 47626.txt","47626",2019-10-02,"12:41",82,60,4,18,22,17,0,6,23,30,1,13,44,273,30,89,392
"./Ship3_Latin-square/2019-10-02_12h41m_Subject 47632.txt","47632",2019-10-02,"12:41",78,60,10,8,18,27,2,1,30,11,5,4,20,780,88,151,1019
"./Ship3_Latin-square/2019-10-02_12h41m_Subject 47634.txt","47634",2019-10-02,"12:41",84,60,9,15,24,25,6,7,38,14,4,17,35,356,34,118,508
"./Ship3_Latin-square/2019-10-02_12h41m_Subject 47640.txt","47640",2019-10-02,"12:41",79,60,11,8,19,29,8,3,40,16,8,2,26,469,69,82,620
"./Ship3_Latin-square/2019-10-02_12h41m_Subject 47754.txt","47754",2019-10-02,"12:41",74,54,9,11,20,38,4,10,52,63,6,27,96,264,36,84,384
"./Ship3_Latin-square/2019-10-02_12h41m_Subject 47800.txt","47800",2019-10-02,"12:41",78,60,8,10,18,56,6,9,71,74,16,15,105,160,7,51,218
"./Ship3_Latin-square/2019-10-02_14h02m_Subject 46876.txt","46876",2019-10-02,"14:02",79,60,8,11,19,24,2,1,27,2,1,2,5,678,64,151,893
"./Ship3_Latin-square/2019-10-02_14h02m_Subject 46877.txt","46877",2019-10-02,"14:02",85,60,13,12,25,3,2,1,6,28,11,21,60,1340,326,354,2020
"./Ship3_Latin-square/2019-10-02_14h02m_Subject 46893.txt","46893",2019-10-02,"14:02",79,60,8,11,19,8,0,4,12,94,18,7,119,1101,112,261,1474
"./Ship3_Latin-square/2019-10-02_14h02m_Subject 46895.txt","46895",2019-10-02,"14:02",85,59,10,16,26,42,10,8,60,23,30,11,64,176,59,68,303
"./Ship3_Latin-square/2019-10-02_14h02m_Subject 47638.txt","47638",2019-10-02,"14:02",80,60,15,5,20,99,14,10,123,39,15,0,54,271,37,17,325
"./Ship3_Latin-square/2019-10-02_14h02m_Subject 47757.txt","47757",2019-10-02,"14:02",70,48,15,7,22,86,21,7,114,37,29,31,97,221,74,43,338
"./Ship3_Latin-square/2019-10-02_14h02m_Subject 47769.txt","47769",2019-10-02,"14:02",84,60,12,12,24,21,6,1,28,44,13,11,68,804,172,215,1191
"./Ship3_Latin-square/2019-10-02_14h02m_Subject 47771.txt","47771",2019-10-02,"14:02",80,60,8,12,20,13,1,0,14,7,1,0,8,940,103,198,1241
"./Ship3_Latin-square/2019-10-02_14h02m_Subject 47775.txt","47775",2019-10-02,"14:02",81,60,8,13,21,33,4,9,46,15,10,3,28,520,74,118,712
"./Ship3_Latin-square/2019-10-02_14h02m_Subject 47781.txt","47781",2019-10-02,"14:02",84,60,11,13,24,26,3,2,31,52,14,10,76,536,17,210,763
"./Ship3_Latin-square/2019-10-02_14h02m_Subject 47782.txt","47782",2019-10-02,"14:02",78,60,8,10,18,24,0,1,25,15,3,4,22,543,85,110,738
"./Ship3_Latin-square/2019-10-02_14h02m_Subject 47783.txt","47783",2019-10-02,"14:02",82,60,13,9,22,71,10,14,95,50,5,12,67,309,16,57,382
"./Ship3_Latin-square/2019-10-02_14h02m_Subject 47785.txt","47785",2019-10-02,"14:02",83,60,13,10,23,31,2,14,47,45,19,20,84,653,19,196,868
"./Ship3_Latin-square/2019-10-02_14h02m_Subject 47786.txt","47786",2019-10-02,"14:02",58,46,10,2,12,62,7,3,72,39,10,1,50,86,3,7,96
"./Ship3_Latin-square/2019-10-02_14h02m_Subject 47788.txt","47788",2019-10-02,"14:02",79,60,8,11,19,23,2,5,30,57,11,6,74,783,96,165,1044
"./Ship3_Latin-square/2019-10-02_14h06m_Subject 46888.txt","46888",2019-10-02,"14:06",83,60,15,8,23,40,10,1,51,59,44,14,117,335,21,51,407
"./Ship3_Latin-square/2019-10-02_14h06m_Subject 46889.txt","46889",2019-10-02,"14:06",79,60,8,11,19,12,1,1,14,11,1,2,14,1035,184,186,1405
"./Ship3_Latin-square/2019-10-02_14h06m_Subject 46890.txt","46890",2019-10-02,"14:06",83,60,10,13,23,20,3,5,28,7,0,10,17,382,86,107,575
"./Ship3_Latin-square/2019-10-02_14h06m_Subject 46892.txt","46892",2019-10-02,"14:06",83,60,12,11,23,23,3,11,37,40,23,10,73,627,91,114,832
"./Ship3_Latin-square/2019-10-02_14h06m_Subject 46898.txt","46898",2019-10-02,"14:06",77,60,7,10,17,27,4,4,35,51,12,15,78,326,27,141,494
"./Ship3_Latin-square/2019-10-02_14h06m_Subject 47097.txt","47097",2019-10-02,"14:06",83,60,9,14,23,11,1,1,13,48,10,11,69,929,137,219,1285
"./Ship3_Latin-square/2019-10-02_14h06m_Subject 47099.txt","47099",2019-10-02,"14:06",80,60,10,10,20,18,3,6,27,25,22,14,61,884,103,157,1144
"./Ship3_Latin-square/2019-10-02_14h06m_Subject 47798.txt","47798",2019-10-02,"14:06",76,60,6,10,16,24,1,1,26,11,4,3,18,211,27,68,306
"./Ship3_Latin-square/2019-10-02_15h10m_Subject 47080.txt","47080",2019-10-02,"15:10",82,60,10,12,22,16,1,2,19,36,10,8,54,451,9,211,671
"./Ship3_Latin-square/2019-10-02_15h10m_Subject 47089.txt","47089",2019-10-02,"15:10",78,60,6,12,18,35,3,6,44,41,9,7,57,284,28,53,365
"./Ship3_Latin-square/2019-10-02_15h10m_Subject 47762.txt","47762",2019-10-02,"15:10",80,60,8,12,20,12,2,7,21,21,3,11,35,313,35,69,417
"./Ship3_Latin-square/2019-10-02_15h10m_Subject 47791.txt","47791",2019-10-02,"15:10",78,60,6,12,18,6,2,0,8,12,1,5,18,839,87,175,1101
"./Ship3_Latin-square/2019-10-03_09h50m_Subject 46878.txt","46878",2019-10-03,"09:50",75,60,6,9,15,13,1,2,16,18,2,3,23,544,49,72,665
"./Ship3_Latin-square/2019-10-03_09h50m_Subject 46885.txt","46885",2019-10-03,"09:50",81,60,9,12,21,58,2,6,66,25,0,7,32,334,53,56,443
"./Ship3_Latin-square/2019-10-03_09h50m_Subject 46899.txt","46899",2019-10-03,"09:50",81,60,11,10,21,22,8,2,32,37,9,9,55,760,145,166,1071
"./Ship3_Latin-square/2019-10-03_09h50m_Subject 47081.txt","47081",2019-10-03,"09:50",82,60,10,12,22,33,6,6,45,29,2,25,56,359,12,121,492
"./Ship3_Latin-square/2019-10-03_09h50m_Subject 47091.txt","47091",2019-10-03,"09:50",76,60,8,8,16,21,2,3,26,56,12,12,80,270,35,37,342
"./Ship3_Latin-square/2019-10-03_09h50m_Subject 47095.txt","47095",2019-10-03,"09:50",80,60,10,10,20,46,4,11,61,60,7,23,90,244,24,42,310
"./Ship3_Latin-square/2019-10-03_09h50m_Subject 47231.txt","47231",2019-10-03,"09:50",80,60,10,10,20,65,10,12,87,17,15,6,38,230,59,45,334
"./Ship3_Latin-square/2019-10-03_09h50m_Subject 47238.txt","47238",2019-10-03,"09:50",80,60,11,9,20,27,1,5,33,59,17,10,86,319,18,80,417
"./Ship3_Latin-square/2019-10-03_09h50m_Subject 47242.txt","47242",2019-10-03,"09:50",82,60,9,13,22,39,5,9,53,57,18,11,86,271,3,150,424
"./Ship3_Latin-square/2019-10-03_09h50m_Subject 47244.txt","47244",2019-10-03,"09:50",78,60,6,12,18,22,1,3,26,36,8,4,48,805,95,165,1065
"./Ship3_Latin-square/2019-10-03_09h50m_Subject 47633.txt","47633",2019-10-03,"09:50",76,60,7,9,16,42,2,1,45,47,6,11,64,384,40,49,473
"./Ship3_Latin-square/2019-10-03_09h50m_Subject 47636.txt","47636",2019-10-03,"09:50",81,60,14,7,21,117,7,3,127,53,18,4,75,482,150,39,671
"./Ship3_Latin-square/2019-10-03_09h50m_Subject 47752.txt","47752",2019-10-03,"09:50",79,60,9,10,19,53,7,4,64,23,20,12,55,563,106,102,771
"./Ship3_Latin-square/2019-10-03_09h50m_Subject 47767.txt","47767",2019-10-03,"09:50",80,60,11,9,20,69,5,16,90,101,32,33,166,164,3,46,213
"./Ship3_Latin-square/2019-10-03_09h50m_Subject 47768.txt","47768",2019-10-03,"09:50",83,60,8,15,23,10,3,9,22,20,1,2,23,739,104,190,1033
"./Ship3_Latin-square/2019-10-03_09h50m_Subject 47780.txt","47780",2019-10-03,"09:50",79,60,8,11,19,46,5,4,55,44,13,11,68,437,62,103,602
"./Ship3_Latin-square/2019-10-03_09h53m_Subject 46884.txt","46884",2019-10-03,"09:53",80,60,8,12,20,25,1,2,28,11,3,1,15,350,61,85,496
"./Ship3_Latin-square/2019-10-03_09h53m_Subject 47083.txt","47083",2019-10-03,"09:53",81,60,9,12,21,43,15,3,61,28,7,8,43,395,50,99,544
"./Ship3_Latin-square/2019-10-03_09h53m_Subject 47086.txt","47086",2019-10-03,"09:53",81,60,11,10,21,44,3,8,55,31,4,10,45,282,29,105,416
"./Ship3_Latin-square/2019-10-03_09h53m_Subject 47246.txt","47246",2019-10-03,"09:53",78,60,5,13,18,27,2,3,32,10,1,3,14,456,51,100,607
"./Ship3_Latin-square/2019-10-03_09h53m_Subject 47635.txt","47635",2019-10-03,"09:53",78,60,8,10,18,12,0,1,13,30,12,9,51,742,98,119,959
"./Ship3_Latin-square/2019-10-03_09h53m_Subject 47779.txt","47779",2019-10-03,"09:53",77,60,6,11,17,37,2,4,43,78,15,7,100,289,37,60,386
"./Ship3_Latin-square/2019-10-03_09h53m_Subject 47790.txt","47790",2019-10-03,"09:53",79,60,10,9,19,68,6,18,92,50,17,5,72,217,21,26,264
"./Ship3_Latin-square/2019-10-03_09h53m_Subject 47797.txt","47797",2019-10-03,"09:53",50,36,10,4,14,51,13,3,67,39,9,33,81,72,7,11,90
"./Ship3_Latin-square/2019-10-03_11h15m_Subject 46900.txt","46900",2019-10-03,"11:15",78,60,6,12,18,11,0,0,11,56,8,11,75,1169,88,341,1598
"./Ship3_Latin-square/2019-10-03_11h15m_Subject 46986.txt","46986",2019-10-03,"11:15",67,52,10,5,15,48,9,2,59,48,8,2,58,207,37,50,294
"./Ship3_Latin-square/2019-10-03_11h15m_Subject 47076.txt","47076",2019-10-03,"11:15",70,50,11,9,20,30,1,7,38,116,3,151,270,399,7,71,477
"./Ship3_Latin-square/2019-10-03_11h15m_Subject 47079.txt","47079",2019-10-03,"11:15",79,60,9,10,19,24,7,2,33,45,11,10,66,536,89,94,719
"./Ship3_Latin-square/2019-10-03_11h15m_Subject 47082.txt","47082",2019-10-03,"11:15",71,50,13,8,21,70,14,5,89,30,19,10,59,171,19,41,231
"./Ship3_Latin-square/2019-10-03_11h15m_Subject 47092.txt","47092",2019-10-03,"11:15",77,60,8,9,17,21,3,2,26,21,5,0,26,1087,138,168,1393
"./Ship3_Latin-square/2019-10-03_11h15m_Subject 47098.txt","47098",2019-10-03,"11:15",80,60,14,6,20,45,5,9,59,52,5,13,70,193,2,30,225
"./Ship3_Latin-square/2019-10-03_11h15m_Subject 47226.txt","47226",2019-10-03,"11:15",80,60,9,11,20,25,4,5,34,45,8,11,64,791,6,359,1156
"./Ship3_Latin-square/2019-10-03_11h15m_Subject 47227.txt","47227",2019-10-03,"11:15",76,60,13,3,16,64,7,2,73,44,21,3,68,245,10,20,275
"./Ship3_Latin-square/2019-10-03_11h15m_Subject 47250.txt","47250",2019-10-03,"11:15",82,60,13,9,22,50,3,9,62,57,26,17,100,385,8,79,472
"./Ship3_Latin-square/2019-10-03_11h15m_Subject 47645.txt","47645",2019-10-03,"11:15",71,55,12,4,16,96,14,6,116,11,5,2,18,185,24,16,225
"./Ship3_Latin-square/2019-10-03_11h15m_Subject 47646.txt","47646",2019-10-03,"11:15",83,60,12,11,23,59,4,30,93,86,39,15,140,504,6,84,594
"./Ship3_Latin-square/2019-10-03_11h15m_Subject 47755.txt","47755",2019-10-03,"11:15",81,60,10,11,21,30,1,4,35,26,14,6,46,725,96,131,952
"./Ship3_Latin-square/2019-10-03_11h15m_Subject 47760.txt","47760",2019-10-03,"11:15",82,60,11,11,22,25,7,3,35,39,13,5,57,1392,239,292,1923
"./Ship3_Latin-square/2019-10-03_11h15m_Subject 47770.txt","47770",2019-10-03,"11:15",75,58,6,11,17,53,8,3,64,48,5,18,71,267,24,52,343
"./Ship3_Latin-square/2019-10-03_11h15m_Subject 47795.txt","47795",2019-10-03,"11:15",50,37,13,0,13,88,23,0,111,47,38,0,85,135,6,0,141
"./Ship3_Latin-square/2019-10-03_11h20m_Subject 47229.txt","47229",2019-10-03,"11:20",81,60,9,12,21,32,0,7,39,36,7,13,56,327,11,126,464
"./Ship3_Latin-square/2019-10-03_11h20m_Subject 47233.txt","47233",2019-10-03,"11:20",80,60,8,12,20,29,4,4,37,27,2,9,38,390,65,79,534
"./Ship3_Latin-square/2019-10-03_11h20m_Subject 47234.txt","47234",2019-10-03,"11:20",80,60,11,9,20,38,5,7,50,34,15,10,59,373,83,89,545
"./Ship3_Latin-square/2019-10-03_11h20m_Subject 47237.txt","47237",2019-10-03,"11:20",81,60,8,13,21,14,0,2,16,3,2,6,11,691,77,169,937
"./Ship3_Latin-square/2019-10-03_11h20m_Subject 47241.txt","47241",2019-10-03,"11:20",81,60,10,11,21,21,3,12,36,11,5,6,22,553,13,173,739
"./Ship3_Latin-square/2019-10-03_11h20m_Subject 47247.txt","47247",2019-10-03,"11:20",77,60,9,8,17,26,4,9,39,20,2,5,27,315,52,31,398
"./Ship3_Latin-square/2019-10-03_11h20m_Subject 47777.txt","47777",2019-10-03,"11:20",77,60,5,12,17,30,1,3,34,34,1,5,40,419,28,105,552
"./Ship3_Latin-square/2019-10-03_11h20m_Subject 47784.txt","47784",2019-10-03,"11:20",77,60,8,9,17,10,2,2,14,80,21,14,115,1395,167,238,1800
"./Ship3_Latin-square/2019-10-03_12h30m_Subject 46880.txt","46880",2019-10-03,"12:30",84,60,11,13,24,32,1,17,50,58,8,10,76,310,5,104,419
"./Ship3_Latin-square/2019-10-03_12h30m_Subject 46882.txt","46882",2019-10-03,"12:30",81,60,10,11,21,14,0,0,14,72,13,20,105,953,178,266,1397
"./Ship3_Latin-square/2019-10-03_12h30m_Subject 46883.txt","46883",2019-10-03,"12:30",74,60,5,9,14,33,0,7,40,44,7,5,56,668,67,68,803
"./Ship3_Latin-square/2019-10-03_12h30m_Subject 46894.txt","46894",2019-10-03,"12:30",80,60,7,13,20,34,4,2,40,16,6,1,23,530,50,138,718
"./Ship3_Latin-square/2019-10-03_12h30m_Subject 46896.txt","46896",2019-10-03,"12:30",84,60,12,12,24,21,3,4,28,39,21,9,69,670,130,143,943
"./Ship3_Latin-square/2019-10-03_12h30m_Subject 47228.txt","47228",2019-10-03,"12:30",80,60,9,11,20,22,1,2,25,20,11,4,35,494,80,94,668
"./Ship3_Latin-square/2019-10-03_12h30m_Subject 47243.txt","47243",2019-10-03,"12:30",78,60,9,9,18,39,2,7,48,10,19,1,30,816,110,158,1084
"./Ship3_Latin-square/2019-10-03_12h30m_Subject 47639.txt","47639",2019-10-03,"12:30",80,60,12,8,20,60,6,10,76,69,20,22,111,341,39,49,429
"./Ship3_Latin-square/2019-10-03_12h30m_Subject 47649.txt","47649",2019-10-03,"12:30",78,60,4,14,18,22,3,3,28,4,0,29,33,590,59,156,805
"./Ship3_Latin-square/2019-10-03_12h30m_Subject 47753.txt","47753",2019-10-03,"12:30",79,60,9,10,19,25,3,1,29,20,4,3,27,717,104,172,993
"./Ship3_Latin-square/2019-10-03_12h30m_Subject 47776.txt","47776",2019-10-03,"12:30",79,60,9,10,19,16,0,2,18,41,16,8,65,1074,143,257,1474
"./Ship3_Latin-square/2019-10-03_12h33m_Subject 46881.txt","46881",2019-10-03,"12:33",81,60,11,10,21,64,7,15,86,70,16,17,103,322,8,48,378
"./Ship3_Latin-square/2019-10-03_12h33m_Subject 47087.txt","47087",2019-10-03,"12:33",85,60,15,10,25,54,7,14,75,56,23,11,90,266,16,74,356
"./Ship3_Latin-square/2019-10-03_12h33m_Subject 47626.txt","47626",2019-10-03,"12:33",78,60,7,11,18,23,2,0,25,37,2,3,42,320,27,61,408
"./Ship3_Latin-square/2019-10-03_12h33m_Subject 47632.txt","47632",2019-10-03,"12:33",80,60,9,11,20,16,5,2,23,6,0,7,13,957,143,165,1265
"./Ship3_Latin-square/2019-10-03_12h33m_Subject 47634.txt","47634",2019-10-03,"12:33",85,60,14,11,25,53,11,16,80,37,42,10,89,204,19,59,282
"./Ship3_Latin-square/2019-10-03_12h33m_Subject 47640.txt","47640",2019-10-03,"12:33",84,60,13,11,24,61,5,14,80,29,11,11,51,138,8,39,185
"./Ship3_Latin-square/2019-10-03_12h33m_Subject 47754.txt","47754",2019-10-03,"12:33",56,41,10,5,15,46,5,6,57,28,4,3,35,100,22,23,145
"./Ship3_Latin-square/2019-10-03_12h33m_Subject 47800.txt","47800",2019-10-03,"12:33",78,60,3,15,18,61,2,12,75,54,4,13,71,269,9,68,346
"./Ship3_Latin-square/2019-10-03_13h47m_Subject 46876.txt","46876",2019-10-03,"13:47",54,39,12,3,15,37,20,2,59,14,8,1,23,228,1,21,250
"./Ship3_Latin-square/2019-10-03_13h47m_Subject 46877.txt","46877",2019-10-03,"13:47",82,60,11,11,22,5,1,1,7,59,13,6,78,1574,264,301,2139
"./Ship3_Latin-square/2019-10-03_13h47m_Subject 46893.txt","46893",2019-10-03,"13:47",76,60,7,9,16,9,0,20,29,90,10,4,104,1458,184,256,1898
"./Ship3_Latin-square/2019-10-03_13h47m_Subject 46895.txt","46895",2019-10-03,"13:47",82,60,5,17,22,41,2,17,60,14,3,6,23,290,24,55,369
"./Ship3_Latin-square/2019-10-03_13h47m_Subject 46897.txt","46897",2019-10-03,"13:47",76,56,10,10,20,65,9,23,97,69,24,38,131,184,33,38,255
"./Ship3_Latin-square/2019-10-03_13h47m_Subject 47638.txt","47638",2019-10-03,"13:47",82,60,13,9,22,58,11,5,74,19,7,7,33,393,61,78,532
"./Ship3_Latin-square/2019-10-03_13h47m_Subject 47769.txt","47769",2019-10-03,"13:47",85,60,13,12,25,26,4,9,39,39,18,9,66,548,78,123,749
"./Ship3_Latin-square/2019-10-03_13h47m_Subject 47771.txt","47771",2019-10-03,"13:47",84,60,15,9,24,26,2,3,31,13,7,3,23,653,84,143,880
"./Ship3_Latin-square/2019-10-03_13h47m_Subject 47775.txt","47775",2019-10-03,"13:47",80,60,10,10,20,67,6,9,82,28,5,4,37,312,42,103,457
"./Ship3_Latin-square/2019-10-03_13h47m_Subject 47781.txt","47781",2019-10-03,"13:47",79,60,8,11,19,12,1,2,15,35,11,4,50,1177,126,252,1555
"./Ship3_Latin-square/2019-10-03_13h47m_Subject 47783.txt","47783",2019-10-03,"13:47",77,60,10,7,17,37,4,1,42,68,14,6,88,782,154,88,1024
"./Ship3_Latin-square/2019-10-03_13h47m_Subject 47785.txt","47785",2019-10-03,"13:47",76,60,6,10,16,19,1,1,21,69,11,19,99,1737,205,355,2297
"./Ship3_Latin-square/2019-10-03_13h47m_Subject 47786.txt","47786",2019-10-03,"13:47",81,60,10,11,21,56,10,9,75,27,20,51,98,256,30,81,367
"./Ship3_Latin-square/2019-10-03_13h51m_Subject 46888.txt","46888",2019-10-03,"13:51",76,60,8,8,16,6,0,2,8,49,9,8,66,874,107,127,1108
"./Ship3_Latin-square/2019-10-03_13h51m_Subject 46889.txt","46889",2019-10-03,"13:51",82,60,3,19,22,16,1,2,19,24,0,20,44,1262,101,342,1705
"./Ship3_Latin-square/2019-10-03_13h51m_Subject 46890.txt","46890",2019-10-03,"13:51",82,60,6,16,22,17,5,4,26,7,0,17,24,473,58,138,669
"./Ship3_Latin-square/2019-10-03_13h51m_Subject 46892.txt","46892",2019-10-03,"13:51",80,60,9,11,20,11,3,0,14,9,1,2,12,972,125,241,1338
"./Ship3_Latin-square/2019-10-03_13h51m_Subject 46898.txt","46898",2019-10-03,"13:51",76,60,10,6,16,42,4,3,49,74,14,1,89,510,115,54,679
"./Ship3_Latin-square/2019-10-03_13h51m_Subject 47097.txt","47097",2019-10-03,"13:51",84,60,15,9,24,47,1,7,55,93,31,14,138,536,9,111,656
"./Ship3_Latin-square/2019-10-03_13h51m_Subject 47099.txt","47099",2019-10-03,"13:51",76,60,8,8,16,20,1,1,22,25,9,10,44,909,97,183,1189
"./Ship3_Latin-square/2019-10-03_13h51m_Subject 47798.txt","47798",2019-10-03,"13:51",79,60,7,12,19,18,1,1,20,9,2,2,13,282,21,80,383
"./Ship3_Latin-square/2019-10-03_15h00m_Subject 47080.txt","47080",2019-10-03,"15:00",80,60,7,13,20,7,0,3,10,19,11,12,42,1004,131,215,1350
"./Ship3_Latin-square/2019-10-03_15h00m_Subject 47089.txt","47089",2019-10-03,"15:00",46,32,14,0,14,22,9,0,31,19,121,0,140,168,1,0,169
"./Ship3_Latin-square/2019-10-03_15h00m_Subject 47762.txt","47762",2019-10-03,"15:00",77,60,7,10,17,21,2,7,30,16,3,1,20,210,24,30,264
"./Ship3_Latin-square/2019-10-03_15h00m_Subject 47791.txt","47791",2019-10-03,"15:00",84,60,10,14,24,5,2,3,10,12,3,3,18,851,153,195,1199
"./Ship3_Latin-square/2019-10-04_09h48m_Subject 46884.txt","46884",2019-10-04,"09:48",80,60,10,10,20,28,4,7,39,15,4,3,22,221,34,50,305
"./Ship3_Latin-square/2019-10-04_09h48m_Subject 47083.txt","47083",2019-10-04,"09:48",76,60,4,12,16,50,5,5,60,20,5,10,35,378,26,79,483
"./Ship3_Latin-square/2019-10-04_09h48m_Subject 47086.txt","47086",2019-10-04,"09:48",83,60,14,9,23,49,8,12,69,40,12,4,56,290,19,56,365
"./Ship3_Latin-square/2019-10-04_09h48m_Subject 47246.txt","47246",2019-10-04,"09:48",84,60,10,14,24,13,5,3,21,4,1,2,7,397,67,91,555
"./Ship3_Latin-square/2019-10-04_09h48m_Subject 47635.txt","47635",2019-10-04,"09:48",82,60,8,14,22,9,0,1,10,22,4,11,37,713,94,151,958
"./Ship3_Latin-square/2019-10-04_09h48m_Subject 47779.txt","47779",2019-10-04,"09:48",83,60,11,12,23,23,3,3,29,47,14,3,64,172,25,61,258
"./Ship3_Latin-square/2019-10-04_09h48m_Subject 47790.txt","47790",2019-10-04,"09:48",82,60,9,13,22,43,3,4,50,33,8,15,56,463,99,137,699
"./Ship3_Latin-square/2019-10-04_09h48m_Subject 47797.txt","47797",2019-10-04,"09:48",53,39,6,8,14,48,4,8,60,87,5,12,104,165,27,34,226
"./Ship3_Latin-square/2019-10-04_09h52m_Subject 46878.txt","46878",2019-10-04,"09:52",80,60,11,9,20,7,3,1,11,9,14,12,35,898,151,113,1162
"./Ship3_Latin-square/2019-10-04_09h52m_Subject 46885.txt","46885",2019-10-04,"09:52",82,60,9,13,22,46,8,7,61,17,7,11,35,308,43,78,429
"./Ship3_Latin-square/2019-10-04_09h52m_Subject 46899.txt","46899",2019-10-04,"09:52",75,60,8,7,15,12,0,1,13,16,2,2,20,938,118,124,1180
"./Ship3_Latin-square/2019-10-04_09h52m_Subject 47081.txt","47081",2019-10-04,"09:52",82,60,9,13,22,17,2,7,26,12,5,1,18,594,88,165,847
"./Ship3_Latin-square/2019-10-04_09h52m_Subject 47091.txt","47091",2019-10-04,"09:52",80,60,7,13,20,19,0,0,19,61,6,7,74,305,33,49,387
"./Ship3_Latin-square/2019-10-04_09h52m_Subject 47095.txt","47095",2019-10-04,"09:52",79,60,8,11,19,41,3,5,49,31,5,12,48,446,56,65,567
"./Ship3_Latin-square/2019-10-04_09h52m_Subject 47231.txt","47231",2019-10-04,"09:52",78,60,1,17,18,60,1,14,75,19,0,3,22,268,4,60,332
"./Ship3_Latin-square/2019-10-04_09h52m_Subject 47238.txt","47238",2019-10-04,"09:52",76,60,8,8,16,20,2,2,24,39,9,3,51,537,76,69,682
"./Ship3_Latin-square/2019-10-04_09h52m_Subject 47242.txt","47242",2019-10-04,"09:52",77,60,6,11,17,21,4,1,26,38,2,9,49,652,57,131,840
"./Ship3_Latin-square/2019-10-04_09h52m_Subject 47244.txt","47244",2019-10-04,"09:52",80,60,9,11,20,7,4,2,13,38,12,7,57,869,138,132,1139
"./Ship3_Latin-square/2019-10-04_09h52m_Subject 47633.txt","47633",2019-10-04,"09:52",81,60,9,12,21,23,0,5,28,66,12,20,98,370,101,80,551
"./Ship3_Latin-square/2019-10-04_09h52m_Subject 47636.txt","47636",2019-10-04,"09:52",75,60,5,10,15,48,4,9,61,43,4,7,54,411,44,65,520
"./Ship3_Latin-square/2019-10-04_09h52m_Subject 47752.txt","47752",2019-10-04,"09:52",81,60,8,13,21,41,5,9,55,23,9,9,41,649,92,189,930
"./Ship3_Latin-square/2019-10-04_09h52m_Subject 47767.txt","47767",2019-10-04,"09:52",80,60,10,10,20,23,1,3,27,33,9,8,50,280,46,38,364
"./Ship3_Latin-square/2019-10-04_09h52m_Subject 47768.txt","47768",2019-10-04,"09:52",83,60,13,10,23,20,4,0,24,21,13,16,50,455,126,75,656
"./Ship3_Latin-square/2019-10-04_09h52m_Subject 47780.txt","47780",2019-10-04,"09:52",82,60,10,12,22,39,6,7,52,39,13,12,64,526,80,117,723
"./Ship3_Latin-square/2019-10-04_10h52m_Subject 47229.txt","47229",2019-10-04,"10:52",78,60,8,10,18,26,2,5,33,21,4,3,28,550,54,92,696
"./Ship3_Latin-square/2019-10-04_10h52m_Subject 47233.txt","47233",2019-10-04,"10:52",82,60,10,12,22,25,5,3,33,23,1,7,31,359,73,63,495
"./Ship3_Latin-square/2019-10-04_10h52m_Subject 47234.txt","47234",2019-10-04,"10:52",85,60,15,10,25,61,3,8,72,43,29,16,88,321,32,78,431
"./Ship3_Latin-square/2019-10-04_10h52m_Subject 47237.txt","47237",2019-10-04,"10:52",78,57,11,10,21,99,10,25,134,94,22,20,136,315,27,70,412
"./Ship3_Latin-square/2019-10-04_10h52m_Subject 47241.txt","47241",2019-10-04,"10:52",77,60,9,8,17,19,0,1,20,8,9,0,17,917,100,156,1173
"./Ship3_Latin-square/2019-10-04_10h52m_Subject 47247.txt","47247",2019-10-04,"10:52",79,60,10,9,19,20,4,4,28,16,3,2,21,294,50,53,397
"./Ship3_Latin-square/2019-10-04_10h52m_Subject 47777.txt","47777",2019-10-04,"10:52",54,42,9,3,12,124,18,7,149,23,1,2,26,99,2,10,111
"./Ship3_Latin-square/2019-10-04_10h52m_Subject 47784.txt","47784",2019-10-04,"10:52",80,60,5,15,20,15,3,1,19,47,6,37,90,1389,109,237,1735
"./Ship3_Latin-square/2019-10-04_10h58m_Subject 46900.txt","46900",2019-10-04,"10:58",80,60,14,6,20,60,3,11,74,12,44,3,59,431,7,47,485
"./Ship3_Latin-square/2019-10-04_10h58m_Subject 46986.txt","46986",2019-10-04,"10:58",50,36,11,3,14,42,16,6,64,17,26,1,44,113,9,5,127
"./Ship3_Latin-square/2019-10-04_10h58m_Subject 47076.txt","47076",2019-10-04,"10:58",83,60,13,10,23,5,2,1,8,12,13,4,29,1069,194,212,1475
"./Ship3_Latin-square/2019-10-04_10h58m_Subject 47079.txt","47079",2019-10-04,"10:58",82,60,12,10,22,20,2,1,23,40,14,8,62,368,54,92,514
"./Ship3_Latin-square/2019-10-04_10h58m_Subject 47082.txt","47082",2019-10-04,"10:58",71,52,9,10,19,52,4,8,64,74,12,4,90,196,27,30,253
"./Ship3_Latin-square/2019-10-04_10h58m_Subject 47092.txt","47092",2019-10-04,"10:58",75,60,7,8,15,11,0,0,11,14,1,3,18,1038,147,156,1341
"./Ship3_Latin-square/2019-10-04_10h58m_Subject 47098.txt","47098",2019-10-04,"10:58",83,60,6,17,23,17,3,3,23,7,1,12,20,362,42,117,521
"./Ship3_Latin-square/2019-10-04_10h58m_Subject 47226.txt","47226",2019-10-04,"10:58",80,60,7,13,20,10,3,3,16,17,4,10,31,2652,155,457,3264
"./Ship3_Latin-square/2019-10-04_10h58m_Subject 47227.txt","47227",2019-10-04,"10:58",81,60,10,11,21,31,5,4,40,9,15,7,31,458,74,56,588
"./Ship3_Latin-square/2019-10-04_10h58m_Subject 47250.txt","47250",2019-10-04,"10:58",80,60,10,10,20,16,2,1,19,20,22,10,52,611,62,163,836
"./Ship3_Latin-square/2019-10-04_10h58m_Subject 47645.txt","47645",2019-10-04,"10:58",50,35,10,5,15,70,24,13,107,15,1,5,21,111,15,18,144
"./Ship3_Latin-square/2019-10-04_10h58m_Subject 47646.txt","47646",2019-10-04,"10:58",78,60,8,10,18,20,2,3,25,91,18,18,127,1412,188,306,1906
"./Ship3_Latin-square/2019-10-04_10h58m_Subject 47755.txt","47755",2019-10-04,"10:58",81,60,9,12,21,20,1,0,21,20,3,3,26,790,123,133,1046
"./Ship3_Latin-square/2019-10-04_10h58m_Subject 47760.txt","47760",2019-10-04,"10:58",81,60,8,13,21,22,3,1,26,37,6,11,54,1086,123,278,1487
"./Ship3_Latin-square/2019-10-04_10h58m_Subject 47770.txt","47770",2019-10-04,"10:58",58,44,7,7,14,43,8,8,59,61,5,6,72,186,37,32,255
"./Ship3_Latin-square/2019-10-04_10h58m_Subject 47795.txt","47795",2019-10-04,"10:58",83,60,6,17,23,39,6,14,59,64,11,42,117,540,16,154,710
"./Ship3_Latin-square/2019-10-04_12h08m_Subject 46881.txt","46881",2019-10-04,"12:08",83,60,8,15,23,15,3,5,23,66,12,16,94,914,71,248,1233
"./Ship3_Latin-square/2019-10-04_12h08m_Subject 47087.txt","47087",2019-10-04,"12:08",82,60,12,10,22,15,1,4,20,28,14,5,47,410,85,81,576
"./Ship3_Latin-square/2019-10-04_12h08m_Subject 47626.txt","47626",2019-10-04,"12:08",75,58,10,7,17,95,6,14,115,35,15,3,53,183,7,36,226
"./Ship3_Latin-square/2019-10-04_12h08m_Subject 47632.txt","47632",2019-10-04,"12:08",77,60,7,10,17,12,1,2,15,9,9,2,20,776,64,136,976
"./Ship3_Latin-square/2019-10-04_12h08m_Subject 47634.txt","47634",2019-10-04,"12:08",82,60,11,11,22,45,12,6,63,18,8,2,28,328,77,97,502
"./Ship3_Latin-square/2019-10-04_12h08m_Subject 47640.txt","47640",2019-10-04,"12:08",78,60,8,10,18,25,1,8,34,17,6,8,31,546,93,95,734
"./Ship3_Latin-square/2019-10-04_12h08m_Subject 47754.txt","47754",2019-10-04,"12:08",52,37,9,6,15,47,11,8,66,100,10,5,115,148,26,17,191
"./Ship3_Latin-square/2019-10-04_12h08m_Subject 47800.txt","47800",2019-10-04,"12:08",76,60,9,7,16,52,9,2,63,57,19,13,89,252,16,50,318
"./Ship3_Latin-square/2019-10-04_12h11m_Subject 46880.txt","46880",2019-10-04,"12:11",76,60,4,12,16,3,0,2,5,16,1,4,21,749,46,207,1002
"./Ship3_Latin-square/2019-10-04_12h11m_Subject 46882.txt","46882",2019-10-04,"12:11",78,58,11,9,20,49,1,13,63,33,78,3,114,494,53,49,596
"./Ship3_Latin-square/2019-10-04_12h11m_Subject 46883.txt","46883",2019-10-04,"12:11",77,60,6,11,17,27,0,1,28,20,20,6,46,601,61,109,771
"./Ship3_Latin-square/2019-10-04_12h11m_Subject 46896.txt","46896",2019-10-04,"12:11",77,60,3,14,17,12,0,0,12,21,2,10,33,1150,47,207,1404
"./Ship3_Latin-square/2019-10-04_12h11m_Subject 47639.txt","47639",2019-10-04,"12:11",81,60,11,10,21,14,5,3,22,25,8,5,38,752,100,143,995
"./Ship3_Latin-square/2019-10-04_12h11m_Subject 47649.txt","47649",2019-10-04,"12:11",74,60,5,9,14,27,2,0,29,3,0,4,7,622,59,133,814
"./Ship3_Latin-square/2019-10-04_12h11m_Subject 47753.txt","47753",2019-10-04,"12:11",83,60,12,11,23,58,6,17,81,26,7,29,62,457,14,130,601
"./Ship3_Latin-square/2019-10-04_13h16m_Subject 46888.txt","46888",2019-10-04,"13:16",82,60,14,8,22,20,4,0,24,39,23,7,69,512,95,114,721
"./Ship3_Latin-square/2019-10-04_13h16m_Subject 46889.txt","46889",2019-10-04,"13:16",83,60,8,15,23,11,1,2,14,22,3,10,35,1022,152,244,1418
"./Ship3_Latin-square/2019-10-04_13h16m_Subject 46890.txt","46890",2019-10-04,"13:16",83,60,14,9,23,41,11,11,63,6,3,1,10,172,0,43,215
"./Ship3_Latin-square/2019-10-04_13h16m_Subject 46898.txt","46898",2019-10-04,"13:16",78,60,9,9,18,21,1,5,27,53,5,9,67,738,100,65,903
"./Ship3_Latin-square/2019-10-04_13h16m_Subject 47097.txt","47097",2019-10-04,"13:16",85,60,10,15,25,10,0,2,12,48,14,12,74,955,138,276,1369
"./Ship3_Latin-square/2019-10-04_13h16m_Subject 47798.txt","47798",2019-10-04,"13:16",79,60,7,12,19,21,1,2,24,2,5,3,10,249,34,62,345
"./Ship3_Latin-square/2019-10-04_13h17m_Subject 46876.txt","46876",2019-10-04,"13:17",79,60,10,9,19,29,2,1,32,10,6,9,25,593,67,121,781
"./Ship3_Latin-square/2019-10-04_13h17m_Subject 46877.txt","46877",2019-10-04,"13:17",77,60,8,9,17,14,0,2,16,33,2,5,40,1585,202,243,2030
"./Ship3_Latin-square/2019-10-04_13h17m_Subject 46895.txt","46895",2019-10-04,"13:17",78,60,7,11,18,48,2,10,60,27,8,9,44,382,66,77,525
"./Ship3_Latin-square/2019-10-04_13h17m_Subject 46897.txt","46897",2019-10-04,"13:17",70,53,12,5,17,92,20,10,122,35,6,2,43,147,21,22,190
"./Ship3_Latin-square/2019-10-04_13h17m_Subject 47769.txt","47769",2019-10-04,"13:17",81,60,12,9,21,30,3,4,37,46,15,8,69,637,123,79,839
"./Ship3_Latin-square/2019-10-04_13h17m_Subject 47771.txt","47771",2019-10-04,"13:17",81,60,10,11,21,20,2,6,28,8,3,5,16,667,64,210,941
"./Ship3_Latin-square/2019-10-04_13h17m_Subject 47775.txt","47775",2019-10-04,"13:17",78,60,10,8,18,48,8,11,67,15,4,3,22,440,55,67,562
"./Ship3_Latin-square/2019-10-04_13h17m_Subject 47781.txt","47781",2019-10-04,"13:17",79,60,9,10,19,13,0,3,16,24,6,5,35,975,86,260,1321
"./Ship3_Latin-square/2019-10-04_13h17m_Subject 47783.txt","47783",2019-10-04,"13:17",82,60,14,8,22,39,6,4,49,34,23,1,58,625,57,125,807
"./Ship3_Latin-square/2019-10-04_13h17m_Subject 47785.txt","47785",2019-10-04,"13:17",80,60,10,10,20,13,6,2,21,55,24,14,93,1187,125,317,1629
"./Ship3_Latin-square/2019-10-04_13h17m_Subject 47786.txt","47786",2019-10-04,"13:17",80,60,11,9,20,62,7,4,73,21,4,1,26,355,77,78,510
"./Ship3_Latin-square/2019-10-04_14h23m_Subject 47080.txt","47080",2019-10-04,"14:23",81,60,8,13,21,6,2,1,9,59,6,6,71,900,85,203,1188
"./Ship3_Latin-square/2019-10-04_14h23m_Subject 47089.txt","47089",2019-10-04,"14:23",82,60,12,10,22,28,6,9,43,84,37,10,131,336,51,62,449
"./Ship3_Latin-square/2019-10-04_14h23m_Subject 47762.txt","47762",2019-10-04,"14:23",78,60,7,11,18,22,0,3,25,27,2,6,35,292,52,54,398
"./Ship3_Latin-square/2019-10-04_14h23m_Subject 47791.txt","47791",2019-10-04,"14:23",78,60,8,10,18,8,0,0,8,9,2,2,13,831,119,154,1104
"./Ship3_Latin-square/2019-10-05_09h32m_Subject 46884.txt","46884",2019-10-05,"09:32",40,30,8,2,10,76,12,8,96,15,2,0,17,75,0,1,76
"./Ship3_Latin-square/2019-10-05_09h32m_Subject 47083.txt","47083",2019-10-05,"09:32",82,59,8,15,23,73,11,15,99,22,6,16,44,307,37,112,456
"./Ship3_Latin-square/2019-10-05_09h32m_Subject 47086.txt","47086",2019-10-05,"09:32",78,60,6,12,18,25,0,2,27,17,1,4,22,484,45,125,654
"./Ship3_Latin-square/2019-10-05_09h32m_Subject 47246.txt","47246",2019-10-05,"09:32",80,60,11,9,20,49,9,9,67,35,7,6,48,194,0,60,254
"./Ship3_Latin-square/2019-10-05_09h32m_Subject 47635.txt","47635",2019-10-05,"09:32",78,60,7,11,18,18,0,3,21,27,3,4,34,668,74,114,856
"./Ship3_Latin-square/2019-10-05_09h32m_Subject 47779.txt","47779",2019-10-05,"09:32",78,59,9,10,19,75,2,4,81,71,14,5,90,226,48,74,348
"./Ship3_Latin-square/2019-10-05_09h32m_Subject 47790.txt","47790",2019-10-05,"09:32",80,57,14,9,23,48,14,15,77,46,14,15,75,222,13,62,297
"./Ship3_Latin-square/2019-10-05_09h32m_Subject 47797.txt","47797",2019-10-05,"09:32",78,57,4,17,21,35,2,10,47,29,6,26,61,336,30,101,467
"./Ship3_Latin-square/2019-10-05_09h34m_Subject 46878.txt","46878",2019-10-05,"09:34",77,60,4,13,17,14,0,3,17,12,3,16,31,1003,80,201,1284
"./Ship3_Latin-square/2019-10-05_09h34m_Subject 46885.txt","46885",2019-10-05,"09:34",55,40,11,4,15,123,26,21,170,34,13,6,53,87,4,15,106
"./Ship3_Latin-square/2019-10-05_09h34m_Subject 46899.txt","46899",2019-10-05,"09:34",77,60,8,9,17,12,3,1,16,27,6,5,38,888,93,147,1128
"./Ship3_Latin-square/2019-10-05_09h34m_Subject 47081.txt","47081",2019-10-05,"09:34",81,60,5,16,21,14,0,6,20,14,2,11,27,534,42,121,697
"./Ship3_Latin-square/2019-10-05_09h34m_Subject 47091.txt","47091",2019-10-05,"09:34",79,60,7,12,19,8,0,4,12,44,5,2,51,263,30,47,340
"./Ship3_Latin-square/2019-10-05_09h34m_Subject 47095.txt","47095",2019-10-05,"09:34",66,50,12,4,16,62,9,2,73,41,23,7,71,195,11,33,239
"./Ship3_Latin-square/2019-10-05_09h34m_Subject 47238.txt","47238",2019-10-05,"09:34",77,60,10,7,17,27,4,5,36,36,12,8,56,488,60,56,604
"./Ship3_Latin-square/2019-10-05_09h34m_Subject 47242.txt","47242",2019-10-05,"09:34",82,60,9,13,22,29,1,2,32,78,17,8,103,449,57,160,666
"./Ship3_Latin-square/2019-10-05_09h34m_Subject 47244.txt","47244",2019-10-05,"09:34",77,60,12,5,17,32,4,2,38,73,21,9,103,393,16,45,454
"./Ship3_Latin-square/2019-10-05_09h34m_Subject 47633.txt","47633",2019-10-05,"09:34",78,60,8,10,18,14,2,3,19,59,12,7,78,416,40,71,527
"./Ship3_Latin-square/2019-10-05_09h34m_Subject 47636.txt","47636",2019-10-05,"09:34",77,60,6,11,17,53,7,13,73,115,5,4,124,468,47,56,571
"./Ship3_Latin-square/2019-10-05_09h34m_Subject 47752.txt","47752",2019-10-05,"09:34",80,60,8,12,20,43,5,5,53,22,9,9,40,733,99,90,922
"./Ship3_Latin-square/2019-10-05_09h34m_Subject 47767.txt","47767",2019-10-05,"09:34",81,60,12,9,21,27,5,3,35,44,14,5,63,195,36,43,274
"./Ship3_Latin-square/2019-10-05_09h34m_Subject 47768.txt","47768",2019-10-05,"09:34",79,58,7,14,21,33,3,5,41,28,2,17,47,423,40,85,548
"./Ship3_Latin-square/2019-10-05_09h34m_Subject 47780.txt","47780",2019-10-05,"09:34",77,60,8,9,17,50,5,9,64,41,12,4,57,413,54,56,523
"./Ship3_Latin-square/2019-10-05_10h43m_Subject 47229.txt","47229",2019-10-05,"10:43",81,60,10,11,21,24,6,4,34,28,14,10,52,587,52,126,765
"./Ship3_Latin-square/2019-10-05_10h43m_Subject 47233.txt","47233",2019-10-05,"10:43",81,60,9,12,21,59,3,8,70,36,10,12,58,249,11,107,367
"./Ship3_Latin-square/2019-10-05_10h43m_Subject 47234.txt","47234",2019-10-05,"10:43",82,60,10,12,22,49,7,7,63,41,11,5,57,381,84,53,518
"./Ship3_Latin-square/2019-10-05_10h43m_Subject 47237.txt","47237",2019-10-05,"10:43",75,60,7,8,15,12,2,2,16,13,1,1,15,674,65,94,833
"./Ship3_Latin-square/2019-10-05_10h43m_Subject 47241.txt","47241",2019-10-05,"10:43",78,60,8,10,18,8,1,2,11,6,12,6,24,1012,163,193,1368
"./Ship3_Latin-square/2019-10-05_10h43m_Subject 47247.txt","47247",2019-10-05,"10:43",78,60,6,12,18,26,3,5,34,25,7,0,32,349,46,79,474
"./Ship3_Latin-square/2019-10-05_10h43m_Subject 47777.txt","47777",2019-10-05,"10:43",78,60,6,12,18,26,2,4,32,21,2,8,31,453,34,89,576
"./Ship3_Latin-square/2019-10-05_10h43m_Subject 47784.txt","47784",2019-10-05,"10:43",77,60,6,11,17,18,1,3,22,46,5,13,64,1276,136,168,1580
"./Ship3_Latin-square/2019-10-05_10h45m_Subject 46900.txt","46900",2019-10-05,"10:45",79,60,7,12,19,11,0,1,12,107,27,11,145,1055,143,249,1447
"./Ship3_Latin-square/2019-10-05_10h45m_Subject 46986.txt","46986",2019-10-05,"10:45",69,49,9,11,20,76,8,8,92,36,11,15,62,173,32,49,254
"./Ship3_Latin-square/2019-10-05_10h45m_Subject 47076.txt","47076",2019-10-05,"10:45",80,60,12,8,20,11,2,2,15,18,22,3,43,528,46,84,658
"./Ship3_Latin-square/2019-10-05_10h45m_Subject 47079.txt","47079",2019-10-05,"10:45",69,50,11,8,19,59,9,28,96,65,28,9,102,137,10,30,177
"./Ship3_Latin-square/2019-10-05_10h45m_Subject 47082.txt","47082",2019-10-05,"10:45",62,46,6,10,16,45,4,10,59,21,2,5,28,94,12,21,127
"./Ship3_Latin-square/2019-10-05_10h45m_Subject 47092.txt","47092",2019-10-05,"10:45",80,60,9,11,20,25,1,8,34,53,11,18,82,459,0,150,609
"./Ship3_Latin-square/2019-10-05_10h45m_Subject 47098.txt","47098",2019-10-05,"10:45",80,60,12,8,20,31,0,4,35,26,5,39,70,207,20,42,269
"./Ship3_Latin-square/2019-10-05_10h45m_Subject 47226.txt","47226",2019-10-05,"10:45",80,60,10,10,20,13,3,1,17,39,5,33,77,1774,197,399,2370
"./Ship3_Latin-square/2019-10-05_10h45m_Subject 47227.txt","47227",2019-10-05,"10:45",80,60,13,7,20,38,9,4,51,35,8,19,62,277,51,35,363
"./Ship3_Latin-square/2019-10-05_10h45m_Subject 47645.txt","47645",2019-10-05,"10:45",82,60,11,11,22,79,15,9,103,16,2,4,22,268,55,74,397
"./Ship3_Latin-square/2019-10-05_10h45m_Subject 47646.txt","47646",2019-10-05,"10:45",73,60,7,6,13,48,2,7,57,71,22,5,98,905,25,113,1043
"./Ship3_Latin-square/2019-10-05_10h45m_Subject 47755.txt","47755",2019-10-05,"10:45",81,60,10,11,21,35,4,2,41,15,13,7,35,679,82,121,882
"./Ship3_Latin-square/2019-10-05_10h45m_Subject 47760.txt","47760",2019-10-05,"10:45",81,60,10,11,21,70,3,33,106,56,44,3,103,419,4,71,494
"./Ship3_Latin-square/2019-10-05_10h45m_Subject 47770.txt","47770",2019-10-05,"10:45",48,35,9,4,13,53,8,3,64,26,24,78,128,217,61,21,299
"./Ship3_Latin-square/2019-10-05_10h45m_Subject 47795.txt","47795",2019-10-05,"10:45",52,42,9,1,10,101,25,0,126,46,9,1,56,130,20,2,152
"./Ship3_Latin-square/2019-10-05_11h54m_Subject 46881.txt","46881",2019-10-05,"11:54",77,60,8,9,17,24,1,7,32,49,14,7,70,445,30,122,597
"./Ship3_Latin-square/2019-10-05_11h54m_Subject 47087.txt","47087",2019-10-05,"11:54",75,60,9,6,15,46,3,5,54,33,11,2,46,310,34,31,375
"./Ship3_Latin-square/2019-10-05_11h54m_Subject 47626.txt","47626",2019-10-05,"11:54",78,60,7,11,18,22,3,3,28,18,6,2,26,436,38,82,556
"./Ship3_Latin-square/2019-10-05_11h54m_Subject 47632.txt","47632",2019-10-05,"11:54",74,60,5,9,14,26,0,3,29,19,2,4,25,996,96,108,1200
"./Ship3_Latin-square/2019-10-05_11h54m_Subject 47634.txt","47634",2019-10-05,"11:54",79,60,12,7,19,36,7,2,45,32,8,10,50,310,43,50,403
"./Ship3_Latin-square/2019-10-05_11h54m_Subject 47640.txt","47640",2019-10-05,"11:54",81,60,10,11,21,48,4,12,64,35,7,9,51,352,21,59,432
"./Ship3_Latin-square/2019-10-05_11h54m_Subject 47800.txt","47800",2019-10-05,"11:54",79,60,10,9,19,63,7,6,76,48,14,12,74,284,46,48,378
"./Ship3_Latin-square/2019-10-05_11h56m_Subject 46880.txt","46880",2019-10-05,"11:56",76,60,8,8,16,14,0,0,14,20,9,3,32,551,35,111,697
"./Ship3_Latin-square/2019-10-05_11h56m_Subject 46882.txt","46882",2019-10-05,"11:56",82,60,11,11,22,13,0,1,14,84,22,23,129,1039,119,319,1477
"./Ship3_Latin-square/2019-10-05_11h56m_Subject 46883.txt","46883",2019-10-05,"11:56",80,60,7,13,20,12,1,3,16,15,13,3,31,605,69,130,804
"./Ship3_Latin-square/2019-10-05_11h56m_Subject 46896.txt","46896",2019-10-05,"11:56",81,60,9,12,21,18,2,1,21,15,9,8,32,929,100,136,1165
"./Ship3_Latin-square/2019-10-05_11h56m_Subject 47649.txt","47649",2019-10-05,"11:56",79,60,12,7,19,54,3,5,62,25,5,1,31,257,12,42,311
"./Ship3_Latin-square/2019-10-05_11h56m_Subject 47753.txt","47753",2019-10-05,"11:56",79,60,10,9,19,43,0,1,44,40,8,3,51,767,134,127,1028
"./Ship3_Latin-square/2019-10-05_12h58m_Subject 46888.txt","46888",2019-10-05,"12:58",78,60,9,9,18,32,1,4,37,28,3,5,36,554,86,98,738
"./Ship3_Latin-square/2019-10-05_12h58m_Subject 46889.txt","46889",2019-10-05,"12:58",77,59,12,6,18,54,12,25,91,50,23,6,79,393,15,40,448
"./Ship3_Latin-square/2019-10-05_12h58m_Subject 46890.txt","46890",2019-10-05,"12:58",81,60,10,11,21,21,4,1,26,2,5,3,10,460,54,126,640
"./Ship3_Latin-square/2019-10-05_12h58m_Subject 46898.txt","46898",2019-10-05,"12:58",79,60,10,9,19,41,10,3,54,34,14,2,50,528,71,69,668
"./Ship3_Latin-square/2019-10-05_12h58m_Subject 47097.txt","47097",2019-10-05,"12:58",77,60,11,6,17,14,5,2,21,68,20,2,90,683,88,104,875
"./Ship3_Latin-square/2019-10-05_12h58m_Subject 47798.txt","47798",2019-10-05,"12:58",79,60,5,14,19,16,0,1,17,10,1,1,12,287,30,73,390
"./Ship3_Latin-square/2019-10-05_13h00m_Subject 46876.txt","46876",2019-10-05,"13:00",59,46,8,5,13,45,1,8,54,14,8,9,31,249,30,37,316
"./Ship3_Latin-square/2019-10-05_13h00m_Subject 46877.txt","46877",2019-10-05,"13:00",83,60,7,16,23,17,1,1,19,25,4,13,42,1434,208,342,1984
"./Ship3_Latin-square/2019-10-05_13h00m_Subject 46895.txt","46895",2019-10-05,"13:00",45,34,7,4,11,49,9,14,72,49,27,35,111,64,4,11,79
"./Ship3_Latin-square/2019-10-05_13h00m_Subject 46897.txt","46897",2019-10-05,"13:00",81,60,8,13,21,62,6,22,90,41,18,33,92,365,29,93,487
"./Ship3_Latin-square/2019-10-05_13h00m_Subject 47781.txt","47781",2019-10-05,"13:00",77,58,6,13,19,18,2,6,26,18,1,6,25,892,73,315,1280
"./Ship3_Latin-square/2019-10-05_13h00m_Subject 47783.txt","47783",2019-10-05,"13:00",78,60,10,8,18,36,10,5,51,41,11,8,60,679,80,100,859
"./Ship3_Latin-square/2019-10-05_13h00m_Subject 47785.txt","47785",2019-10-05,"13:00",81,60,11,10,21,17,2,2,21,86,19,10,115,1738,244,271,2253
"./Ship3_Latin-square/2019-10-05_13h00m_Subject 47786.txt","47786",2019-10-05,"13:00",50,37,6,7,13,64,8,25,97,20,7,0,27,90,12,23,125
"./Ship3_Latin-square/2019-10-05_14h02m_Subject 47080.txt","47080",2019-10-05,"14:02",77,60,7,10,17,8,2,1,11,49,7,15,71,1203,83,218,1504
"./Ship3_Latin-square/2019-10-05_14h02m_Subject 47089.txt","47089",2019-10-05,"14:02",64,48,10,6,16,33,4,3,40,48,98,7,153,209,20,29,258
"./Ship3_Latin-square/2019-10-05_14h02m_Subject 47762.txt","47762",2019-10-05,"14:02",79,60,10,9,19,40,6,3,49,12,3,1,16,267,55,33,355
"./Ship3_Latin-square/2019-10-05_14h02m_Subject 47791.txt","47791",2019-10-05,"14:02",79,60,10,9,19,15,3,2,20,27,4,3,34,397,13,67,477
"./Ship3_Latin-square/2019-10-06_09h57m_Subject 46878.txt","46878",2019-10-06,"09:57",81,60,10,11,21,12,1,2,15,17,3,8,28,929,150,179,1258
"./Ship3_Latin-square/2019-10-06_09h57m_Subject 46885.txt","46885",2019-10-06,"09:57",79,60,7,12,19,73,6,10,89,15,2,3,20,347,43,85,475
"./Ship3_Latin-square/2019-10-06_09h57m_Subject 46899.txt","46899",2019-10-06,"09:57",78,60,15,3,18,110,6,10,126,35,9,9,53,593,7,33,633
"./Ship3_Latin-square/2019-10-06_09h57m_Subject 47081.txt","47081",2019-10-06,"09:57",79,60,4,15,19,18,0,3,21,19,0,6,25,620,41,172,833
"./Ship3_Latin-square/2019-10-06_09h57m_Subject 47091.txt","47091",2019-10-06,"09:57",77,60,7,10,17,24,0,4,28,49,8,9,66,187,8,45,240
"./Ship3_Latin-square/2019-10-06_09h57m_Subject 47095.txt","47095",2019-10-06,"09:57",81,60,9,12,21,27,0,5,32,18,7,7,32,473,90,89,652
"./Ship3_Latin-square/2019-10-06_09h57m_Subject 47231.txt","47231",2019-10-06,"09:57",81,58,6,17,23,43,5,9,57,31,9,29,69,188,18,39,245
"./Ship3_Latin-square/2019-10-06_09h57m_Subject 47238.txt","47238",2019-10-06,"09:57",85,60,13,12,25,15,1,2,18,45,23,31,99,583,125,128,836
"./Ship3_Latin-square/2019-10-06_09h57m_Subject 47242.txt","47242",2019-10-06,"09:57",82,60,9,13,22,25,3,4,32,27,26,7,60,578,87,149,814
"./Ship3_Latin-square/2019-10-06_09h57m_Subject 47244.txt","47244",2019-10-06,"09:57",77,60,7,10,17,13,0,5,18,26,7,8,41,813,80,107,1000
"./Ship3_Latin-square/2019-10-06_09h57m_Subject 47633.txt","47633",2019-10-06,"09:57",78,60,9,9,18,22,3,12,37,54,8,12,74,361,65,66,492
"./Ship3_Latin-square/2019-10-06_09h57m_Subject 47636.txt","47636",2019-10-06,"09:57",71,52,5,14,19,43,4,13,60,104,9,56,169,297,49,106,452
"./Ship3_Latin-square/2019-10-06_09h57m_Subject 47752.txt","47752",2019-10-06,"09:57",55,39,10,6,16,57,18,6,81,32,45,23,100,167,22,20,209
"./Ship3_Latin-square/2019-10-06_09h57m_Subject 47767.txt","47767",2019-10-06,"09:57",79,60,8,11,19,31,4,3,38,52,4,24,80,267,34,57,358
"./Ship3_Latin-square/2019-10-06_09h57m_Subject 47768.txt","47768",2019-10-06,"09:57",80,59,3,18,21,30,1,5,36,28,0,19,47,453,17,177,647
"./Ship3_Latin-square/2019-10-06_09h57m_Subject 47780.txt","47780",2019-10-06,"09:57",81,60,6,15,21,45,5,10,60,52,10,23,85,400,54,141,595
"./Ship3_Latin-square/2019-10-06_10h01m_Subject 46884.txt","46884",2019-10-06,"10:01",77,59,9,9,18,40,4,9,53,18,1,11,30,283,31,37,351
"./Ship3_Latin-square/2019-10-06_10h01m_Subject 47083.txt","47083",2019-10-06,"10:01",81,60,12,9,21,90,6,15,111,62,21,10,93,210,9,59,278
"./Ship3_Latin-square/2019-10-06_10h01m_Subject 47086.txt","47086",2019-10-06,"10:01",80,60,11,9,20,23,8,3,34,12,2,3,17,487,93,87,667
"./Ship3_Latin-square/2019-10-06_10h01m_Subject 47246.txt","47246",2019-10-06,"10:01",78,60,7,11,18,20,5,6,31,6,1,10,17,404,51,99,554
"./Ship3_Latin-square/2019-10-06_10h01m_Subject 47635.txt","47635",2019-10-06,"10:01",82,60,2,20,22,56,1,5,62,47,3,18,68,528,9,44,581
"./Ship3_Latin-square/2019-10-06_10h01m_Subject 47779.txt","47779",2019-10-06,"10:01",80,60,9,11,20,23,1,7,31,51,8,1,60,293,44,46,383
"./Ship3_Latin-square/2019-10-06_10h01m_Subject 47790.txt","47790",2019-10-06,"10:01",76,60,7,9,16,43,2,4,49,68,14,2,84,577,33,73,683
"./Ship3_Latin-square/2019-10-06_10h01m_Subject 47797.txt","47797",2019-10-06,"10:01",84,60,10,14,24,41,5,7,53,34,6,9,49,349,60,96,505
"./Ship3_Latin-square/2019-10-06_11h11m_Subject 46900.txt","46900",2019-10-06,"11:11",85,60,14,11,25,27,2,7,36,53,68,8,129,621,58,150,829
"./Ship3_Latin-square/2019-10-06_11h11m_Subject 46986.txt","46986",2019-10-06,"11:11",81,60,8,13,21,38,8,6,52,15,6,7,28,325,52,61,438
"./Ship3_Latin-square/2019-10-06_11h11m_Subject 47076.txt","47076",2019-10-06,"11:11",79,60,11,8,19,8,1,3,12,16,7,7,30,788,100,125,1013
"./Ship3_Latin-square/2019-10-06_11h11m_Subject 47079.txt","47079",2019-10-06,"11:11",80,60,10,10,20,25,4,3,32,46,13,7,66,434,98,61,593
"./Ship3_Latin-square/2019-10-06_11h11m_Subject 47082.txt","47082",2019-10-06,"11:11",71,53,10,8,18,41,13,2,56,52,15,2,69,205,36,34,275
"./Ship3_Latin-square/2019-10-06_11h11m_Subject 47092.txt","47092",2019-10-06,"11:11",79,60,7,12,19,12,2,4,18,23,6,1,30,933,112,197,1242
"./Ship3_Latin-square/2019-10-06_11h11m_Subject 47098.txt","47098",2019-10-06,"11:11",83,60,9,14,23,13,1,1,15,6,4,2,12,565,78,137,780
"./Ship3_Latin-square/2019-10-06_11h11m_Subject 47226.txt","47226",2019-10-06,"11:11",79,60,7,12,19,13,2,1,16,131,20,7,158,2543,208,700,3451
"./Ship3_Latin-square/2019-10-06_11h11m_Subject 47227.txt","47227",2019-10-06,"11:11",82,60,10,12,22,33,3,9,45,11,16,15,42,355,67,60,482
"./Ship3_Latin-square/2019-10-06_11h11m_Subject 47250.txt","47250",2019-10-06,"11:11",80,60,11,9,20,7,3,1,11,11,32,2,45,905,167,158,1230
"./Ship3_Latin-square/2019-10-06_11h11m_Subject 47645.txt","47645",2019-10-06,"11:11",81,59,8,14,22,72,7,14,93,11,1,9,21,316,46,58,420
"./Ship3_Latin-square/2019-10-06_11h11m_Subject 47646.txt","47646",2019-10-06,"11:11",76,60,7,9,16,26,0,0,26,61,8,22,91,1375,103,313,1791
"./Ship3_Latin-square/2019-10-06_11h11m_Subject 47755.txt","47755",2019-10-06,"11:11",85,60,13,12,25,111,14,24,149,47,19,35,101,288,13,95,396
"./Ship3_Latin-square/2019-10-06_11h11m_Subject 47760.txt","47760",2019-10-06,"11:11",73,60,6,7,13,25,1,5,31,28,8,3,39,800,77,158,1035
"./Ship3_Latin-square/2019-10-06_11h11m_Subject 47770.txt","47770",2019-10-06,"11:11",61,44,5,12,17,45,13,3,61,43,8,15,66,189,22,51,262
"./Ship3_Latin-square/2019-10-06_11h11m_Subject 47795.txt","47795",2019-10-06,"11:11",78,60,12,6,18,61,15,6,82,62,29,1,92,464,40,42,546
"./Ship3_Latin-square/2019-10-06_11h15m_Subject 47229.txt","47229",2019-10-06,"11:15",77,60,8,9,17,26,2,3,31,29,10,2,41,652,73,91,816
"./Ship3_Latin-square/2019-10-06_11h15m_Subject 47233.txt","47233",2019-10-06,"11:15",80,60,7,13,20,68,2,28,98,33,5,8,46,553,59,154,766
"./Ship3_Latin-square/2019-10-06_11h15m_Subject 47234.txt","47234",2019-10-06,"11:15",78,60,6,12,18,30,5,6,41,79,5,27,111,600,103,95,798
"./Ship3_Latin-square/2019-10-06_11h15m_Subject 47237.txt","47237",2019-10-06,"11:15",77,60,10,7,17,34,3,4,41,62,11,13,86,420,66,50,536
"./Ship3_Latin-square/2019-10-06_11h15m_Subject 47241.txt","47241",2019-10-06,"11:15",82,60,9,13,22,14,1,3,18,10,15,7,32,891,98,248,1237
"./Ship3_Latin-square/2019-10-06_11h15m_Subject 47247.txt","47247",2019-10-06,"11:15",54,41,7,6,13,101,13,15,129,48,14,6,68,93,0,22,115
"./Ship3_Latin-square/2019-10-06_11h15m_Subject 47777.txt","47777",2019-10-06,"11:15",78,60,6,12,18,75,9,12,96,51,30,8,89,236,19,50,305
"./Ship3_Latin-square/2019-10-06_11h15m_Subject 47784.txt","47784",2019-10-06,"11:15",78,60,12,6,18,170,23,15,208,93,30,6,129,368,7,58,433
"./Ship3_Latin-square/2019-10-06_12h20m_Subject 46880.txt","46880",2019-10-06,"12:20",82,60,10,12,22,9,0,2,11,17,12,4,33,739,84,139,962
"./Ship3_Latin-square/2019-10-06_12h20m_Subject 46883.txt","46883",2019-10-06,"12:20",78,60,11,7,18,87,10,17,114,68,33,5,106,217,0,43,260
"./Ship3_Latin-square/2019-10-06_12h20m_Subject 46896.txt","46896",2019-10-06,"12:20",80,60,8,12,20,17,5,2,24,12,7,7,26,735,99,118,952
"./Ship3_Latin-square/2019-10-06_12h20m_Subject 47649.txt","47649",2019-10-06,"12:20",82,60,9,13,22,34,1,5,40,8,4,1,13,578,80,172,830
"./Ship3_Latin-square/2019-10-06_12h20m_Subject 47753.txt","47753",2019-10-06,"12:20",80,60,8,12,20,16,1,2,19,13,3,7,23,821,133,129,1083
"./Ship3_Latin-square/2019-10-06_12h24m_Subject 46881.txt","46881",2019-10-06,"12:24",80,60,10,10,20,26,3,0,29,64,26,6,96,795,122,138,1055
"./Ship3_Latin-square/2019-10-06_12h24m_Subject 47087.txt","47087",2019-10-06,"12:24",75,60,8,7,15,19,2,4,25,39,43,2,84,361,41,41,443
"./Ship3_Latin-square/2019-10-06_12h24m_Subject 47626.txt","47626",2019-10-06,"12:24",76,60,10,6,16,29,2,2,33,32,5,7,44,365,49,45,459
"./Ship3_Latin-square/2019-10-06_12h24m_Subject 47632.txt","47632",2019-10-06,"12:24",79,60,10,9,19,16,4,2,22,19,9,3,31,536,51,122,709
"./Ship3_Latin-square/2019-10-06_12h24m_Subject 47634.txt","47634",2019-10-06,"12:24",84,60,12,12,24,64,10,7,81,13,4,7,24,353,64,90,507
"./Ship3_Latin-square/2019-10-06_12h24m_Subject 47640.txt","47640",2019-10-06,"12:24",84,60,14,10,24,37,5,5,47,17,7,6,30,399,89,80,568
"./Ship3_Latin-square/2019-10-06_13h39m_Subject 46876.txt","46876",2019-10-06,"13:39",83,60,12,11,23,24,3,4,31,23,9,8,40,416,62,151,629
"./Ship3_Latin-square/2019-10-06_13h39m_Subject 46877.txt","46877",2019-10-06,"13:39",82,60,10,12,22,6,0,0,6,47,27,13,87,1459,241,317,2017
"./Ship3_Latin-square/2019-10-06_13h39m_Subject 46895.txt","46895",2019-10-06,"13:39",84,60,13,11,24,29,6,1,36,25,11,8,44,321,78,39,438
"./Ship3_Latin-square/2019-10-06_13h39m_Subject 46897.txt","46897",2019-10-06,"13:39",81,59,14,8,22,71,17,7,95,29,13,7,49,134,20,19,173
"./Ship3_Latin-square/2019-10-06_13h39m_Subject 47786.txt","47786",2019-10-06,"13:39",78,60,7,11,18,45,6,3,54,30,11,4,45,411,28,94,533
"./Ship3_Latin-square/2019-10-06_13h40m_Subject 46889.txt","46889",2019-10-06,"13:40",79,60,7,12,19,10,0,2,12,23,0,3,26,1127,154,225,1506
"./Ship3_Latin-square/2019-10-06_13h40m_Subject 46890.txt","46890",2019-10-06,"13:40",79,60,10,9,19,19,3,1,23,13,8,8,29,269,29,49,347
"./Ship3_Latin-square/2019-10-06_13h40m_Subject 46898.txt","46898",2019-10-06,"13:40",76,60,5,11,16,26,4,6,36,46,4,14,64,653,52,80,785
"./Ship3_Latin-square/2019-10-06_13h40m_Subject 47097.txt","47097",2019-10-06,"13:40",76,60,7,9,16,17,1,2,20,55,10,4,69,909,82,150,1141
"./Ship3_Latin-square/2019-10-06_13h40m_Subject 47798.txt","47798",2019-10-06,"13:40",81,60,7,14,21,24,1,3,28,7,2,0,9,264,18,50,332
"./Ship3_Latin-square/2019-10-06_14h41m_Subject 47089.txt","47089",2019-10-06,"14:41",81,60,14,7,21,40,8,5,53,60,51,3,114,350,46,46,442
"./Ship3_Latin-square/2019-10-06_14h41m_Subject 47762.txt","47762",2019-10-06,"14:41",80,60,10,10,20,34,7,1,42,29,4,1,34,190,36,30,256
"./Ship3_Latin-square/2019-10-06_14h41m_Subject 47791.txt","47791",2019-10-06,"14:41",79,60,9,10,19,26,1,1,28,13,13,7,33,559,68,119,746
"./Ship3_Latin-square/2019-10-07_10h13m_Subject 46878.txt","46878",2019-10-07,"10:13",82,60,11,11,22,23,3,10,36,35,18,18,71,436,14,145,595
"./Ship3_Latin-square/2019-10-07_10h13m_Subject 46885.txt","46885",2019-10-07,"10:13",81,60,11,10,21,84,14,15,113,28,14,7,49,225,37,47,309
"./Ship3_Latin-square/2019-10-07_10h13m_Subject 46899.txt","46899",2019-10-07,"10:13",77,60,7,10,17,11,0,1,12,23,3,5,31,918,88,192,1198
"./Ship3_Latin-square/2019-10-07_10h13m_Subject 47081.txt","47081",2019-10-07,"10:13",81,60,7,14,21,12,4,6,22,26,4,18,48,571,61,167,799
"./Ship3_Latin-square/2019-10-07_10h13m_Subject 47091.txt","47091",2019-10-07,"10:13",80,60,12,8,20,9,3,0,12,49,20,6,75,236,47,36,319
"./Ship3_Latin-square/2019-10-07_10h13m_Subject 47095.txt","47095",2019-10-07,"10:13",79,60,5,14,19,18,0,2,20,23,5,10,38,563,56,93,712
"./Ship3_Latin-square/2019-10-07_10h13m_Subject 47231.txt","47231",2019-10-07,"10:13",69,50,12,7,19,64,16,15,95,68,16,18,102,119,17,44,180
"./Ship3_Latin-square/2019-10-07_10h13m_Subject 47244.txt","47244",2019-10-07,"10:13",80,60,10,10,20,17,4,3,24,50,25,9,84,601,66,140,807
"./Ship3_Latin-square/2019-10-07_10h13m_Subject 47633.txt","47633",2019-10-07,"10:13",77,60,10,7,17,71,11,7,89,73,16,9,98,208,9,26,243
"./Ship3_Latin-square/2019-10-07_10h13m_Subject 47636.txt","47636",2019-10-07,"10:13",77,60,8,9,17,61,5,5,71,40,9,8,57,481,62,65,608
"./Ship3_Latin-square/2019-10-07_10h13m_Subject 47752.txt","47752",2019-10-07,"10:13",83,60,9,14,23,45,7,5,57,17,8,5,30,572,93,183,848
"./Ship3_Latin-square/2019-10-07_10h13m_Subject 47768.txt","47768",2019-10-07,"10:13",79,60,8,11,19,19,2,6,27,32,4,9,45,671,67,118,856
"./Ship3_Latin-square/2019-10-07_10h13m_Subject 47780.txt","47780",2019-10-07,"10:13",81,60,11,10,21,39,4,5,48,45,15,16,76,513,80,101,694
"./Ship3_Latin-square/2019-10-07_10h16m_Subject 46884.txt","46884",2019-10-07,"10:16",56,44,10,2,12,55,4,2,61,34,3,2,39,107,10,2,119
"./Ship3_Latin-square/2019-10-07_10h16m_Subject 47083.txt","47083",2019-10-07,"10:16",77,60,4,13,17,49,1,9,59,20,1,5,26,322,18,86,426
"./Ship3_Latin-square/2019-10-07_10h16m_Subject 47086.txt","47086",2019-10-07,"10:16",78,60,6,12,18,34,9,1,44,5,0,2,7,534,43,120,697
"./Ship3_Latin-square/2019-10-07_10h16m_Subject 47246.txt","47246",2019-10-07,"10:16",82,60,8,14,22,19,2,5,26,7,3,4,14,324,33,111,468
"./Ship3_Latin-square/2019-10-07_10h16m_Subject 47635.txt","47635",2019-10-07,"10:16",79,60,10,9,19,16,2,1,19,20,11,7,38,768,122,143,1033
"./Ship3_Latin-square/2019-10-07_10h16m_Subject 47779.txt","47779",2019-10-07,"10:16",81,60,8,13,21,12,3,2,17,50,9,3,62,370,40,46,456
"./Ship3_Latin-square/2019-10-07_10h16m_Subject 47790.txt","47790",2019-10-07,"10:16",84,60,11,13,24,13,7,3,23,11,3,15,29,556,148,65,769
"./Ship3_Latin-square/2019-10-07_10h16m_Subject 47797.txt","47797",2019-10-07,"10:16",80,59,9,12,21,53,5,6,64,19,15,8,42,286,49,35,370
"./Ship3_Latin-square/2019-10-07_11h33m_Subject 46900.txt","46900",2019-10-07,"11:33",80,60,11,9,20,10,0,2,12,80,26,16,122,739,113,266,1118
"./Ship3_Latin-square/2019-10-07_11h33m_Subject 46986.txt","46986",2019-10-07,"11:33",64,46,9,9,18,40,10,3,53,10,2,5,17,151,36,45,232
"./Ship3_Latin-square/2019-10-07_11h33m_Subject 47079.txt","47079",2019-10-07,"11:33",80,60,10,10,20,39,12,10,61,71,16,16,103,266,25,44,335
"./Ship3_Latin-square/2019-10-07_11h33m_Subject 47092.txt","47092",2019-10-07,"11:33",77,60,10,7,17,23,2,0,25,24,6,2,32,770,62,128,960
"./Ship3_Latin-square/2019-10-07_11h33m_Subject 47098.txt","47098",2019-10-07,"11:33",81,60,10,11,21,33,2,8,43,14,3,17,34,390,53,66,509
"./Ship3_Latin-square/2019-10-07_11h33m_Subject 47645.txt","47645",2019-10-07,"11:33",74,54,8,12,20,62,7,15,84,12,1,8,21,274,33,65,372
"./Ship3_Latin-square/2019-10-07_11h33m_Subject 47755.txt","47755",2019-10-07,"11:33",81,60,9,12,21,49,10,7,66,48,17,4,69,487,100,72,659
"./Ship3_Latin-square/2019-10-07_11h33m_Subject 47760.txt","47760",2019-10-07,"11:33",81,60,10,11,21,16,0,12,28,23,9,3,35,704,59,199,962
"./Ship3_Latin-square/2019-10-07_11h33m_Subject 47770.txt","47770",2019-10-07,"11:33",55,44,9,2,11,64,9,3,76,44,22,1,67,172,10,6,188
"./Ship3_Latin-square/2019-10-07_11h36m_Subject 47233.txt","47233",2019-10-07,"11:36",81,60,11,10,21,163,8,23,194,29,5,5,39,474,39,126,639
"./Ship3_Latin-square/2019-10-07_11h36m_Subject 47234.txt","47234",2019-10-07,"11:36",81,60,11,10,21,31,3,6,40,46,7,16,69,452,104,59,615
"./Ship3_Latin-square/2019-10-07_11h36m_Subject 47237.txt","47237",2019-10-07,"11:36",77,60,9,8,17,26,3,1,30,7,7,13,27,444,72,81,597
"./Ship3_Latin-square/2019-10-07_11h36m_Subject 47241.txt","47241",2019-10-07,"11:36",78,60,7,11,18,8,0,1,9,13,5,4,22,1072,128,155,1355
"./Ship3_Latin-square/2019-10-07_11h36m_Subject 47247.txt","47247",2019-10-07,"11:36",79,60,7,12,19,28,3,4,35,25,4,3,32,324,70,75,469
"./Ship3_Latin-square/2019-10-07_11h36m_Subject 47777.txt","47777",2019-10-07,"11:36",76,60,7,9,16,47,4,7,58,31,8,4,43,296,25,60,381
"./Ship3_Latin-square/2019-10-07_11h36m_Subject 47784.txt","47784",2019-10-07,"11:36",82,60,9,13,22,13,2,3,18,85,19,15,119,1354,201,382,1937
"./Ship3_Latin-square/2019-10-07_12h47m_Subject 47626.txt","47626",2019-10-07,"12:47",80,60,11,9,20,18,1,5,24,25,4,3,32,449,58,78,585
"./Ship3_Latin-square/2019-10-07_12h47m_Subject 47632.txt","47632",2019-10-07,"12:47",79,60,13,6,19,34,7,4,45,26,16,7,49,441,20,74,535
"./Ship3_Latin-square/2019-10-07_12h49m_Subject 46883.txt","46883",2019-10-07,"12:49",77,60,8,9,17,22,5,3,30,38,18,1,57,550,68,134,752
"./Ship3_Latin-square/2019-10-07_12h49m_Subject 46896.txt","46896",2019-10-07,"12:49",75,60,8,7,15,27,1,9,37,39,10,4,53,588,59,90,737
"./Ship3_Latin-square/2019-10-07_12h49m_Subject 47649.txt","47649",2019-10-07,"12:49",82,60,14,8,22,43,3,9,55,16,5,3,24,277,30,51,358
"./Ship3_Latin-square/2019-10-07_12h49m_Subject 47753.txt","47753",2019-10-07,"12:49",86,60,15,11,26,69,5,29,103,38,26,14,78,425,15,116,556
"./Ship3_Latin-square/2019-10-07_14h03m_Subject 46877.txt","46877",2019-10-07,"14:03",83,60,15,8,23,15,1,4,20,23,80,8,111,735,36,121,892
"./Ship3_Latin-square/2019-10-07_14h03m_Subject 46895.txt","46895",2019-10-07,"14:03",61,44,7,10,17,42,8,10,60,46,8,59,113,152,20,41,213
"./Ship3_Latin-square/2019-10-07_14h03m_Subject 46897.txt","46897",2019-10-07,"14:03",79,60,7,12,19,36,7,4,47,47,5,12,64,355,37,56,448
"./Ship3_Latin-square/2019-10-07_14h03m_Subject 47786.txt","47786",2019-10-07,"14:03",83,60,11,12,23,53,7,7,67,33,6,8,47,288,60,36,384
"./Ship3_Latin-square/2019-10-07_14h07m_Subject 46889.txt","46889",2019-10-07,"14:07",82,60,10,12,22,9,0,8,17,36,13,5,54,798,121,165,1084
"./Ship3_Latin-square/2019-10-07_14h07m_Subject 46890.txt","46890",2019-10-07,"14:07",82,60,9,13,22,11,2,3,16,14,7,11,32,436,90,107,633
"./Ship3_Latin-square/2019-10-07_14h07m_Subject 46898.txt","46898",2019-10-07,"14:07",79,60,7,12,19,21,4,3,28,33,0,14,47,691,96,118,905
"./Ship3_Latin-square/2019-10-07_14h07m_Subject 47798.txt","47798",2019-10-07,"14:07",67,49,12,6,18,47,7,6,60,31,16,14,61,104,2,17,123
"./Ship3_Latin-square/2019-10-07_15h22m_Subject 47762.txt","47762",2019-10-07,"15:22",54,38,9,7,16,41,3,12,56,21,18,26,65,98,7,16,121
"./Ship3_Latin-square/2019-10-07_15h22m_Subject 47791.txt","47791",2019-10-07,"15:22",83,60,9,14,23,14,14,3,31,9,9,12,30,480,53,124,657
"./Ship3_Latin-square/2019-10-08_10h00m_Subject 46884.txt","46884",2019-10-08,"10:00",71,53,8,10,18,78,8,14,100,30,4,5,39,144,31,23,198
"./Ship3_Latin-square/2019-10-08_10h00m_Subject 47083.txt","47083",2019-10-08,"10:00",80,59,13,8,21,66,13,8,87,38,6,5,49,279,32,39,350
"./Ship3_Latin-square/2019-10-08_10h00m_Subject 47086.txt","47086",2019-10-08,"10:00",79,60,10,9,19,29,6,6,41,8,0,0,8,470,78,76,624
"./Ship3_Latin-square/2019-10-08_10h00m_Subject 47246.txt","47246",2019-10-08,"10:00",85,60,10,15,25,17,8,2,27,2,4,8,14,433,72,102,607
"./Ship3_Latin-square/2019-10-08_10h00m_Subject 47635.txt","47635",2019-10-08,"10:00",81,60,11,10,21,64,6,14,84,48,12,9,69,265,2,74,341
"./Ship3_Latin-square/2019-10-08_10h00m_Subject 47779.txt","47779",2019-10-08,"10:00",48,35,10,3,13,20,5,2,27,25,26,1,52,51,10,4,65
"./Ship3_Latin-square/2019-10-08_10h00m_Subject 47790.txt","47790",2019-10-08,"10:00",62,46,12,4,16,48,2,7,57,33,8,3,44,174,14,16,204
"./Ship3_Latin-square/2019-10-08_10h00m_Subject 47797.txt","47797",2019-10-08,"10:00",85,60,11,14,25,66,6,9,81,17,3,12,32,349,44,90,483
"./Ship3_Latin-square/2019-10-08_10h03m_Subject 46878.txt","46878",2019-10-08,"10:03",78,60,5,13,18,8,2,4,14,5,0,4,9,862,61,185,1108
"./Ship3_Latin-square/2019-10-08_10h03m_Subject 46885.txt","46885",2019-10-08,"10:03",72,55,8,9,17,106,11,10,127,18,9,8,35,209,25,58,292
"./Ship3_Latin-square/2019-10-08_10h03m_Subject 46899.txt","46899",2019-10-08,"10:03",83,60,14,9,23,93,7,27,127,63,23,27,113,512,63,81,656
"./Ship3_Latin-square/2019-10-08_10h03m_Subject 47081.txt","47081",2019-10-08,"10:03",83,60,6,17,23,21,4,4,29,6,25,5,36,767,99,220,1086
"./Ship3_Latin-square/2019-10-08_10h03m_Subject 47091.txt","47091",2019-10-08,"10:03",79,60,9,10,19,16,0,3,19,46,11,8,65,226,27,53,306
"./Ship3_Latin-square/2019-10-08_10h03m_Subject 47095.txt","47095",2019-10-08,"10:03",60,44,10,6,16,40,5,9,54,38,12,30,80,176,18,43,237
"./Ship3_Latin-square/2019-10-08_10h03m_Subject 47231.txt","47231",2019-10-08,"10:03",84,60,9,15,24,39,4,15,58,27,7,7,41,172,26,39,237
"./Ship3_Latin-square/2019-10-08_10h03m_Subject 47244.txt","47244",2019-10-08,"10:03",80,60,7,13,20,24,0,3,27,37,8,6,51,689,70,173,932
"./Ship3_Latin-square/2019-10-08_10h03m_Subject 47633.txt","47633",2019-10-08,"10:03",80,60,9,11,20,31,7,4,42,60,11,10,81,364,51,69,484
"./Ship3_Latin-square/2019-10-08_10h03m_Subject 47636.txt","47636",2019-10-08,"10:03",48,34,12,2,14,70,15,7,92,63,30,7,100,205,21,13,239
"./Ship3_Latin-square/2019-10-08_10h03m_Subject 47752.txt","47752",2019-10-08,"10:03",53,41,11,1,12,42,11,4,57,40,20,26,86,270,44,0,314
"./Ship3_Latin-square/2019-10-08_10h03m_Subject 47768.txt","47768",2019-10-08,"10:03",85,60,13,12,25,49,7,8,64,35,12,15,62,223,6,76,305
"./Ship3_Latin-square/2019-10-08_10h03m_Subject 47780.txt","47780",2019-10-08,"10:03",79,60,9,10,19,32,5,6,43,59,18,11,88,434,75,77,586
"./Ship3_Latin-square/2019-10-08_11h11m_Subject 46986.txt","46986",2019-10-08,"11:11",79,58,11,10,21,38,7,1,46,9,10,2,21,281,46,71,398
"./Ship3_Latin-square/2019-10-08_11h11m_Subject 47079.txt","47079",2019-10-08,"11:11",77,60,6,11,17,31,1,18,50,66,10,11,87,329,29,63,421
"./Ship3_Latin-square/2019-10-08_11h11m_Subject 47092.txt","47092",2019-10-08,"11:11",80,60,11,9,20,16,3,1,20,17,4,2,23,917,122,159,1198
"./Ship3_Latin-square/2019-10-08_11h11m_Subject 47098.txt","47098",2019-10-08,"11:11",83,60,9,14,23,19,1,4,24,5,1,4,10,447,66,108,621
"./Ship3_Latin-square/2019-10-08_11h11m_Subject 47645.txt","47645",2019-10-08,"11:11",82,60,9,13,22,53,8,12,73,13,0,3,16,287,43,82,412
"./Ship3_Latin-square/2019-10-08_11h11m_Subject 47755.txt","47755",2019-10-08,"11:11",82,60,14,8,22,48,7,5,60,14,24,2,40,441,78,104,623
"./Ship3_Latin-square/2019-10-08_11h11m_Subject 47760.txt","47760",2019-10-08,"11:11",81,60,12,9,21,52,10,7,69,42,51,10,103,513,84,117,714
"./Ship3_Latin-square/2019-10-08_11h11m_Subject 47770.txt","47770",2019-10-08,"11:11",77,58,9,10,19,33,7,3,43,46,15,7,68,416,64,81,561
"./Ship3_Latin-square/2019-10-08_11h15m_Subject 47233.txt","47233",2019-10-08,"11:15",80,60,7,13,20,78,1,8,87,27,5,6,38,530,34,122,686
"./Ship3_Latin-square/2019-10-08_11h15m_Subject 47234.txt","47234",2019-10-08,"11:15",83,60,10,13,23,22,5,2,29,60,25,5,90,484,87,76,647
"./Ship3_Latin-square/2019-10-08_11h15m_Subject 47237.txt","47237",2019-10-08,"11:15",76,60,11,5,16,24,1,6,31,21,5,0,26,421,29,40,490
"./Ship3_Latin-square/2019-10-08_11h15m_Subject 47241.txt","47241",2019-10-08,"11:15",82,60,8,14,22,17,0,5,22,9,5,2,16,1019,154,261,1434
"./Ship3_Latin-square/2019-10-08_11h15m_Subject 47247.txt","47247",2019-10-08,"11:15",77,60,9,8,17,45,7,5,57,23,4,4,31,198,26,26,250
"./Ship3_Latin-square/2019-10-08_11h15m_Subject 47784.txt","47784",2019-10-08,"11:15",73,60,7,6,13,46,0,8,54,88,9,8,105,783,78,65,926
"./Ship3_Latin-square/2019-10-08_12h25m_Subject 46883.txt","46883",2019-10-08,"12:25",81,60,11,10,21,33,6,7,46,40,36,12,88,241,36,52,329
"./Ship3_Latin-square/2019-10-08_12h25m_Subject 46896.txt","46896",2019-10-08,"12:25",84,60,6,18,24,60,4,23,87,35,7,23,65,224,6,173,403
"./Ship3_Latin-square/2019-10-08_12h25m_Subject 47649.txt","47649",2019-10-08,"12:25",79,60,9,10,19,29,3,5,37,25,6,0,31,438,28,90,556
"./Ship3_Latin-square/2019-10-08_12h25m_Subject 47753.txt","47753",2019-10-08,"12:25",78,60,9,9,18,13,2,1,16,34,1,3,38,895,133,159,1187
"./Ship3_Latin-square/2019-10-08_12h30m_Subject 47632.txt","47632",2019-10-08,"12:30",80,60,10,10,20,22,6,1,29,19,11,1,31,604,118,74,796
"./Ship3_Latin-square/2019-10-08_13h35m_Subject 46889.txt","46889",2019-10-08,"13:35",78,60,6,12,18,10,0,3,13,31,12,6,49,1086,140,211,1437
"./Ship3_Latin-square/2019-10-08_13h35m_Subject 46890.txt","46890",2019-10-08,"13:35",81,60,10,11,21,19,1,5,25,12,3,14,29,307,53,68,428
"./Ship3_Latin-square/2019-10-08_13h35m_Subject 46898.txt","46898",2019-10-08,"13:35",80,60,10,10,20,31,3,6,40,63,8,4,75,518,68,120,706
"./Ship3_Latin-square/2019-10-08_13h35m_Subject 47798.txt","47798",2019-10-08,"13:35",82,60,9,13,22,23,2,3,28,8,4,1,13,288,27,67,382
"./Ship3_Latin-square/2019-10-08_13h38m_Subject 46877.txt","46877",2019-10-08,"13:38",81,60,8,13,21,6,1,1,8,59,21,10,90,1475,176,359,2010
"./Ship3_Latin-square/2019-10-08_13h38m_Subject 46895.txt","46895",2019-10-08,"13:38",80,60,13,7,20,36,6,6,48,44,20,3,67,258,73,27,358
"./Ship3_Latin-square/2019-10-08_13h38m_Subject 46897.txt","46897",2019-10-08,"13:38",47,33,13,1,14,49,20,3,72,17,22,11,50,74,5,0,79
"./Ship3_Latin-square/2019-10-08_13h38m_Subject 47786.txt","47786",2019-10-08,"13:38",78,60,9,9,18,39,9,7,55,42,3,4,49,319,44,47,410
"./Ship3_Latin-square/2019-10-08_14h55m_Subject 47762.txt","47762",2019-10-08,"14:55",82,60,9,13,22,10,0,3,13,10,3,3,16,214,35,57,306
"./Ship3_Latin-square/2019-10-08_14h55m_Subject 47791.txt","47791",2019-10-08,"14:55",77,60,6,11,17,4,0,0,4,7,1,6,14,848,79,158,1085
"./Ship3_Latin-square/2019-10-09_09h55m_Subject 47083.txt","47083",2019-10-09,"09:55",82,60,12,10,22,54,5,7,66,30,13,3,46,330,62,66,458
"./Ship3_Latin-square/2019-10-09_09h55m_Subject 47086.txt","47086",2019-10-09,"09:55",81,60,8,13,21,17,1,2,20,13,3,1,17,495,68,110,673
"./Ship3_Latin-square/2019-10-09_09h55m_Subject 47635.txt","47635",2019-10-09,"09:55",84,60,11,13,24,26,0,2,28,49,12,21,82,493,92,125,710
"./Ship3_Latin-square/2019-10-09_09h55m_Subject 47779.txt","47779",2019-10-09,"09:55",80,60,10,10,20,19,6,1,26,56,19,4,79,308,54,85,447
"./Ship3_Latin-square/2019-10-09_09h55m_Subject 47790.txt","47790",2019-10-09,"09:55",78,60,8,10,18,21,4,3,28,14,0,3,17,583,120,116,819
"./Ship3_Latin-square/2019-10-09_09h55m_Subject 47797.txt","47797",2019-10-09,"09:55",73,55,6,12,18,36,7,9,52,23,2,24,49,197,53,36,286
"./Ship3_Latin-square/2019-10-09_09h58m_Subject 46878.txt","46878",2019-10-09,"09:58",80,60,11,9,20,28,6,6,40,14,13,7,34,371,53,84,508
"./Ship3_Latin-square/2019-10-09_09h58m_Subject 46899.txt","46899",2019-10-09,"09:58",79,60,11,8,19,24,7,2,33,11,4,5,20,757,88,146,991
"./Ship3_Latin-square/2019-10-09_09h58m_Subject 47081.txt","47081",2019-10-09,"09:58",76,60,5,11,16,19,3,8,30,20,2,9,31,399,36,56,491
"./Ship3_Latin-square/2019-10-09_09h58m_Subject 47091.txt","47091",2019-10-09,"09:58",80,60,11,9,20,17,0,2,19,51,19,2,72,259,45,42,346
"./Ship3_Latin-square/2019-10-09_09h58m_Subject 47095.txt","47095",2019-10-09,"09:58",79,60,7,12,19,18,1,5,24,18,4,15,37,393,47,46,486
"./Ship3_Latin-square/2019-10-09_09h58m_Subject 47231.txt","47231",2019-10-09,"09:58",78,57,12,9,21,66,16,6,88,20,19,3,42,187,29,40,256
"./Ship3_Latin-square/2019-10-09_09h58m_Subject 47633.txt","47633",2019-10-09,"09:58",77,60,10,7,17,38,6,2,46,67,25,8,100,296,39,39,374
"./Ship3_Latin-square/2019-10-09_09h58m_Subject 47636.txt","47636",2019-10-09,"09:58",76,60,7,9,16,60,2,8,70,38,10,7,55,389,46,50,485
"./Ship3_Latin-square/2019-10-09_09h58m_Subject 47752.txt","47752",2019-10-09,"09:58",79,60,9,10,19,40,3,11,54,16,8,8,32,464,59,131,654
"./Ship3_Latin-square/2019-10-09_09h58m_Subject 47768.txt","47768",2019-10-09,"09:58",7,6,1,0,1,20,2,0,22,13,3,0,16,29,4,0,33
"./Ship3_Latin-square/2019-10-09_09h58m_Subject 47780.txt","47780",2019-10-09,"09:58",79,60,11,8,19,95,7,16,118,57,15,11,83,248,15,60,323
"./Ship3_Latin-square/2019-10-09_11h08m_Subject 47234.txt","47234",2019-10-09,"11:08",80,60,7,13,20,17,1,4,22,47,8,10,65,490,41,82,613
"./Ship3_Latin-square/2019-10-09_11h08m_Subject 47237.txt","47237",2019-10-09,"11:08",75,55,14,6,20,61,4,7,72,60,18,81,159,289,4,30,323
"./Ship3_Latin-square/2019-10-09_11h08m_Subject 47241.txt","47241",2019-10-09,"11:08",78,60,7,11,18,13,2,1,16,5,10,1,16,939,116,158,1213
"./Ship3_Latin-square/2019-10-09_11h08m_Subject 47247.txt","47247",2019-10-09,"11:08",75,60,6,9,15,30,0,0,30,19,2,2,23,276,32,41,349
"./Ship3_Latin-square/2019-10-09_11h08m_Subject 47784.txt","47784",2019-10-09,"11:08",77,60,7,10,17,42,0,4,46,79,27,12,118,1075,117,194,1386
"./Ship3_Latin-square/2019-10-09_11h10m_Subject 46986.txt","46986",2019-10-09,"11:10",78,60,8,10,18,35,5,6,46,7,1,6,14,338,45,62,445
"./Ship3_Latin-square/2019-10-09_11h10m_Subject 47098.txt","47098",2019-10-09,"11:10",85,60,14,11,25,34,8,8,50,54,41,31,126,244,36,61,341
"./Ship3_Latin-square/2019-10-09_11h10m_Subject 47645.txt","47645",2019-10-09,"11:10",81,60,8,13,21,58,12,20,90,12,3,5,20,298,40,55,393
"./Ship3_Latin-square/2019-10-09_11h10m_Subject 47755.txt","47755",2019-10-09,"11:10",80,60,8,12,20,36,4,4,44,67,19,5,91,578,85,146,809
"./Ship3_Latin-square/2019-10-09_11h10m_Subject 47770.txt","47770",2019-10-09,"11:10",52,39,10,3,13,50,8,3,61,59,26,2,87,183,28,14,225
"./Ship3_Latin-square/2019-10-09_12h23m_Subject 47632.txt","47632",2019-10-09,"12:23",81,60,8,13,21,18,0,1,19,12,3,10,25,856,130,161,1147
"./Ship3_Latin-square/2019-10-09_12h28m_Subject 46883.txt","46883",2019-10-09,"12:28",79,60,9,10,19,42,2,2,46,25,15,22,62,441,52,99,592
"./Ship3_Latin-square/2019-10-09_12h28m_Subject 46896.txt","46896",2019-10-09,"12:28",78,60,9,9,18,30,1,1,32,39,11,13,63,747,75,137,959
"./Ship3_Latin-square/2019-10-09_12h28m_Subject 47753.txt","47753",2019-10-09,"12:28",83,60,14,9,23,51,8,7,66,26,27,13,66,458,70,88,616
"./Ship3_Latin-square/2019-10-09_13h38m_Subject 46890.txt","46890",2019-10-09,"13:38",83,60,9,14,23,10,1,0,11,72,6,6,84,334,81,95,510
"./Ship3_Latin-square/2019-10-09_13h38m_Subject 46898.txt","46898",2019-10-09,"13:38",80,60,11,9,20,43,2,5,50,44,24,20,88,412,24,46,482
"./Ship3_Latin-square/2019-10-09_13h38m_Subject 47798.txt","47798",2019-10-09,"13:38",76,56,12,8,20,18,3,1,22,13,7,3,23,211,22,51,284
"./Ship3_Latin-square/2019-10-09_13h42m_Subject 46877.txt","46877",2019-10-09,"13:42",82,60,12,10,22,8,1,2,11,28,9,4,41,996,128,211,1335
"./Ship3_Latin-square/2019-10-09_13h42m_Subject 46897.txt","46897",2019-10-09,"13:42",70,51,9,10,19,59,10,5,74,30,4,12,46,116,19,21,156
"./Ship3_Latin-square/2019-10-09_13h42m_Subject 47786.txt","47786",2019-10-09,"13:42",64,49,10,5,15,59,8,6,73,48,11,7,66,104,4,10,118
"./Ship3_Latin-square/2019-10-09_14h43m_Subject 47762.txt","47762",2019-10-09,"14:43",64,49,11,4,15,76,11,3,90,15,10,0,25,155,19,14,188
"./Ship3_Latin-square/2019-10-10_09h57m_Subject 46878.txt","46878",2019-10-10,"09:57",73,60,7,6,13,14,2,2,18,7,4,1,12,837,104,95,1036
"./Ship3_Latin-square/2019-10-10_09h57m_Subject 47081.txt","47081",2019-10-10,"09:57",73,55,10,8,18,81,6,11,98,64,28,25,117,256,16,23,295
"./Ship3_Latin-square/2019-10-10_09h57m_Subject 47095.txt","47095",2019-10-10,"09:57",78,60,10,8,18,28,3,5,36,28,6,7,41,229,29,48,306
"./Ship3_Latin-square/2019-10-10_09h57m_Subject 47231.txt","47231",2019-10-10,"09:57",82,58,12,12,24,54,8,12,74,35,24,9,68,264,37,44,345
"./Ship3_Latin-square/2019-10-10_09h57m_Subject 47633.txt","47633",2019-10-10,"09:57",80,60,9,11,20,32,5,7,44,61,15,17,93,411,59,82,552
"./Ship3_Latin-square/2019-10-10_09h57m_Subject 47636.txt","47636",2019-10-10,"09:57",76,56,12,8,20,78,9,11,98,73,37,4,114,265,52,37,354
"./Ship3_Latin-square/2019-10-10_09h57m_Subject 47768.txt","47768",2019-10-10,"09:57",71,51,9,11,20,41,6,6,53,30,9,15,54,302,42,81,425
"./Ship3_Latin-square/2019-10-10_09h57m_Subject 47780.txt","47780",2019-10-10,"09:57",76,60,7,9,16,31,6,3,40,44,18,5,67,545,65,103,713
"./Ship3_Latin-square/2019-10-10_10h00m_Subject 47086.txt","47086",2019-10-10,"10:00",79,60,6,13,19,17,7,1,25,7,0,11,18,513,31,121,665
"./Ship3_Latin-square/2019-10-10_10h00m_Subject 47635.txt","47635",2019-10-10,"10:00",77,60,9,8,17,15,2,8,25,36,9,6,51,488,40,73,601
"./Ship3_Latin-square/2019-10-10_10h00m_Subject 47779.txt","47779",2019-10-10,"10:00",41,31,6,4,10,71,11,12,94,45,7,4,56,76,7,7,90
"./Ship3_Latin-square/2019-10-10_10h00m_Subject 47790.txt","47790",2019-10-10,"10:00",83,60,12,11,23,45,11,7,63,48,6,16,70,236,32,64,332
"./Ship3_Latin-square/2019-10-10_10h00m_Subject 47797.txt","47797",2019-10-10,"10:00",60,43,10,7,17,64,8,7,79,53,19,24,96,81,11,26,118
"./Ship3_Latin-square/2019-10-10_11h20m_Subject 46986.txt","46986",2019-10-10,"11:20",79,60,11,8,19,25,3,9,37,5,4,3,12,311,52,63,426
"./Ship3_Latin-square/2019-10-10_11h20m_Subject 47098.txt","47098",2019-10-10,"11:20",82,60,12,10,22,71,14,12,97,63,8,49,120,208,4,57,269
"./Ship3_Latin-square/2019-10-10_11h20m_Subject 47645.txt","47645",2019-10-10,"11:20",82,60,8,14,22,55,4,14,73,8,3,9,20,211,54,69,334
"./Ship3_Latin-square/2019-10-10_11h20m_Subject 47770.txt","47770",2019-10-10,"11:20",63,49,6,8,14,47,2,2,51,122,14,45,181,208,27,23,258
"./Ship3_Latin-square/2019-10-10_11h24m_Subject 47234.txt","47234",2019-10-10,"11:24",82,60,9,13,22,20,2,2,24,64,16,24,104,404,68,87,559
"./Ship3_Latin-square/2019-10-10_11h24m_Subject 47237.txt","47237",2019-10-10,"11:24",78,60,9,9,18,37,2,6,45,7,2,6,15,481,50,85,616
"./Ship3_Latin-square/2019-10-10_11h24m_Subject 47241.txt","47241",2019-10-10,"11:24",79,60,10,9,19,22,4,6,32,24,10,7,41,545,9,117,671
"./Ship3_Latin-square/2019-10-10_12h57m_Subject 47632.txt","47632",2019-10-10,"12:57",77,60,3,14,17,14,0,2,16,12,2,6,20,955,43,235,1233
"./Ship3_Latin-square/2019-10-10_12h59m_Subject 46896.txt","46896",2019-10-10,"12:59",82,60,4,18,22,17,2,3,22,62,3,8,73,983,76,294,1353
"./Ship3_Latin-square/2019-10-10_12h59m_Subject 47753.txt","47753",2019-10-10,"12:59",81,60,7,14,21,33,0,5,38,14,2,26,42,740,83,183,1006
"./Ship3_Latin-square/2019-10-10_14h12m_Subject 46877.txt","46877",2019-10-10,"14:12",84,60,13,11,24,11,1,1,13,25,17,7,49,1265,276,254,1795
"./Ship3_Latin-square/2019-10-10_14h12m_Subject 46897.txt","46897",2019-10-10,"14:12",79,60,9,10,19,40,3,7,50,12,13,11,36,233,32,38,303
"./Ship3_Latin-square/2019-10-10_14h12m_Subject 47786.txt","47786",2019-10-10,"14:12",78,60,10,8,18,55,5,15,75,33,5,9,47,308,35,53,396
"./Ship3_Latin-square/2019-10-10_14h15m_Subject 46890.txt","46890",2019-10-10,"14:15",86,60,12,14,26,27,1,4,32,14,12,9,35,234,33,91,358
"./Ship3_Latin-square/2019-10-10_14h15m_Subject 46898.txt","46898",2019-10-10,"14:15",81,60,10,11,21,28,4,4,36,66,8,19,93,569,87,113,769
"./Ship3_Latin-square/2019-10-10_14h15m_Subject 47798.txt","47798",2019-10-10,"14:15",79,60,6,13,19,27,4,5,36,11,2,6,19,258,21,56,335
"./Ship3_Latin-square/2019-10-10_15h23m_Subject 47762.txt","47762",2019-10-10,"15:23",81,60,11,10,21,29,3,6,38,16,3,2,21,244,35,67,346
"./Ship3_Latin-square/2019-10-11_09h55m_Subject 47086.txt","47086",2019-10-11,"09:55",80,60,10,10,20,40,1,15,56,31,3,4,38,268,20,61,349
"./Ship3_Latin-square/2019-10-11_09h55m_Subject 47635.txt","47635",2019-10-11,"09:55",81,60,7,14,21,16,1,3,20,53,6,7,66,590,61,150,801
"./Ship3_Latin-square/2019-10-11_09h55m_Subject 47779.txt","47779",2019-10-11,"09:55",77,58,9,10,19,54,10,3,67,65,23,4,92,292,34,65,391
"./Ship3_Latin-square/2019-10-11_09h55m_Subject 47790.txt","47790",2019-10-11,"09:55",78,60,7,11,18,18,1,3,22,26,4,5,35,756,78,177,1011
"./Ship3_Latin-square/2019-10-11_09h55m_Subject 47797.txt","47797",2019-10-11,"09:55",81,60,9,12,21,46,3,6,55,11,8,5,24,283,32,64,379
"./Ship3_Latin-square/2019-10-11_09h58m_Subject 47081.txt","47081",2019-10-11,"09:58",84,60,8,16,24,14,1,5,20,19,6,21,46,566,73,173,812
"./Ship3_Latin-square/2019-10-11_09h58m_Subject 47095.txt","47095",2019-10-11,"09:58",80,60,10,10,20,20,6,0,26,17,14,7,38,330,64,47,441
"./Ship3_Latin-square/2019-10-11_09h58m_Subject 47636.txt","47636",2019-10-11,"09:58",78,60,11,7,18,74,24,4,102,51,14,6,71,356,68,47,471
"./Ship3_Latin-square/2019-10-11_09h58m_Subject 47768.txt","47768",2019-10-11,"09:58",78,60,7,11,18,35,5,9,49,35,4,16,55,370,28,76,474
"./Ship3_Latin-square/2019-10-11_09h58m_Subject 47780.txt","47780",2019-10-11,"09:58",82,60,11,11,22,31,4,9,44,34,13,6,53,417,56,117,590
"./Ship3_Latin-square/2019-10-11_11h04m_Subject 47234.txt","47234",2019-10-11,"11:04",81,58,15,8,23,67,7,9,83,58,62,8,128,195,21,52,268
"./Ship3_Latin-square/2019-10-11_11h04m_Subject 47237.txt","47237",2019-10-11,"11:04",81,60,7,14,21,10,0,1,11,17,0,10,27,753,87,179,1019
"./Ship3_Latin-square/2019-10-11_11h04m_Subject 47241.txt","47241",2019-10-11,"11:04",80,60,8,12,20,8,3,2,13,7,1,2,10,880,133,171,1184
"./Ship3_Latin-square/2019-10-11_11h07m_Subject 46986.txt","46986",2019-10-11,"11:07",75,53,11,11,22,75,10,12,97,37,8,11,56,123,12,43,178
"./Ship3_Latin-square/2019-10-11_11h07m_Subject 47098.txt","47098",2019-10-11,"11:07",80,60,12,8,20,36,2,5,43,26,31,14,71,422,75,74,571
"./Ship3_Latin-square/2019-10-11_11h07m_Subject 47645.txt","47645",2019-10-11,"11:07",67,48,14,5,19,85,19,13,117,16,15,2,33,161,17,14,192
"./Ship3_Latin-square/2019-10-11_12h15m_Subject 47632.txt","47632",2019-10-11,"12:15",82,60,10,12,22,10,2,2,14,16,3,7,26,895,145,170,1210
"./Ship3_Latin-square/2019-10-11_12h18m_Subject 46896.txt","46896",2019-10-11,"12:18",79,60,7,12,19,16,1,1,18,54,9,4,67,694,102,146,942
"./Ship3_Latin-square/2019-10-11_12h18m_Subject 47753.txt","47753",2019-10-11,"12:18",84,60,11,13,24,15,0,5,20,13,4,29,46,572,74,146,792
"./Ship3_Latin-square/2019-10-11_13h20m_Subject 46890.txt","46890",2019-10-11,"13:20",83,59,15,9,24,44,6,10,60,22,13,6,41,124,3,38,165
"./Ship3_Latin-square/2019-10-11_13h20m_Subject 46898.txt","46898",2019-10-11,"13:20",79,60,11,8,19,41,6,3,50,44,19,6,69,342,39,53,434
"./Ship3_Latin-square/2019-10-11_13h30m_Subject 46897.txt","46897",2019-10-11,"13:30",84,60,10,14,24,24,5,8,37,15,1,13,29,238,39,39,316
"./Ship3_Latin-square/2019-10-11_13h30m_Subject 47786.txt","47786",2019-10-11,"13:30",78,60,9,9,18,56,7,5,68,39,9,4,52,182,19,27,228
"./Ship3_Latin-square/2019-10-12_09h30m_Subject 47086.txt","47086",2019-10-12,"09:30",80,60,9,11,20,26,2,4,32,7,0,2,9,537,82,129,748
"./Ship3_Latin-square/2019-10-12_09h30m_Subject 47790.txt","47790",2019-10-12,"09:30",64,45,10,9,19,47,12,6,65,31,16,10,57,282,63,79,424
"./Ship3_Latin-square/2019-10-12_09h30m_Subject 47797.txt","47797",2019-10-12,"09:30",53,38,10,5,15,34,4,5,43,26,5,6,37,91,26,33,150
"./Ship3_Latin-square/2019-10-12_09h32m_Subject 47081.txt","47081",2019-10-12,"09:32",80,60,12,8,20,26,6,1,33,32,12,1,45,303,48,53,404
"./Ship3_Latin-square/2019-10-12_09h32m_Subject 47095.txt","47095",2019-10-12,"09:32",72,53,12,7,19,19,8,7,34,32,12,17,61,230,64,36,330
"./Ship3_Latin-square/2019-10-12_09h32m_Subject 47780.txt","47780",2019-10-12,"09:32",79,60,10,9,19,20,1,3,24,39,9,7,55,512,74,81,667
"./Ship3_Latin-square/2019-10-12_10h40m_Subject 47234.txt","47234",2019-10-12,"10:40",79,60,9,10,19,26,4,5,35,52,12,11,75,375,58,46,479
"./Ship3_Latin-square/2019-10-12_10h40m_Subject 47237.txt","47237",2019-10-12,"10:40",83,60,12,11,23,11,0,1,12,23,2,6,31,622,75,160,857
"./Ship3_Latin-square/2019-10-12_10h40m_Subject 47241.txt","47241",2019-10-12,"10:40",79,60,12,7,19,12,3,7,22,7,16,2,25,750,86,111,947
"./Ship3_Latin-square/2019-10-12_10h42m_Subject 46986.txt","46986",2019-10-12,"10:42",76,60,7,9,16,32,3,1,36,5,1,3,9,387,42,60,489
"./Ship3_Latin-square/2019-10-12_10h42m_Subject 47098.txt","47098",2019-10-12,"10:42",80,60,7,13,20,15,2,3,20,19,3,1,23,677,77,184,938
"./Ship3_Latin-square/2019-10-12_10h42m_Subject 47645.txt","47645",2019-10-12,"10:42",85,60,10,15,25,59,10,16,85,7,2,6,15,267,56,68,391
"./Ship3_Latin-square/2019-10-12_11h46m_Subject 47632.txt","47632",2019-10-12,"11:46",80,60,7,13,20,12,1,4,17,9,12,5,26,841,104,198,1143
"./Ship3_Latin-square/2019-10-12_11h49m_Subject 46896.txt","46896",2019-10-12,"11:49",76,60,5,11,16,15,0,1,16,56,7,8,71,737,80,151,968
"./Ship3_Latin-square/2019-10-12_11h49m_Subject 47753.txt","47753",2019-10-12,"11:49",84,60,10,14,24,8,2,4,14,12,7,5,24,745,109,201,1055
"./Ship3_Latin-square/2019-10-12_12h55m_Subject 46890.txt","46890",2019-10-12,"12:55",84,58,12,14,26,25,1,0,26,24,13,7,44,205,51,78,334
"./Ship3_Latin-square/2019-10-12_12h55m_Subject 46898.txt","46898",2019-10-12,"12:55",74,60,9,5,14,23,0,1,24,28,24,7,59,963,95,94,1152
"./Ship3_Latin-square/2019-10-12_12h58m_Subject 46897.txt","46897",2019-10-12,"12:58",82,60,12,10,22,37,4,9,50,18,5,4,27,140,22,27,189
"./Ship3_Latin-square/2019-10-12_12h58m_Subject 47786.txt","47786",2019-10-12,"12:58",78,60,9,9,18,65,7,14,86,32,13,10,55,176,25,19,220
"./Ship3_Latin-square/2019-10-13_09h55m_Subject 47081.txt","47081",2019-10-13,"09:55",83,60,12,11,23,27,9,3,39,8,19,0,27,399,93,74,566
"./Ship3_Latin-square/2019-10-13_09h55m_Subject 47095.txt","47095",2019-10-13,"09:55",81,60,10,11,21,20,3,1,24,43,6,20,69,386,72,103,561
"./Ship3_Latin-square/2019-10-13_10h01m_Subject 47086.txt","47086",2019-10-13,"10:01",78,60,9,9,18,19,0,5,24,13,1,1,15,434,29,73,536
"./Ship3_Latin-square/2019-10-13_10h01m_Subject 47790.txt","47790",2019-10-13,"10:01",79,60,6,13,19,40,5,5,50,81,6,34,121,297,22,101,420
"./Ship3_Latin-square/2019-10-13_10h01m_Subject 47797.txt","47797",2019-10-13,"10:01",68,50,7,11,18,39,3,11,53,50,6,31,87,133,28,25,186
"./Ship3_Latin-square/2019-10-13_11h17m_Subject 46986.txt","46986",2019-10-13,"11:17",74,55,10,9,19,60,6,8,74,26,3,13,42,239,31,36,306
"./Ship3_Latin-square/2019-10-13_11h17m_Subject 47098.txt","47098",2019-10-13,"11:17",77,60,7,10,17,24,1,3,28,9,0,5,14,545,68,112,725
"./Ship3_Latin-square/2019-10-13_11h17m_Subject 47645.txt","47645",2019-10-13,"11:17",77,56,12,9,21,90,14,15,119,9,4,9,22,167,23,49,239
"./Ship3_Latin-square/2019-10-13_11h20m_Subject 47234.txt","47234",2019-10-13,"11:20",82,60,12,10,22,47,5,14,66,72,101,2,175,234,57,48,339
"./Ship3_Latin-square/2019-10-13_11h20m_Subject 47237.txt","47237",2019-10-13,"11:20",78,60,7,11,18,7,1,2,10,5,1,2,8,715,103,156,974
"./Ship3_Latin-square/2019-10-13_11h20m_Subject 47241.txt","47241",2019-10-13,"11:20",79,60,9,10,19,15,4,4,23,16,14,3,33,823,88,160,1071
"./Ship3_Latin-square/2019-10-13_12h30m_Subject 46896.txt","46896",2019-10-13,"12:30",81,60,5,16,21,24,0,2,26,32,7,9,48,691,59,145,895
"./Ship3_Latin-square/2019-10-13_12h30m_Subject 47753.txt","47753",2019-10-13,"12:30",86,60,16,10,26,55,11,14,80,27,13,18,58,429,64,108,601
"./Ship3_Latin-square/2019-10-13_12h35m_Subject 47632.txt","47632",2019-10-13,"12:35",80,60,8,12,20,15,5,3,23,7,10,5,22,673,74,140,887
"./Ship3_Latin-square/2019-10-13_13h45m_Subject 46897.txt","46897",2019-10-13,"13:45",64,45,14,5,19,69,16,6,91,18,8,1,27,81,3,9,93
"./Ship3_Latin-square/2019-10-13_13h49m_Subject 46890.txt","46890",2019-10-13,"13:49",82,60,9,13,22,15,1,0,16,20,12,8,40,738,162,157,1057
"./Ship3_Latin-square/2019-10-14_10h10m_Subject 47095.txt","47095",2019-10-14,"10:10",81,60,10,11,21,22,8,8,38,34,14,15,63,337,36,84,457
"./Ship3_Latin-square/2019-10-14_10h15m_Subject 47086.txt","47086",2019-10-14,"10:15",79,60,10,9,19,27,3,3,33,10,1,3,14,702,105,124,931
"./Ship3_Latin-square/2019-10-14_10h15m_Subject 47790.txt","47790",2019-10-14,"10:15",83,58,15,10,25,62,10,11,83,44,22,5,71,346,57,62,465
"./Ship3_Latin-square/2019-10-14_11h30m_Subject 46986.txt","46986",2019-10-14,"11:30",80,60,11,9,20,35,10,6,51,9,5,6,20,382,57,92,531
"./Ship3_Latin-square/2019-10-14_11h30m_Subject 47098.txt","47098",2019-10-14,"11:30",82,60,10,12,22,21,4,1,26,5,2,2,9,562,115,109,786
"./Ship3_Latin-square/2019-10-14_11h30m_Subject 47645.txt","47645",2019-10-14,"11:30",79,60,10,9,19,78,13,10,101,12,1,2,15,240,34,44,318
"./Ship3_Latin-square/2019-10-14_11h33m_Subject 47234.txt","47234",2019-10-14,"11:33",83,60,10,13,23,32,5,7,44,18,10,1,29,482,72,100,654
"./Ship3_Latin-square/2019-10-14_11h33m_Subject 47237.txt","47237",2019-10-14,"11:33",79,60,7,12,19,32,40,2,74,25,1,22,48,751,86,154,991
"./Ship3_Latin-square/2019-10-14_12h33m_Subject 47632.txt","47632",2019-10-14,"12:33",78,60,9,9,18,18,0,3,21,18,6,16,40,543,9,142,694
"./Ship3_Latin-square/2019-10-14_12h41m_Subject 46896.txt","46896",2019-10-14,"12:41",81,60,5,16,21,13,1,2,16,37,8,12,57,798,69,164,1031
"./Ship3_Latin-square/2019-10-14_12h41m_Subject 47753.txt","47753",2019-10-14,"12:41",85,60,17,8,25,65,7,13,85,51,23,12,86,447,25,92,564
"./Ship3_Latin-square/2019-10-14_13h27m_Subject 46890.txt","46890",2019-10-14,"13:27",82,60,9,13,22,11,3,3,17,19,4,10,33,415,28,141,584
"./Ship3_Latin-square/2019-10-14_13h42m_Subject 46897.txt","46897",2019-10-14,"13:42",66,49,10,7,17,60,11,9,80,29,10,3,42,97,12,12,121
"./Ship3_Latin-square/2019-10-15_09h52m_Subject 47790.txt","47790",2019-10-15,"09:52",42,31,7,4,11,51,9,5,65,23,11,4,38,117,4,12,133
"./Ship3_Latin-square/2019-10-15_09h54m_Subject 47095.txt","47095",2019-10-15,"09:54",66,50,10,6,16,39,2,10,51,43,11,22,76,212,9,17,238
"./Ship3_Latin-square/2019-10-15_11h10m_Subject 47098.txt","47098",2019-10-15,"11:10",81,60,9,12,21,15,2,3,20,6,0,0,6,558,104,129,791
"./Ship3_Latin-square/2019-10-15_11h15m_Subject 47237.txt","47237",2019-10-15,"11:15",81,60,9,12,21,8,5,1,14,17,1,11,29,637,66,154,857
"./Ship3_Latin-square/2019-10-15_12h22m_Subject 47632.txt","47632",2019-10-15,"12:22",79,60,9,10,19,13,1,3,17,16,12,1,29,808,84,115,1007
"./Ship3_Latin-square/2019-10-15_12h24m_Subject 46896.txt","46896",2019-10-15,"12:24",75,60,7,8,15,29,5,3,37,41,9,2,52,310,9,68,387
"./Ship3_Latin-square/2019-10-15_12h24m_Subject 47753.txt","47753",2019-10-15,"12:24",80,60,9,11,20,8,1,1,10,19,4,7,30,665,88,177,930
"./Ship3_Latin-square/2019-10-15_13h35m_Subject 46897.txt","46897",2019-10-15,"13:35",53,40,10,3,13,87,11,6,104,21,6,3,30,81,23,4,108
"./Ship3_Latin-square/2019-10-15_13h39m_Subject 46890.txt","46890",2019-10-15,"13:39",85,60,11,14,25,11,2,4,17,29,5,9,43,541,98,184,823
"./Ship3_Latin-square/2019-10-16_09h37m_Subject 47790.txt","47790",2019-10-16,"09:37",76,60,9,7,16,20,1,5,26,30,7,4,41,447,69,56,572
"./Ship3_Latin-square/2019-10-16_09h39m_Subject 47095.txt","47095",2019-10-16,"09:39",82,60,13,9,22,5,2,3,10,21,5,7,33,536,143,78,757
"./Ship3_Latin-square/2019-10-16_10h57m_Subject 47237.txt","47237",2019-10-16,"10:57",77,60,13,4,17,93,5,14,112,93,28,5,126,298,9,15,322
"./Ship3_Latin-square/2019-10-16_11h05m_Subject 47098.txt","47098",2019-10-16,"11:05",80,60,9,11,20,8,1,2,11,2,0,1,3,587,75,89,751
"./Ship3_Latin-square/2019-10-16_12h01m_Subject 47632.txt","47632",2019-10-16,"12:01",80,60,10,10,20,6,1,4,11,15,8,0,23,734,106,157,997
"./Ship3_Latin-square/2019-10-16_12h12m_Subject 46896.txt","46896",2019-10-16,"12:12",80,60,9,11,20,13,3,1,17,34,17,10,61,704,104,143,951
"./Ship3_Latin-square/2019-10-16_12h12m_Subject 47753.txt","47753",2019-10-16,"12:12",78,60,4,14,18,15,0,2,17,17,1,7,25,1022,53,191,1266
"./Ship3_Latin-square/2019-10-16_13h12m_Subject 46890.txt","46890",2019-10-16,"13:12",82,59,9,14,23,18,5,1,24,15,6,10,31,457,32,130,619
"./Ship3_Latin-square/2019-10-16_13h15m_Subject 46897.txt","46897",2019-10-16,"13:15",50,35,11,4,15,76,16,12,104,18,15,10,43,66,21,11,98
"./Ship3_Latin-square/2019-10-17_09h57m_Subject 47790.txt","47790",2019-10-17,"09:57",78,60,8,10,18,13,3,3,19,17,2,7,26,791,133,167,1091
"./Ship3_Latin-square/2019-10-17_10h00m_Subject 47095.txt","47095",2019-10-17,"10:00",80,60,7,13,20,25,1,1,27,34,9,11,54,608,101,112,821
"./Ship3_Latin-square/2019-10-17_11h27m_Subject 47237.txt","47237",2019-10-17,"11:27",81,60,8,13,21,4,1,1,6,21,6,6,33,727,62,185,974
"./Ship3_Latin-square/2019-10-17_11h29m_Subject 47098.txt","47098",2019-10-17,"11:29",81,60,11,10,21,37,1,9,47,29,6,15,50,161,4,40,205
"./Ship3_Latin-square/2019-10-17_12h52m_Subject 47632.txt","47632",2019-10-17,"12:52",79,60,10,9,19,13,2,1,16,17,11,3,31,684,106,120,910
"./Ship3_Latin-square/2019-10-17_12h54m_Subject 46896.txt","46896",2019-10-17,"12:54",80,60,9,11,20,41,5,7,53,38,10,11,59,496,66,82,644
"./Ship3_Latin-square/2019-10-17_12h54m_Subject 47753.txt","47753",2019-10-17,"12:54",79,60,8,11,19,9,1,3,13,23,5,9,37,793,97,168,1058
"./Ship3_Latin-square/2019-10-17_13h58m_Subject 46890.txt","46890",2019-10-17,"13:58",83,60,11,12,23,11,3,0,14,34,12,18,64,602,85,200,887
"./Ship3_Latin-square/2019-10-17_14h00m_Subject 46897.txt","46897",2019-10-17,"14:00",57,44,8,5,13,67,9,8,84,14,27,20,61,121,12,17,150
"./Ship3_Latin-square/2019-10-18_09h57m_Subject 47790.txt","47790",2019-10-18,"09:57",76,60,9,7,16,39,5,5,49,30,13,2,45,394,75,31,500
"./Ship3_Latin-square/2019-10-18_10h00m_Subject 47095.txt","47095",2019-10-18,"10:00",87,60,14,13,27,10,9,1,20,27,14,10,51,570,125,124,819
"./Ship3_Latin-square/2019-10-18_11h04m_Subject 47237.txt","47237",2019-10-18,"11:04",77,60,9,8,17,30,1,7,38,34,14,1,49,469,35,65,569
"./Ship3_Latin-square/2019-10-18_11h06m_Subject 47098.txt","47098",2019-10-18,"11:06",77,60,7,10,17,10,3,2,15,6,0,6,12,491,43,86,620
"./Ship3_Latin-square/2019-10-18_12h11m_Subject 46896.txt","46896",2019-10-18,"12:11",84,60,11,13,24,19,4,5,28,36,19,10,65,642,121,119,882
"./Ship3_Latin-square/2019-10-18_12h11m_Subject 47753.txt","47753",2019-10-18,"12:11",79,60,9,10,19,12,1,1,14,14,4,7,25,783,114,142,1039
"./Ship3_Latin-square/2019-10-18_13h16m_Subject 46890.txt","46890",2019-10-18,"13:16",75,54,13,8,21,55,5,7,67,35,18,9,62,136,1,30,167
"./Ship3_Latin-square/2019-10-18_13h18m_Subject 46897.txt","46897",2019-10-18,"13:18",46,34,8,4,12,60,7,12,79,23,31,4,58,51,3,7,61
"./Ship3_Latin-square/2019-10-19_09h30m_Subject 47790.txt","47790",2019-10-19,"09:30",80,60,9,11,20,19,2,1,22,30,7,3,40,626,108,62,796
"./Ship3_Latin-square/2019-10-19_09h32m_Subject 47095.txt","47095",2019-10-19,"09:32",77,60,6,11,17,20,4,2,26,36,5,15,56,337,42,50,429
"./Ship3_Latin-square/2019-10-19_10h38m_Subject 47237.txt","47237",2019-10-19,"10:38",78,60,9,9,18,12,4,0,16,28,2,4,34,628,48,107,783
"./Ship3_Latin-square/2019-10-19_10h40m_Subject 47098.txt","47098",2019-10-19,"10:40",77,55,4,18,22,39,0,16,55,14,0,21,35,174,18,114,306
"./Ship3_Latin-square/2019-10-19_11h50m_Subject 47753.txt","47753",2019-10-19,"11:50",82,60,6,16,22,42,4,9,55,23,2,30,55,606,72,155,833
"./Ship3_Latin-square/2019-10-19_12h49m_Subject 46890.txt","46890",2019-10-19,"12:49",83,60,11,12,23,12,4,4,20,52,13,13,78,552,148,124,824
"./Ship3_Latin-square/2019-10-19_12h55m_Subject 46897.txt","46897",2019-10-19,"12:55",79,56,9,14,23,40,9,5,54,17,9,15,41,200,19,63,282
"./Ship3_Latin-square/2019-10-20_10h10m_Subject 47095.txt","47095",2019-10-20,"10:10",78,60,9,9,18,33,4,5,42,36,14,18,68,620,104,100,824
"./Ship3_Latin-square/2019-10-20_10h15m_Subject 47790.txt","47790",2019-10-20,"10:15",81,60,8,13,21,21,4,4,29,13,2,6,21,558,109,75,742
"./Ship3_Latin-square/2019-10-20_11h27m_Subject 47098.txt","47098",2019-10-20,"11:27",84,60,12,12,24,16,4,7,27,14,6,53,73,412,80,100,592
"./Ship3_Latin-square/2019-10-20_12h35m_Subject 47753.txt","47753",2019-10-20,"12:35",79,60,7,12,19,6,0,0,6,11,8,1,20,830,113,157,1100
"./Ship3_Latin-square/2019-10-20_13h45m_Subject 46897.txt","46897",2019-10-20,"13:45",81,60,9,12,21,21,6,3,30,13,5,12,30,232,33,43,308
"./Ship3_Latin-square/2019-10-20_13h49m_Subject 46890.txt","46890",2019-10-20,"13:49",74,53,12,9,21,26,2,2,30,27,6,10,43,627,50,81,758
"./Ship3_Latin-square/2019-10-21_10h05m_Subject 47095.txt","47095",2019-10-21,"10:05",76,60,5,11,16,63,1,2,66,36,6,14,56,654,42,118,814
"./Ship3_Latin-square/2019-10-21_10h09m_Subject 47790.txt","47790",2019-10-21,"10:09",82,60,10,12,22,24,3,5,32,4,4,7,15,681,143,107,931
"./Ship3_Latin-square/2019-10-21_12h30m_Subject 47753.txt","47753",2019-10-21,"12:30",83,60,14,9,23,78,9,10,97,52,68,21,141,308,12,84,404
"./Ship3_Latin-square/2019-10-21_13h35m_Subject 46897.txt","46897",2019-10-21,"13:35",78,58,11,9,20,43,7,5,55,36,14,18,68,77,0,26,103
"./Ship3_Latin-square/2019-10-21_13h39m_Subject 46890.txt","46890",2019-10-21,"13:39",80,60,8,12,20,7,0,1,8,46,4,21,71,793,109,233,1135
"./Ship3_Latin-square/2019-10-22_10h02m_Subject 47790.txt","47790",2019-10-22,"10:02",82,60,12,10,22,46,9,10,65,21,17,6,44,188,11,83,282
"./Ship3_Latin-square/2019-10-22_10h04m_Subject 47095.txt","47095",2019-10-22,"10:04",78,59,12,7,19,54,7,8,69,40,9,12,61,262,14,32,308
"./Ship3_Latin-square/2019-10-22_12h40m_Subject 47753.txt","47753",2019-10-22,"12:40",80,60,8,12,20,10,1,0,11,24,0,3,27,933,124,248,1305
"./Ship3_Latin-square/2019-10-22_14h02m_Subject 46897.txt","46897",2019-10-22,"14:02",84,60,7,17,24,43,8,7,58,4,7,5,16,272,18,75,365
"./Ship3_Latin-square/2019-10-23_09h57m_Subject 47790.txt","47790",2019-10-23,"09:57",80,60,8,12,20,18,3,2,23,15,3,5,23,468,61,90,619
"./Ship3_Latin-square/2019-10-23_10h00m_Subject 47095.txt","47095",2019-10-23,"10:00",80,60,6,14,20,10,1,2,13,22,8,11,41,644,62,146,852
"./Ship3_Latin-square/2019-10-23_12h26m_Subject 47753.txt","47753",2019-10-23,"12:26",84,60,13,11,24,27,2,8,37,15,8,13,36,641,86,162,889
"./Ship3_Latin-square/2019-10-23_14h00m_Subject 46897.txt","46897",2019-10-23,"14:00",52,37,14,1,15,47,31,0,78,15,7,1,23,104,15,2,121
"./Ship3_Latin-square/2019-10-24_09h53m_Subject 47790.txt","47790",2019-10-24,"09:53",81,60,12,9,21,14,3,0,17,18,9,2,29,324,46,98,468
"./Ship3_Latin-square/2019-10-24_09h56m_Subject 47095.txt","47095",2019-10-24,"09:56",75,56,12,7,19,37,8,2,47,15,16,5,36,379,30,65,474
"./Ship3_Latin-square/2019-10-24_12h17m_Subject 47753.txt","47753",2019-10-24,"12:17",83,60,10,13,23,8,0,4,12,16,14,4,34,925,145,248,1318
"./Ship3_Latin-square/2019-10-24_13h35m_Subject 46897.txt","46897",2019-10-24,"13:35",79,60,9,10,19,53,7,5,65,15,7,11,33,339,30,48,417
"./Ship3_Latin-square/2019-10-25_09h48m_Subject 47790.txt","47790",2019-10-25,"09:48",77,60,8,9,17,10,5,2,17,28,4,7,39,511,27,87,625
"./Ship3_Latin-square/2019-10-25_09h51m_Subject 47095.txt","47095",2019-10-25,"09:51",76,59,11,6,17,30,13,0,43,36,12,4,52,367,54,53,474
"./Ship3_Latin-square/2019-10-25_12h54m_Subject 46897.txt","46897",2019-10-25,"12:54",69,52,8,9,17,75,8,7,90,14,6,6,26,176,18,26,220
"./Ship3_Latin-square/2019-10-26_12h51m_Subject 46897.txt","46897",2019-10-26,"12:51",81,60,10,11,21,56,5,5,66,19,4,3,26,183,30,43,256
"./Ship3_Latin-square/2019-10-27_14h01m_Subject 46897.txt","46897",2019-10-27,"14:01",47,36,10,1,11,68,16,2,86,7,22,1,30,108,16,4,128
"./Ship3_Latin-square/2019-10-28_13h40m_Subject 46897.txt","46897",2019-10-28,"13:40",45,32,13,0,13,53,24,0,77,35,45,0,80,80,3,0,83
"./Ship3_Latin-square/2019-10-29_14h16m_Subject 46897.txt","46897",2019-10-29,"14:16",64,47,9,8,17,70,6,8,84,34,26,7,67,253,28,71,352
"./Ship3_Latin-square/2019-10-30_13h20m_Subject 46897.txt","46897",2019-10-30,"13:20",64,46,13,5,18,79,14,4,97,11,27,3,41,163,18,14,195
"./Ship3_Latin-square/2019-10-31_13h05m_Subject 46897.txt","46897",2019-10-31,"13:05",78,60,7,11,18,45,7,11,63,7,1,5,13,307,24,66,397
"./Ship3_Latin-square/2019-11-01_13h07m_Subject 46897.txt","46897",2019-11-01,"13:07",83,60,10,13,23,37,5,5,47,6,2,5,13,241,31,70,342
"./Ship3_Latin-square/2019-11-02_12h58m_Subject 46897.txt","46897",2019-11-02,"12:58",82,60,11,11,22,46,4,7,57,3,8,1,12,249,48,50,347
"./Ship3_Latin-square/2019-11-03_13h55m_Subject 46897.txt","46897",2019-11-03,"13:55",81,60,8,13,21,21,2,3,26,12,5,10,27,317,37,52,406
"./Ship3_Latin-square/2019-11-04_13h29m_Subject 46897.txt","46897",2019-11-04,"13:29",84,60,10,14,24,21,3,8,32,10,2,6,18,243,25,96,364
"./Ship3_Latin-square/2019-11-05_13h30m_Subject 46897.txt","46897",2019-11-05,"13:30",50,39,9,2,11,87,13,5,105,33,5,2,40,86,3,4,93
"./Ship3_Latin-square/2019-11-06_13h35m_Subject 46897.txt","46897",2019-11-06,"13:35",81,60,9,12,21,19,6,3,28,12,2,3,17,157,22,44,223
"./Ship3_Latin-square/2019-11-07_13h10m_Subject 46897.txt","46897",2019-11-07,"13:10",67,49,10,8,18,62,17,14,93,62,39,8,109,136,12,32,180
